2189345	2024-05-31 08:00:00	4	3	2.12	3.35	3.25	2.28	3.30	2.96	2	4	7	6	2	5	8	6	12	5	7	1	13	2	3	1	2	1	3	1	-1	-1	0.16	-0.05	-0.29
2110753	2023-11-05 04:00:00	4	1	3.10	3.05	2.13	3.65	3.15	2.17	4	2	0	3	2	2	7	4	2	0	3	5	7	1	2	3	3	2	1	1	1	1	0.55	0.10	0.04
2189346	2024-05-31 08:00:00	4	3	1.08	9.90	19.00	1.08	9.90	19.00	0	0	0	0	0	0	0	0	0	1	1	1	1	1	1	1	1	1	1	0	0	0	0.00	0.00	0.00
1992088	2023-06-08 08:30:00	4	3	1.75	3.65	4.25	1.77	3.55	4.25	5	3	3	2	1	7	7	4	10	3	6	0	10	2	3	1	2	1	3	1	-1	0	0.02	-0.10	0.00
2178603	2024-03-14 08:30:00	4	1	1.88	3.35	3.70	2.00	3.30	3.35	20	11	20	21	10	15	41	21	35	3	23	9	44	1	3	2	3	1	2	1	-1	-1	0.12	-0.05	-0.35
1992080	2023-06-30 08:00:00	4	3	1.08	8.00	15.00	1.12	7.70	17.00	5	11	8	10	9	8	15	20	16	8	3	7	23	3	1	2	1	3	2	1	-1	1	0.04	-0.30	2.00
2066192	2023-08-11 08:00:00	4	3	3.70	3.45	1.93	3.45	3.35	2.03	12	6	8	10	4	11	22	10	19	2	14	5	24	1	3	2	3	1	2	-1	-1	1	-0.25	-0.10	0.10
1992078	2023-06-08 08:30:00	4	3	1.20	6.10	13.00	1.18	6.50	14.00	7	4	3	5	6	5	12	10	8	3	5	7	15	1	2	3	3	2	1	-1	1	1	-0.02	0.40	1.00
2066191	2023-08-11 08:00:00	4	3	1.60	3.75	5.30	1.55	3.85	5.70	5	2	2	2	3	4	7	5	6	2	4	3	9	1	3	2	3	1	2	-1	1	1	-0.05	0.10	0.40
1992079	2023-06-30 08:00:00	4	1	1.86	3.55	3.85	1.91	3.65	3.55	2	2	3	5	2	4	7	4	7	1	4	1	8	1	3	1	2	1	2	1	1	-1	0.05	0.10	-0.30
2066190	2023-08-10 08:30:00	4	1	1.84	3.35	3.90	1.77	3.50	4.35	9	3	6	6	5	10	15	8	16	1	8	0	16	2	3	1	2	1	3	-1	1	1	-0.07	0.15	0.45
2066189	2023-08-10 08:00:00	4	1	1.34	4.70	7.40	1.34	4.85	7.80	2	2	5	2	2	4	4	4	9	5	5	0	9	2	2	1	1	1	3	0	1	1	0.00	0.15	0.40
2066187	2023-08-10 08:00:00	4	1	1.60	3.60	5.10	1.60	3.60	5.60	1	2	1	2	1	4	3	3	5	2	2	0	5	2	2	1	1	1	3	0	0	1	0.00	0.00	0.50
2306230	2024-10-24 08:30:00	4	3	1.38	4.25	8.20	1.35	4.35	9.10	4	4	5	4	4	7	8	8	12	6	6	2	14	2	2	1	1	1	3	-1	1	1	-0.03	0.10	0.90
2306229	2024-10-23 08:30:00	4	3	2.25	3.05	3.25	2.49	2.71	3.25	4	23	10	8	10	11	12	33	21	26	5	17	38	3	1	2	1	3	2	1	-1	0	0.24	-0.34	0.00
2256571	2024-08-14 06:00:00	4	3	2.07	3.10	3.40	2.17	2.87	3.70	8	16	15	16	8	15	24	24	30	12	12	6	36	2	2	1	1	1	3	1	-1	1	0.10	-0.23	0.30
1992069	2023-06-29 06:00:00	4	3	1.44	4.15	6.80	1.40	4.30	7.40	6	3	5	4	5	7	10	8	12	2	4	0	12	2	3	1	2	1	3	-1	1	1	-0.04	0.15	0.60
2306232	2024-10-30 08:30:00	4	1	1.59	3.80	5.30	1.59	3.70	5.60	9	7	6	5	8	12	14	15	18	7	6	3	21	3	2	1	1	2	3	0	-1	1	0.00	-0.10	0.30
2309183	2024-12-01 04:00:00	4	0	3.15	3.05	2.11	3.70	2.92	2.14	4	10	3	4	5	6	8	15	9	11	4	10	19	3	1	2	1	3	2	1	-1	1	0.55	-0.13	0.03
2256573	2024-08-21 06:00:00	4	3	2.19	2.96	3.50	2.12	2.99	3.65	6	7	8	6	7	9	12	14	17	10	8	5	22	3	2	1	1	2	3	-1	1	1	-0.07	0.03	0.15
2189312	2024-04-04 08:30:00	4	1	2.65	3.00	2.71	2.47	2.99	2.94	19	6	15	16	6	20	35	12	35	2	25	2	37	1	3	1	2	1	2	-1	-1	1	-0.18	-0.01	0.23
2189314	2024-04-12 08:00:00	4	3	1.13	7.30	18.00	1.14	7.20	16.00	0	7	5	1	5	3	1	12	8	12	1	5	13	3	1	2	1	3	2	1	-1	-1	0.01	-0.10	-2.00
2189317	2024-05-10 06:00:00	4	0	6.30	4.05	1.48	7.10	3.85	1.47	9	10	9	15	8	8	24	18	17	6	12	13	30	1	2	3	3	2	1	1	-1	-1	0.80	-0.20	-0.01
2189319	2024-05-10 06:00:00	4	3	2.11	3.10	3.50	2.14	3.05	3.50	1	2	4	2	2	5	3	4	9	8	7	2	11	3	2	1	1	2	3	1	-1	0	0.03	-0.05	0.00
1992118	2023-06-07 06:00:00	4	3	1.75	3.45	4.60	1.75	3.50	4.50	1	2	3	2	1	0	3	3	3	1	1	1	4	1	1	1	1	1	1	0	1	-1	0.00	0.05	-0.10
1992119	2023-06-28 06:00:00	4	1	3.05	3.10	2.12	2.58	3.15	2.66	14	2	7	9	2	11	23	4	18	1	20	6	24	1	3	2	3	1	2	-1	1	1	-0.47	0.05	0.54
2189320	2024-05-31 06:00:00	4	1	1.50	3.85	6.70	1.51	3.80	6.80	2	4	4	3	4	6	5	8	10	7	4	2	12	3	2	1	1	2	3	1	-1	1	0.01	-0.05	0.10
2189325	2024-04-11 06:00:00	4	3	1.41	4.15	6.70	1.46	4.05	6.90	5	6	5	6	5	7	11	11	12	6	6	5	17	2	2	1	1	1	3	1	-1	1	0.05	-0.10	0.20
2189326	2024-05-31 06:00:00	4	3	1.19	5.90	11.00	1.23	5.80	10.00	5	6	6	7	7	5	12	13	11	10	9	11	22	2	1	3	2	3	1	1	-1	-1	0.04	-0.10	-1.00
1992110	2023-06-30 06:00:00	4	1	1.54	3.65	4.90	1.43	4.05	7.40	10	11	15	11	13	14	21	24	29	9	6	1	30	3	2	1	1	2	3	-1	1	1	-0.11	0.40	2.50
2189329	2024-05-08 06:00:00	4	0	3.30	3.10	2.21	3.15	2.94	2.36	4	8	1	4	3	5	8	11	6	5	2	7	13	2	1	3	2	3	1	-1	-1	1	-0.15	-0.16	0.15
1992108	2023-06-30 06:00:00	4	3	1.24	5.00	8.50	1.37	4.45	7.70	20	23	28	24	19	22	44	42	50	12	14	6	56	2	3	1	2	1	3	1	-1	-1	0.13	-0.55	-0.80
2189333	2024-05-29 06:00:00	4	3	2.03	3.20	3.35	2.04	3.20	3.65	7	2	5	8	2	6	15	4	11	3	14	7	18	1	3	2	3	1	2	1	0	1	0.01	0.00	0.30
1992107	2023-06-07 08:00:00	4	3	1.60	3.50	5.90	1.60	3.60	5.60	11	6	12	8	8	14	19	14	26	10	15	3	29	2	3	1	2	1	3	0	1	-1	0.00	0.10	-0.30
2093734	2023-09-28 08:30:00	4	1	1.79	3.30	4.60	1.85	3.10	4.55	0	4	2	2	0	4	2	4	6	5	3	1	7	3	2	1	1	2	3	1	-1	-1	0.06	-0.20	-0.05
1992100	2023-06-29 08:30:00	4	3	1.71	3.65	4.55	1.64	3.80	4.85	8	8	9	9	7	7	17	15	16	3	5	4	20	1	3	2	3	1	2	-1	1	1	-0.07	0.15	0.30
1992098	2023-06-08 06:00:00	4	3	1.31	5.10	8.20	1.27	5.20	10.00	6	4	3	3	4	7	9	8	10	6	7	5	15	2	3	1	2	1	3	-1	1	1	-0.04	0.10	1.80
1992099	2023-06-29 08:30:00	4	3	1.71	3.80	4.30	1.70	3.75	4.45	5	3	4	3	3	6	8	6	10	3	5	1	11	2	3	1	2	1	3	-1	-1	1	-0.01	-0.05	0.15
2189343	2024-05-15 08:30:00	4	3	1.36	4.50	7.80	1.36	4.65	7.50	4	4	7	4	6	7	8	10	14	8	6	2	16	3	2	1	1	2	3	0	1	-1	0.00	0.15	-0.30
2189342	2024-05-08 08:00:00	4	1	3.40	3.35	2.06	3.55	3.40	1.98	5	3	13	10	4	4	15	7	17	9	17	7	24	2	3	1	2	1	3	1	1	-1	0.15	0.05	-0.08
2189283	2024-06-09 06:00:00	4	1	1.64	3.50	4.50	1.61	3.65	5.40	2	1	3	1	4	3	3	5	6	4	2	1	7	3	2	1	1	2	3	-1	1	1	-0.03	0.15	0.90
2189282	2024-06-05 08:00:00	4	0	3.75	3.25	1.97	3.05	3.20	2.29	18	10	8	9	9	18	27	19	26	11	19	12	38	1	3	2	3	1	2	-1	-1	1	-0.70	-0.05	0.32
2189285	2024-05-30 06:00:00	4	3	1.21	5.70	13.00	1.23	5.50	12.00	1	5	2	4	2	2	5	7	4	2	0	3	7	2	1	3	2	3	1	1	-1	-1	0.02	-0.20	-1.00
2189292	2024-04-25 06:00:00	4	3	1.39	4.45	7.30	1.38	4.45	7.70	3	4	4	3	2	6	6	6	10	4	4	0	10	2	2	1	1	1	3	-1	0	1	-0.01	0.00	0.40
2288495	2024-09-19 06:00:00	4	3	2.18	2.97	3.05	2.47	2.79	3.15	6	20	8	11	12	9	17	32	17	19	4	19	36	2	1	2	1	3	1	1	-1	1	0.29	-0.18	0.10
2189294	2024-05-09 08:30:00	4	3	1.59	3.90	5.20	1.59	3.90	5.10	6	4	4	4	5	6	10	9	10	1	2	1	11	1	3	1	2	1	2	0	0	-1	0.00	0.00	-0.10
2288493	2024-09-19 08:30:00	4	1	1.78	3.35	4.60	1.84	3.15	4.55	7	9	15	6	5	20	13	14	35	26	25	4	39	3	2	1	1	2	3	1	-1	-1	0.06	-0.20	-0.05
2189297	2024-05-29 06:00:00	4	3	1.43	4.30	6.80	1.45	4.25	6.50	2	4	7	5	4	5	7	8	12	6	5	1	13	3	2	1	1	2	3	1	-1	-1	0.02	-0.05	-0.30
2288498	2024-09-26 08:30:00	4	1	2.58	2.95	2.83	2.67	2.92	2.75	8	3	8	8	2	7	16	5	15	2	13	3	18	1	3	2	3	1	2	1	-1	-1	0.09	-0.03	-0.08
2288499	2024-09-26 06:00:00	4	3	1.80	3.40	4.35	1.77	3.35	4.60	8	4	5	5	4	11	13	8	16	3	8	0	16	2	3	1	2	1	3	-1	-1	1	-0.03	-0.05	0.25
2189298	2024-05-29 06:00:00	4	1	2.67	3.10	2.48	2.75	3.20	2.48	4	1	4	6	2	5	10	3	9	0	7	1	10	1	3	2	3	1	2	1	1	0	0.08	0.10	0.00
2189301	2024-04-11 08:30:00	4	3	1.11	7.90	17.00	1.14	7.00	16.00	3	15	10	6	8	7	9	23	17	17	3	9	26	3	1	2	1	3	2	1	-1	-1	0.03	-0.90	-1.00
2189305	2024-05-08 08:00:00	4	3	5.70	3.85	1.54	6.80	4.10	1.45	4	3	3	4	5	4	8	8	7	1	1	2	9	1	1	3	2	2	1	1	1	-1	1.10	0.25	-0.09
2189308	2024-05-16 08:30:00	4	3	1.14	7.00	17.00	1.14	7.20	17.00	4	7	5	5	6	4	9	13	9	5	1	5	14	2	1	2	1	3	1	0	1	0	0.00	0.20	0.00
2189311	2024-05-29 08:00:00	4	3	1.12	7.90	15.00	1.12	7.80	18.00	2	4	3	2	6	4	4	10	7	8	2	5	12	3	1	2	1	3	2	0	-1	1	0.00	-0.10	3.00
1992129	2023-06-09 08:00:00	4	3	2.09	3.25	3.40	2.12	3.25	3.35	2	2	2	3	3	2	5	5	4	4	4	5	9	1	1	3	2	2	1	1	0	-1	0.03	0.00	-0.05
1992060	2023-06-29 08:30:00	4	3	1.13	7.90	16.00	1.12	8.10	17.00	3	4	3	3	5	5	6	9	8	4	1	2	10	3	1	2	1	3	2	-1	1	1	-0.01	0.20	1.00
2256576	2024-08-14 08:30:00	4	1	3.05	2.86	2.49	2.91	2.82	2.62	5	4	0	2	3	3	7	7	3	3	3	7	10	1	1	3	2	2	1	-1	-1	1	-0.14	-0.04	0.13
2256577	2024-08-21 08:30:00	4	3	1.57	3.55	6.30	1.57	3.60	6.20	9	13	15	9	11	18	18	24	33	20	14	5	38	3	2	1	1	2	3	0	1	-1	0.00	0.05	-0.10
1992058	2023-06-29 08:30:00	4	3	1.34	4.70	8.00	1.45	4.30	6.50	7	12	12	12	7	8	19	19	20	3	3	2	22	2	2	1	1	1	3	1	-1	-1	0.11	-0.40	-1.50
2256582	2024-08-15 08:30:00	4	0	2.85	3.15	2.44	2.89	3.10	2.44	7	5	1	7	4	2	14	9	3	0	5	11	14	1	2	3	3	2	1	1	-1	0	0.04	-0.05	0.00
1992059	2023-06-09 08:00:00	4	3	1.39	4.40	7.80	1.36	4.60	7.70	14	10	18	10	16	20	24	26	38	17	15	3	41	3	2	1	1	2	3	-1	1	-1	-0.03	0.20	-0.10
2256583	2024-08-22 08:30:00	4	3	1.55	3.65	6.10	1.57	3.60	6.00	4	5	9	5	4	6	9	9	15	9	9	3	18	2	2	1	1	1	3	1	-1	-1	0.02	-0.05	-0.10
2256580	2024-08-15 08:30:00	4	3	2.47	3.05	2.88	2.42	3.00	2.99	2	3	5	1	1	11	3	4	16	13	12	0	16	3	2	1	1	2	3	-1	-1	1	-0.05	-0.05	0.11
2256581	2024-08-22 08:30:00	4	1	1.77	3.40	4.50	1.72	3.55	4.65	5	4	10	3	7	9	8	11	19	12	9	1	20	3	2	1	1	2	3	-1	1	1	-0.05	0.15	0.15
2256586	2024-08-23 06:00:00	4	3	1.60	3.55	5.80	1.72	3.30	5.10	5	5	9	8	3	8	13	8	17	4	9	0	17	2	3	1	2	1	3	1	-1	-1	0.12	-0.25	-0.70
2256587	2024-08-16 08:30:00	4	3	1.10	8.70	17.00	1.14	7.50	15.00	8	21	16	11	17	16	19	38	32	25	6	12	44	3	1	2	1	3	2	1	-1	-1	0.04	-1.20	-2.00
2256584	2024-08-16 06:00:00	4	1	2.95	2.96	2.36	2.49	2.84	3.05	26	12	15	17	12	28	43	24	43	4	23	4	47	1	3	1	2	1	2	-1	-1	1	-0.46	-0.12	0.69
2189261	2024-05-30 08:30:00	4	3	1.45	4.40	6.10	1.45	4.35	6.30	3	4	5	4	4	5	7	8	10	4	3	1	11	3	2	1	1	2	3	0	-1	1	0.00	-0.05	0.20
2081010	2023-08-24 08:30:00	4	1	1.99	3.10	3.90	1.99	3.10	3.95	5	6	6	5	5	9	10	11	15	5	4	0	15	3	2	1	1	2	3	0	0	1	0.00	0.00	0.05
2256588	2024-08-23 08:30:00	4	3	1.85	3.70	3.70	1.95	3.45	3.60	14	12	15	12	8	17	26	20	32	13	19	7	39	2	3	1	2	1	3	1	-1	-1	0.10	-0.25	-0.10
2189262	2024-05-30 08:30:00	4	1	2.06	3.20	3.55	2.16	3.20	3.30	3	1	4	4	2	3	7	3	7	0	4	0	7	1	3	1	2	1	2	1	0	-1	0.10	0.00	-0.25
2081005	2023-08-25 08:30:00	4	3	1.38	4.50	7.50	1.39	4.35	7.60	4	6	5	5	5	6	9	11	11	4	2	2	13	3	1	1	1	2	2	1	-1	1	0.01	-0.15	0.10
2189267	2024-04-05 08:00:00	4	3	2.46	3.10	2.86	2.40	3.05	2.96	9	2	7	9	1	11	18	3	18	0	15	0	18	1	3	1	2	1	2	-1	-1	1	-0.06	-0.05	0.10
2081004	2023-08-30 06:00:00	4	3	1.20	5.50	12.00	1.26	5.30	9.50	2	2	5	3	1	3	5	3	8	3	5	0	8	2	3	1	2	1	3	1	-1	-1	0.06	-0.20	-2.50
2189268	2024-05-09 06:00:00	4	3	1.67	3.60	4.45	1.56	3.80	5.50	8	3	5	3	6	10	11	9	15	4	6	0	15	2	3	1	2	1	3	-1	1	1	-0.11	0.20	1.05
2047976	2023-08-04 08:00:00	4	3	1.19	6.40	12.00	1.19	6.40	11.00	3	2	3	3	5	3	6	7	6	4	3	4	10	2	1	2	1	3	1	0	0	-1	0.00	0.00	-1.00
2047972	2023-08-03 08:30:00	4	0	2.47	3.05	2.89	2.47	3.05	2.87	1	0	4	3	0	1	4	0	5	1	5	0	5	2	3	1	2	1	3	0	0	-1	0.00	0.00	-0.02
2047971	2023-08-03 08:00:00	4	1	2.76	3.00	2.60	2.91	2.94	2.53	4	2	4	5	1	4	9	3	8	1	7	2	10	1	3	2	3	1	2	1	-1	-1	0.15	-0.06	-0.07
2033567	2023-07-03 00:00:00	5	3	1.91	3.40	3.55	1.88	3.55	3.75	7	2	2	3	4	6	10	6	8	1	5	3	11	1	3	2	3	1	2	-1	1	1	-0.03	0.15	0.20
2022175	2023-06-22 00:00:00	5	1	3.25	3.30	1.97	3.05	3.45	2.16	3	1	4	3	2	4	6	3	8	2	5	0	8	2	3	1	2	1	3	-1	1	1	-0.20	0.15	0.19
2043801	2023-07-09 00:00:00	5	3	2.47	3.10	2.68	2.52	3.30	2.87	13	1	10	11	2	15	24	3	25	2	23	1	26	2	3	1	2	1	3	1	1	1	0.05	0.20	0.19
2041733	2023-07-06 03:00:00	5	3	1.72	3.70	4.05	1.72	3.80	4.25	4	2	4	4	5	6	8	7	10	3	4	1	11	2	3	1	2	1	3	0	1	1	0.00	0.10	0.20
2041732	2023-07-06 00:00:00	5	0	8.30	4.15	1.36	8.90	4.35	1.36	12	7	8	9	7	9	21	14	17	2	9	6	23	1	3	2	3	1	2	1	1	0	0.60	0.20	0.00
2033535	2023-07-02 03:00:00	5	1	1.37	4.60	6.90	1.38	4.85	8.30	4	3	4	4	4	5	8	7	9	1	2	0	9	2	3	1	2	1	3	1	1	1	0.01	0.25	1.40
2033534	2023-07-02 00:00:00	5	1	2.38	3.05	2.84	2.47	3.05	2.71	0	1	3	2	1	2	2	2	5	3	3	0	5	2	2	1	1	1	3	1	0	-1	0.09	0.00	-0.13
2022198	2023-06-29 02:45:00	5	0	1.63	3.95	3.90	1.59	4.10	4.90	3	2	2	2	3	4	5	5	6	2	2	1	7	2	2	1	1	1	3	-1	1	1	-0.04	0.15	1.00
2022196	2023-06-26 02:45:00	5	0	5.50	4.30	1.46	5.30	4.30	1.51	3	3	3	4	3	3	7	6	6	1	2	2	8	1	2	2	3	1	1	-1	0	1	-0.20	0.00	0.05
2022197	2023-06-29 02:45:00	5	0	3.00	3.55	1.98	3.65	3.75	1.85	1	2	6	4	4	3	5	6	9	6	5	2	11	3	2	1	1	2	3	1	1	-1	0.65	0.20	-0.13
2022194	2023-06-23 02:45:00	5	3	2.19	3.30	2.79	2.35	3.35	2.80	0	2	4	4	1	2	4	3	6	3	4	1	7	2	3	1	2	1	3	1	1	1	0.16	0.05	0.01
2022195	2023-06-26 00:00:00	5	0	3.35	3.45	1.96	3.70	3.60	1.89	1	0	3	4	3	1	5	3	4	0	2	1	5	1	3	2	3	1	2	1	1	-1	0.35	0.15	-0.07
2022192	2023-06-29 00:00:00	5	3	2.89	3.35	2.11	2.97	3.35	2.25	2	1	1	2	1	1	4	2	2	0	2	2	4	1	2	2	3	1	1	1	0	1	0.08	0.00	0.14
2022193	2023-06-23 00:00:00	5	0	2.51	3.30	2.39	2.67	3.35	2.46	1	0	1	3	1	2	4	1	3	0	3	1	4	1	3	2	3	1	2	1	1	1	0.16	0.05	0.07
2022190	2023-06-26 00:00:00	5	3	4.95	3.75	1.59	4.80	3.85	1.63	2	0	2	2	1	2	4	1	4	0	3	0	4	1	3	1	2	1	2	-1	1	1	-0.15	0.10	0.04
2022191	2023-06-29 00:00:00	5	3	2.47	3.40	2.37	2.51	3.45	2.56	15	1	9	11	2	16	26	3	25	0	23	1	26	1	3	2	3	1	2	1	1	1	0.04	0.05	0.19
2022188	2023-06-23 00:00:00	5	0	5.10	3.90	1.54	5.20	3.90	1.58	0	0	1	2	1	1	2	1	2	0	1	0	2	1	3	1	2	1	2	1	0	1	0.10	0.00	0.04
2022189	2023-06-26 00:00:00	5	3	1.31	4.80	7.40	1.35	4.90	7.40	1	1	0	2	2	1	3	3	1	0	0	2	3	1	1	3	2	2	1	1	1	0	0.04	0.10	0.00
2022186	2023-06-28 02:45:00	5	1	2.92	3.40	2.25	2.99	3.45	2.20	1	0	2	3	2	1	4	2	3	0	2	1	4	1	3	2	3	1	2	1	1	-1	0.07	0.05	-0.05
2022187	2023-06-23 00:00:00	5	1	1.28	5.00	7.00	1.34	5.00	7.50	2	2	1	2	3	3	4	5	4	1	0	1	5	2	1	2	1	3	1	1	0	1	0.06	0.00	0.50
2022184	2023-06-25 02:45:00	5	3	1.40	4.80	7.80	1.38	4.90	8.20	2	2	2	3	4	4	5	6	6	2	1	1	7	3	1	1	1	2	2	-1	1	1	-0.02	0.10	0.40
2022185	2023-06-28 02:45:00	5	1	1.62	3.90	4.80	1.62	3.95	4.80	7	2	4	3	4	6	10	6	10	1	5	1	11	1	3	1	2	1	2	0	1	0	0.00	0.05	0.00
2022182	2023-06-25 00:00:00	5	0	3.15	3.25	2.02	3.65	3.50	2.04	1	1	2	2	2	1	3	3	3	0	0	0	3	1	1	1	1	1	1	1	1	1	0.50	0.25	0.02
2022183	2023-06-22 02:45:00	5	0	7.00	5.30	1.26	7.90	5.30	1.31	9	4	2	5	3	6	14	7	8	1	8	7	15	1	3	2	3	1	2	1	0	1	0.90	0.00	0.05
2022180	2023-06-28 00:00:00	5	3	2.21	3.40	2.68	2.35	3.50	2.70	1	1	7	7	1	3	8	2	10	2	8	0	10	2	3	1	2	1	3	1	1	1	0.14	0.10	0.02
2022181	2023-06-22 00:00:00	5	3	2.94	3.20	2.13	2.89	3.25	2.35	4	1	1	1	2	3	5	3	4	2	4	3	7	1	3	2	3	1	2	-1	1	1	-0.05	0.05	0.22
2033571	2023-07-03 03:00:00	5	0	1.60	3.80	4.75	1.65	3.90	5.40	0	2	2	2	2	3	2	4	5	3	1	0	5	3	2	1	1	2	3	1	1	1	0.05	0.10	0.65
2022179	2023-06-28 00:00:00	5	1	4.05	3.75	1.65	4.60	3.85	1.66	4	2	4	6	3	4	10	5	8	0	5	2	10	1	3	2	3	1	2	1	1	1	0.55	0.10	0.01
2022176	2023-06-22 00:00:00	5	3	6.40	4.65	1.33	7.80	4.85	1.34	1	1	2	4	3	2	5	4	4	0	1	1	5	1	2	2	3	1	1	1	1	1	1.40	0.20	0.01
2022177	2023-06-25 00:00:00	5	1	2.63	3.50	2.61	2.65	3.45	2.62	4	1	3	4	1	5	8	2	8	0	6	0	8	1	3	1	2	1	2	1	-1	1	0.02	-0.05	0.01
2282690	2024-08-28 18:00:00	6	1	1.93	3.45	3.20	1.95	3.40	3.20	3	2	2	2	2	2	5	4	4	2	3	3	7	1	2	2	3	1	1	1	-1	0	0.02	-0.05	0.00
2237587	2024-07-17 18:00:00	6	3	2.09	3.30	2.95	2.11	3.40	2.85	3	2	5	1	4	3	4	6	8	6	4	2	10	3	2	1	1	2	3	1	1	-1	0.02	0.10	-0.10
2282691	2024-08-28 18:30:00	6	3	2.01	3.30	3.15	2.08	3.30	2.97	3	2	5	2	2	5	5	4	10	5	6	0	10	2	3	1	2	1	3	1	0	-1	0.07	0.00	-0.18
2282689	2024-08-21 18:00:00	6	0	2.77	3.25	2.22	2.75	3.25	2.23	2	0	4	4	0	3	6	0	7	1	7	0	7	2	3	1	2	1	3	-1	0	1	-0.02	0.00	0.01
2291478	2024-11-30 14:00:00	6	1	2.70	3.20	2.29	2.73	3.15	2.29	1	1	2	2	0	2	3	1	4	2	4	1	5	2	3	1	2	1	3	1	-1	0	0.03	-0.05	0.00
2237588	2024-07-17 18:00:00	6	3	1.59	3.65	4.60	1.60	3.65	4.55	2	0	2	2	0	2	4	0	4	0	4	0	4	1	3	1	2	1	2	1	0	-1	0.01	0.00	-0.05
2282692	2024-08-21 18:30:00	6	1	2.87	3.25	2.11	2.85	3.30	2.14	4	4	5	3	4	5	7	8	10	6	5	3	13	3	2	1	1	2	3	-1	1	1	-0.02	0.05	0.03
2221833	2024-06-19 18:00:00	6	1	2.03	3.20	3.20	2.03	3.20	3.20	0	0	0	0	0	0	0	0	0	1	1	1	1	1	1	1	1	1	1	0	0	0	0.00	0.00	0.00
2221834	2024-06-19 18:30:00	6	1	2.20	3.20	2.83	2.27	3.20	2.73	0	0	1	1	0	0	1	0	1	1	2	1	2	1	3	1	2	1	2	1	0	-1	0.07	0.00	-0.10
2024130	2023-06-28 18:00:00	6	3	2.06	3.10	3.20	2.08	3.10	3.15	1	1	2	2	0	0	3	1	2	0	2	1	3	1	3	2	3	1	2	1	0	-1	0.02	0.00	-0.05
2221837	2024-06-19 18:30:00	6	1	2.06	3.15	3.10	2.04	3.15	3.15	1	0	0	0	0	1	1	0	1	1	2	1	2	1	3	1	2	1	2	-1	0	1	-0.02	0.00	0.05
2024128	2023-06-28 18:00:00	6	1	1.45	4.05	5.60	1.45	4.05	5.60	1	0	0	0	1	1	1	1	1	0	0	0	1	1	1	1	1	1	1	0	0	0	0.00	0.00	0.00
2042847	2023-07-10 05:00:00	7	0	4.80	3.55	1.64	4.60	3.50	1.68	10	9	15	19	9	9	29	18	24	2	13	7	31	1	3	2	3	1	2	-1	-1	1	-0.20	-0.05	0.04
2042846	2023-07-09 09:30:00	7	3	1.33	4.65	7.60	1.25	5.30	8.90	16	12	18	12	18	24	28	30	42	15	13	1	43	3	2	1	1	2	3	-1	1	1	-0.08	0.65	1.30
2042845	2023-07-09 07:00:00	7	3	1.62	3.60	4.45	1.61	3.60	5.00	6	2	5	2	3	7	8	5	12	4	7	0	12	2	3	1	2	1	3	-1	0	1	-0.01	0.00	0.55
2049436	2023-07-13 10:00:00	7	0	5.40	3.60	1.62	5.50	3.45	1.65	2	3	1	4	1	2	6	4	3	0	2	3	6	1	2	3	3	2	1	1	-1	1	0.10	-0.15	0.03
2025754	2023-07-03 09:00:00	7	0	1.30	5.10	7.40	1.34	4.75	6.60	5	9	11	8	6	9	13	15	20	9	7	2	22	3	2	1	1	2	3	1	-1	-1	0.04	-0.35	-0.80
2049371	2023-07-13 07:30:00	7	1	1.58	3.70	5.60	1.61	3.65	5.40	2	3	3	3	3	4	5	6	7	4	3	2	9	3	2	1	1	2	3	1	-1	-1	0.03	-0.05	-0.20
2025752	2023-07-03 07:00:00	7	3	1.10	8.50	14.00	1.11	8.00	14.00	5	10	4	6	7	6	11	17	10	8	2	9	19	2	1	3	2	3	1	1	-1	0	0.01	-0.50	0.00
2025749	2023-07-05 08:30:00	7	1	2.00	3.25	3.20	1.92	3.40	3.50	20	4	14	15	7	16	35	11	30	2	26	7	37	1	3	2	3	1	2	-1	1	1	-0.08	0.15	0.30
2025746	2023-07-01 08:30:00	7	1	3.40	3.15	2.04	3.05	3.15	2.20	5	1	2	1	1	4	6	2	6	3	7	3	9	1	3	1	2	1	2	-1	0	1	-0.35	0.00	0.16
2023091	2023-06-27 08:30:00	7	0	3.05	3.05	2.37	3.25	2.99	2.29	8	10	8	12	10	6	20	20	14	4	4	10	24	1	1	3	2	2	1	1	-1	-1	0.20	-0.06	-0.08
2025747	2023-06-29 07:30:00	7	3	1.42	4.15	6.50	1.51	3.80	5.60	6	12	12	12	8	11	18	20	23	5	3	0	23	3	2	1	1	2	3	1	-1	-1	0.09	-0.35	-0.90
2023088	2023-06-25 09:30:00	7	1	1.70	3.50	4.10	1.61	3.70	4.80	12	4	9	7	7	14	19	11	23	4	12	0	23	2	3	1	2	1	3	-1	1	1	-0.09	0.20	0.70
2023089	2023-06-26 06:00:00	7	3	3.55	3.30	1.94	3.15	3.25	2.11	25	12	19	20	11	25	45	23	44	0	22	1	45	1	3	2	3	1	2	-1	-1	1	-0.40	-0.05	0.17
2050734	2023-07-17 07:30:00	7	3	1.64	3.55	6.30	1.64	3.60	6.20	1	2	3	1	4	3	2	6	6	4	0	0	6	3	1	1	1	2	2	0	1	-1	0.00	0.05	-0.10
2042848	2023-07-10 07:30:00	7	1	1.60	3.75	4.80	1.63	3.70	4.65	14	10	14	16	10	16	30	20	30	1	11	1	31	1	3	1	2	1	2	1	-1	-1	0.03	-0.05	-0.15
1962015	2023-09-03 18:00:00	8	0	2.03	3.20	3.60	2.03	3.20	3.60	1	0	0	0	1	1	1	1	1	0	0	0	1	1	1	1	1	1	1	0	0	0	0.00	0.00	0.00
1962007	2023-08-26 18:00:00	8	3	2.47	3.30	2.68	2.47	3.30	2.68	1	0	0	0	0	1	1	0	1	0	1	0	1	1	3	1	2	1	2	0	0	0	0.00	0.00	0.00
1962006	2023-08-26 17:30:00	8	3	4.40	4.55	1.58	4.40	4.55	1.58	1	0	0	0	0	0	1	0	0	0	1	1	1	1	2	2	3	1	1	0	0	0	0.00	0.00	0.00
1962003	2023-08-20 17:30:00	8	0	3.50	3.35	2.01	3.45	3.45	2.00	2	1	1	2	2	0	4	3	1	0	1	3	4	1	2	3	3	2	1	-1	1	-1	-0.05	0.10	-0.01
1961999	2023-08-19 18:00:00	8	3	2.47	3.35	2.65	2.47	3.35	2.65	0	0	1	0	0	0	0	0	1	1	1	0	1	2	2	1	1	1	3	0	0	0	0.00	0.00	0.00
1961993	2023-08-13 17:00:00	8	3	2.51	3.15	2.74	2.41	3.15	2.87	2	0	1	1	1	2	3	1	3	0	2	0	3	1	3	1	2	1	2	-1	0	1	-0.10	0.00	0.13
1961994	2023-08-13 17:00:00	8	3	2.36	3.10	3.00	2.36	3.10	3.00	1	0	0	0	0	1	1	0	1	0	1	0	1	1	3	1	2	1	2	0	0	0	0.00	0.00	0.00
1961989	2023-08-12 18:00:00	8	3	2.03	3.50	3.35	2.08	3.45	3.25	0	1	2	2	0	0	2	1	2	0	1	0	2	1	3	1	2	1	2	1	-1	-1	0.05	-0.05	-0.10
1961991	2023-08-12 18:00:00	8	0	2.13	3.50	3.05	2.13	3.50	3.05	0	0	1	0	1	0	0	1	1	1	0	0	1	3	1	1	1	2	2	0	0	0	0.00	0.00	0.00
2153531	2024-03-17 13:00:00	8	0	3.30	3.45	2.06	3.25	3.45	2.06	1	0	0	0	0	1	1	0	1	1	2	1	2	1	3	1	2	1	2	-1	0	0	-0.05	0.00	0.00
2153535	2024-03-30 15:00:00	8	3	3.10	3.30	2.20	3.10	3.30	2.20	1	0	0	0	0	1	1	0	1	0	1	0	1	1	3	1	2	1	2	0	0	0	0.00	0.00	0.00
2139137	2024-03-02 14:00:00	8	1	2.19	3.15	3.25	2.19	3.15	3.25	0	0	1	1	0	0	1	0	1	0	1	0	1	1	3	1	2	1	2	0	0	0	0.00	0.00	0.00
2139138	2024-03-03 15:00:00	8	1	1.65	3.65	5.00	1.66	3.65	4.90	0	0	2	2	0	0	2	0	2	0	2	0	2	1	3	1	2	1	2	1	0	-1	0.01	0.00	-0.10
1962041	2023-09-30 18:00:00	8	3	1.97	3.30	3.75	1.97	3.30	3.75	0	1	1	1	0	0	1	1	1	0	0	0	1	1	1	1	1	1	1	0	0	0	0.00	0.00	0.00
2139141	2024-03-01 18:00:00	8	0	1.77	3.70	4.05	1.77	3.70	4.05	0	1	0	0	0	0	0	1	0	1	0	1	1	2	1	2	1	3	1	0	0	0	0.00	0.00	0.00
1962043	2023-09-29 18:00:00	8	0	2.12	3.85	2.86	2.17	3.85	2.79	0	0	2	1	1	1	1	1	3	2	2	0	3	2	2	1	1	1	3	1	0	-1	0.05	0.00	-0.07
1962037	2023-09-24 15:00:00	8	0	3.25	3.55	2.03	3.60	3.75	1.87	5	1	6	6	5	4	11	6	10	0	5	1	11	1	3	2	3	1	2	1	1	-1	0.35	0.20	-0.16
1962039	2023-09-23 18:00:00	8	3	2.14	3.45	3.10	2.14	3.45	3.10	0	0	1	0	1	0	0	1	1	1	0	0	1	3	1	1	1	2	2	0	0	0	0.00	0.00	0.00
1962033	2023-09-24 14:00:00	8	0	2.37	3.60	2.64	2.35	3.60	2.67	1	0	1	1	0	1	2	0	2	0	2	0	2	1	3	1	2	1	2	-1	0	1	-0.02	0.00	0.03
1962034	2023-09-24 16:00:00	8	0	3.10	3.20	2.26	3.05	3.25	2.26	1	0	0	1	1	0	2	1	0	0	1	2	2	1	2	3	3	2	1	-1	1	0	-0.05	0.05	0.00
1962030	2023-09-23 13:00:00	8	3	1.93	3.40	3.75	2.00	3.35	3.55	1	1	3	3	1	1	4	2	4	1	3	1	5	1	3	1	2	1	2	1	-1	-1	0.07	-0.05	-0.20
1962017	2023-09-02 18:00:00	8	3	2.91	3.85	2.09	2.91	3.85	2.09	1	0	0	0	1	0	1	1	0	0	0	1	1	1	1	3	2	2	1	0	0	0	0.00	0.00	0.00
2153568	2024-03-16 13:00:00	8	1	2.97	3.20	2.31	3.00	3.20	2.29	0	0	2	2	0	0	2	0	2	0	2	0	2	1	3	1	2	1	2	1	0	-1	0.03	0.00	-0.02
2153571	2024-05-06 14:00:00	8	0	1.47	4.00	6.80	1.47	3.95	6.90	0	1	0	0	0	2	0	1	2	2	1	0	2	3	2	1	1	2	3	0	-1	1	0.00	-0.05	0.10
1962075	2023-11-12 13:00:00	8	3	1.82	3.85	3.70	1.87	3.80	3.55	1	1	1	1	1	1	2	2	2	0	0	0	2	1	1	1	1	1	1	1	-1	-1	0.05	-0.05	-0.15
1962074	2023-11-12 14:00:00	8	0	2.51	3.15	2.76	2.47	3.15	2.81	3	0	1	1	0	3	4	0	4	0	4	0	4	1	3	1	2	1	2	-1	0	1	-0.04	0.00	0.05
2153576	2024-04-07 16:00:00	8	3	2.92	3.15	2.38	2.91	3.15	2.38	1	0	0	1	0	0	2	0	0	0	2	2	2	1	2	2	3	1	1	-1	0	0	-0.01	0.00	0.00
1962070	2023-11-11 14:00:00	8	1	2.19	3.15	3.25	2.07	3.20	3.50	2	0	1	1	1	2	3	1	3	0	2	0	3	1	3	1	2	1	2	-1	1	1	-0.12	0.05	0.25
1962065	2023-10-27 18:00:00	8	1	1.72	3.75	4.30	1.69	3.80	4.45	1	1	0	0	1	2	1	2	2	1	0	0	2	3	1	1	1	2	2	-1	1	1	-0.03	0.05	0.15
2153582	2024-04-20 13:00:00	8	3	3.70	3.40	1.94	3.60	3.35	1.99	6	1	2	2	0	8	8	1	10	2	9	0	10	2	3	1	2	1	3	-1	-1	1	-0.10	-0.05	0.05
2153583	2024-05-03 13:00:00	8	1	2.00	3.60	3.30	2.02	3.60	3.25	2	1	2	4	1	0	6	2	2	0	4	4	6	1	2	2	3	1	1	1	0	-1	0.02	0.00	-0.05
1962060	2023-10-28 14:00:00	8	0	3.30	3.60	2.01	3.50	3.60	1.93	4	2	4	4	2	6	8	4	10	3	7	1	11	2	3	1	2	1	3	1	0	-1	0.20	0.00	-0.08
2153585	2024-04-20 14:00:00	8	0	4.00	3.55	1.82	4.00	3.55	1.82	1	0	0	0	0	1	1	0	1	0	1	0	1	1	3	1	2	1	2	0	0	0	0.00	0.00	0.00
1962063	2023-10-29 14:00:00	8	1	2.87	3.45	2.26	2.88	3.45	2.25	1	0	1	1	0	1	2	0	2	0	2	0	2	1	3	1	2	1	2	1	0	-1	0.01	0.00	-0.01
1962062	2023-10-28 13:00:00	8	1	2.49	3.05	2.87	2.45	3.05	2.92	1	0	2	2	0	1	3	0	3	0	3	0	3	1	3	1	2	1	2	-1	0	1	-0.04	0.00	0.05
2153587	2024-04-27 13:00:00	8	0	2.21	3.20	3.15	2.21	3.20	3.15	0	0	1	1	0	0	1	0	1	0	1	0	1	1	3	1	2	1	2	0	0	0	0.00	0.00	0.00
1962056	2023-10-21 13:00:00	8	3	2.23	3.20	2.95	2.23	3.20	2.95	0	0	1	1	0	0	1	0	1	0	1	0	1	1	3	1	2	1	2	0	0	0	0.00	0.00	0.00
2153592	2024-04-27 14:00:00	8	1	2.28	3.45	2.86	2.26	3.45	2.86	1	0	3	1	0	2	2	0	5	3	5	0	5	2	3	1	2	1	3	-1	0	0	-0.02	0.00	0.00
2153594	2024-05-03 14:00:00	8	3	1.81	3.50	4.15	1.81	3.50	4.15	0	1	2	1	1	1	1	2	3	2	1	0	3	3	2	1	1	2	3	0	0	0	0.00	0.00	0.00
1962049	2023-10-20 18:00:00	8	3	1.83	3.45	3.75	1.83	3.45	3.75	1	1	0	0	2	1	1	3	1	2	0	2	3	2	1	2	1	3	1	0	0	0	0.00	0.00	0.00
2153597	2024-04-13 14:00:00	8	0	2.87	3.15	2.40	2.87	3.15	2.40	1	0	0	0	0	1	1	0	1	0	1	0	1	1	3	1	2	1	2	0	0	0	0.00	0.00	0.00
2153598	2024-05-03 15:00:00	8	3	2.47	3.00	2.91	2.49	3.05	2.87	0	1	4	1	3	2	1	4	6	5	2	0	6	3	2	1	1	2	3	1	1	-1	0.02	0.05	-0.04
1962050	2023-10-21 15:00:00	8	1	1.79	3.45	3.95	1.81	3.45	3.90	0	0	2	2	0	0	2	0	2	0	2	0	2	1	3	1	2	1	2	1	0	-1	0.02	0.00	-0.05
2153599	2024-04-12 18:00:00	8	3	2.72	3.10	2.58	2.78	3.15	2.48	8	1	12	12	2	5	20	3	17	1	18	4	21	1	3	2	3	1	2	1	1	-1	0.06	0.05	-0.10
2153537	2024-03-09 13:00:00	8	3	2.99	3.05	2.40	3.00	3.00	2.40	1	1	0	1	0	1	2	1	1	0	1	1	2	1	2	2	3	1	1	1	-1	0	0.01	-0.05	0.00
2153539	2024-04-07 14:00:00	8	0	2.20	3.40	3.05	2.20	3.45	2.99	0	0	2	1	1	0	1	1	2	2	2	1	3	2	2	1	1	1	3	0	1	-1	0.00	0.05	-0.06
2153544	2024-04-21 14:00:00	8	3	2.79	3.10	2.52	2.89	3.05	2.45	1	1	3	4	1	0	5	2	3	0	3	2	5	1	3	2	3	1	2	1	-1	-1	0.10	-0.05	-0.07
2153546	2024-03-09 15:00:00	8	3	1.98	3.30	3.70	2.00	3.25	3.65	0	1	2	2	0	0	2	1	2	0	1	0	2	1	3	1	2	1	2	1	-1	-1	0.02	-0.05	-0.05
2153549	2024-04-07 14:00:00	8	3	1.62	3.90	4.85	1.62	3.90	4.85	0	0	1	1	0	0	1	0	1	0	1	0	1	1	3	1	2	1	2	0	0	0	0.00	0.00	0.00
2153551	2024-04-10 18:00:00	8	3	1.89	3.65	3.65	1.88	3.75	3.55	4	1	3	1	4	3	5	5	6	5	5	4	10	2	2	1	1	1	3	-1	1	-1	-0.01	0.10	-0.10
1962092	2023-12-03 13:00:00	8	0	3.60	3.65	1.89	3.60	3.65	1.89	0	0	0	0	0	0	0	0	0	1	1	1	1	1	1	1	1	1	1	0	0	0	0.00	0.00	0.00
2153556	2024-03-09 15:00:00	8	0	1.76	3.75	4.10	1.76	3.75	4.10	0	0	1	1	0	0	1	0	1	0	1	0	1	1	3	1	2	1	2	0	0	0	0.00	0.00	0.00
2153560	2024-04-13 13:00:00	8	1	1.75	3.80	4.05	1.82	3.70	3.80	0	2	4	4	0	1	4	2	5	2	4	1	6	2	3	1	2	1	3	1	-1	-1	0.07	-0.10	-0.25
1962084	2023-11-24 18:00:00	8	1	1.54	4.35	5.10	1.55	4.25	5.10	3	7	6	5	4	4	8	11	10	4	1	2	12	3	1	2	1	3	2	1	-1	0	0.01	-0.10	0.00
2153561	2024-03-09 14:00:00	8	3	1.48	4.40	5.90	1.42	4.55	6.60	3	1	2	2	2	2	5	3	4	2	4	3	7	1	3	2	3	1	2	-1	1	1	-0.06	0.15	0.70
2153564	2024-03-16 15:00:00	8	1	2.63	3.15	2.61	2.56	3.20	2.67	2	0	1	0	1	2	2	1	3	1	2	0	3	2	3	1	2	1	3	-1	1	1	-0.07	0.05	0.06
1962082	2023-11-25 13:00:00	8	3	1.80	3.45	4.25	1.72	3.60	4.55	4	0	1	0	3	4	4	3	5	2	3	1	6	2	3	1	2	1	3	-1	1	1	-0.08	0.15	0.30
2153632	2024-06-16 17:00:00	8	1	2.17	3.15	3.30	2.14	3.15	3.35	1	0	1	1	0	1	2	0	2	0	2	0	2	1	3	1	2	1	2	-1	0	1	-0.03	0.00	0.05
2153633	2024-06-01 13:00:00	8	3	1.34	4.80	7.90	1.35	4.75	7.90	2	4	5	4	2	4	6	6	9	4	4	1	10	2	2	1	1	1	3	1	-1	0	0.01	-0.05	0.00
2153635	2024-06-26 18:00:00	8	1	1.83	3.90	3.60	1.78	4.00	3.75	6	3	3	4	6	4	10	9	7	2	3	5	12	1	2	3	3	2	1	-1	1	1	-0.05	0.10	0.15
2153639	2024-06-16 13:00:00	8	3	1.84	3.40	4.10	1.84	3.45	4.05	3	3	4	4	3	2	7	6	6	0	1	1	7	1	2	2	3	1	1	0	1	-1	0.00	0.05	-0.05
2153640	2024-06-22 18:00:00	8	3	2.49	3.40	2.59	2.52	3.40	2.57	1	0	3	4	0	1	5	0	4	0	5	1	5	1	3	2	3	1	2	1	0	-1	0.03	0.00	-0.02
2153641	2024-05-19 15:00:00	8	3	1.85	3.70	3.70	1.84	3.70	3.75	1	0	1	1	0	1	2	0	2	0	2	0	2	1	3	1	2	1	2	-1	0	1	-0.01	0.00	0.05
2153643	2024-06-26 18:00:00	8	3	2.62	3.20	2.59	2.47	3.20	2.77	6	0	4	4	0	6	10	0	10	0	10	0	10	1	3	1	2	1	2	-1	0	1	-0.15	0.00	0.18
2153646	2024-06-15 18:00:00	8	3	2.73	3.20	2.49	2.75	3.20	2.48	1	0	1	1	0	1	2	0	2	0	2	0	2	1	3	1	2	1	2	1	0	-1	0.02	0.00	-0.01
2153647	2024-06-16 17:00:00	8	1	1.83	3.50	4.05	1.83	3.50	4.05	2	0	0	1	1	1	3	1	1	0	2	2	3	1	2	2	3	1	1	0	0	0	0.00	0.00	0.00
2153648	2024-06-26 18:00:00	8	1	2.16	3.30	3.20	2.16	3.25	3.20	1	1	0	0	1	1	1	2	1	1	0	1	2	2	1	2	1	3	1	0	-1	0	0.00	-0.05	0.00
2153649	2024-06-01 15:00:00	8	1	2.88	3.25	2.36	2.88	3.25	2.35	2	0	1	1	0	1	3	0	2	0	3	1	3	1	3	2	3	1	2	0	0	-1	0.00	0.00	-0.01
2153650	2024-05-15 18:00:00	8	3	2.47	3.10	2.83	2.47	3.15	2.81	0	0	1	0	1	1	0	1	2	2	1	0	2	3	2	1	1	2	3	0	1	-1	0.00	0.05	-0.02
2153653	2024-06-23 13:00:00	8	0	3.00	3.90	2.03	2.93	3.90	2.07	3	0	1	0	0	3	3	0	4	1	4	0	4	2	3	1	2	1	3	-1	0	1	-0.07	0.00	0.04
2153654	2024-06-16 17:00:00	8	3	2.38	3.20	2.88	2.38	3.20	2.88	0	0	1	1	0	0	1	0	1	0	1	0	1	1	3	1	2	1	2	0	0	0	0.00	0.00	0.00
2153655	2024-06-26 18:00:00	8	3	1.90	3.70	3.55	1.94	3.65	3.45	3	2	5	6	1	3	9	3	8	0	6	1	9	1	3	2	3	1	2	1	-1	-1	0.04	-0.05	-0.10
2153600	2024-05-06 16:00:00	8	3	2.07	3.60	3.15	2.05	3.65	3.15	2	3	3	1	3	4	3	6	7	6	3	2	9	3	2	1	1	2	3	-1	1	0	-0.02	0.05	0.00
2153601	2024-05-03 18:00:00	8	0	3.90	3.35	1.91	4.05	3.30	1.89	2	2	3	5	2	2	7	4	5	0	3	2	7	1	3	2	3	1	2	1	-1	-1	0.15	-0.05	-0.02
2153603	2024-04-06 13:00:00	8	3	2.58	3.55	2.43	2.58	3.50	2.46	2	1	4	6	0	3	8	1	7	0	7	1	8	1	3	2	3	1	2	0	-1	1	0.00	-0.05	0.03
2153606	2024-04-14 14:00:00	8	3	1.95	3.50	3.55	1.95	3.50	3.55	2	2	2	3	2	1	5	4	3	0	1	2	5	1	2	3	3	2	1	0	0	0	0.00	0.00	0.00
2153608	2024-04-03 18:00:00	8	1	2.25	3.60	2.81	2.25	3.60	2.81	0	0	0	0	1	0	0	1	0	1	0	1	1	2	1	2	1	3	1	0	0	0	0.00	0.00	0.00
2153610	2024-03-17 14:00:00	8	3	2.54	3.10	2.76	2.54	3.10	2.76	1	0	1	0	1	0	1	1	1	0	0	0	1	1	1	1	1	1	1	0	0	0	0.00	0.00	0.00
2153613	2024-04-20 15:00:00	8	0	1.97	3.35	3.70	2.02	3.30	3.55	0	1	3	5	0	0	5	1	3	0	4	2	5	1	3	2	3	1	2	1	-1	-1	0.05	-0.05	-0.15
2153614	2024-05-03 15:00:00	8	3	2.46	3.15	2.83	2.50	3.00	2.87	3	6	2	7	2	6	10	8	8	3	5	5	13	1	2	2	3	1	1	1	-1	1	0.04	-0.15	0.04
2153615	2024-05-03 14:00:00	8	1	1.76	3.65	4.20	1.76	3.65	4.20	0	0	1	1	0	0	1	0	1	0	1	0	1	1	3	1	2	1	2	0	0	0	0.00	0.00	0.00
2153617	2024-03-30 13:00:00	8	3	1.62	3.85	4.95	1.62	3.85	4.95	0	0	1	1	0	0	1	0	1	0	1	0	1	1	3	1	2	1	2	0	0	0	0.00	0.00	0.00
2153618	2024-04-28 14:00:00	8	1	1.76	3.65	4.25	1.82	3.55	4.00	2	3	4	4	2	3	6	5	7	2	3	1	8	2	3	1	2	1	3	1	-1	-1	0.06	-0.10	-0.25
2153619	2024-05-06 15:00:00	8	0	2.47	3.15	2.81	2.47	3.10	2.83	0	1	2	1	0	3	1	1	5	4	4	0	5	2	2	1	1	1	3	0	-1	1	0.00	-0.05	0.02
2153620	2024-04-27 13:00:00	8	0	1.67	3.75	4.70	1.59	3.95	5.10	2	1	6	2	3	3	4	4	9	5	5	0	9	2	2	1	1	1	3	-1	1	1	-0.08	0.20	0.40
2153621	2024-04-28 13:00:00	8	1	1.74	3.60	4.40	1.74	3.55	4.45	0	2	3	1	1	4	1	3	7	6	4	0	7	3	2	1	1	2	3	0	-1	1	0.00	-0.05	0.05
2153622	2024-03-29 18:00:00	8	1	2.56	3.10	2.72	2.52	3.10	2.77	3	0	1	1	0	3	4	0	4	0	4	0	4	1	3	1	2	1	2	-1	0	1	-0.04	0.00	0.05
2153631	2024-06-22 18:00:00	8	0	3.25	3.50	2.05	3.25	3.55	2.04	0	0	2	0	1	0	0	1	2	2	1	0	2	3	2	1	1	2	3	0	1	-1	0.00	0.05	-0.01
2153697	2024-06-01 14:00:00	8	3	2.13	3.65	2.98	2.13	3.65	2.96	0	0	2	1	0	0	1	0	2	1	2	0	2	2	3	1	2	1	3	0	0	-1	0.00	0.00	-0.02
2153701	2024-06-22 17:00:00	8	3	2.65	3.20	2.57	2.71	3.20	2.52	1	0	3	2	1	0	3	1	3	0	2	0	3	1	3	1	2	1	2	1	0	-1	0.06	0.00	-0.05
2153702	2024-06-02 18:00:00	8	0	2.02	3.20	3.65	2.06	3.20	3.55	1	0	2	4	0	0	5	0	2	0	5	3	5	1	3	2	3	1	2	1	0	-1	0.04	0.00	-0.10
2153705	2024-05-18 18:00:00	8	0	2.87	3.20	2.38	2.87	3.20	2.38	1	0	0	0	0	0	1	0	0	0	1	1	1	1	2	2	3	1	1	0	0	0	0.00	0.00	0.00
2153710	2024-06-22 17:30:00	8	3	3.30	3.25	2.13	3.30	3.25	2.12	2	0	3	2	0	3	4	0	6	2	6	0	6	2	3	1	2	1	3	0	0	-1	0.00	0.00	-0.01
2153711	2024-06-15 17:30:00	8	3	1.54	4.15	5.30	1.54	4.10	5.50	0	1	1	0	1	2	0	2	3	3	1	0	3	3	2	1	1	2	3	0	-1	1	0.00	-0.05	0.20
2153714	2024-05-31 18:00:00	8	0	2.85	3.45	2.28	2.85	3.45	2.28	1	0	0	0	0	1	1	0	1	0	1	0	1	1	3	1	2	1	2	0	0	0	0.00	0.00	0.00
2153715	2024-06-15 15:00:00	8	0	2.59	3.55	2.43	2.56	3.55	2.46	2	0	2	2	0	2	4	0	4	0	4	0	4	1	3	1	2	1	2	-1	0	1	-0.03	0.00	0.03
2153716	2024-06-26 18:00:00	8	1	2.20	3.15	3.25	2.20	3.20	3.20	0	1	2	1	1	0	1	2	2	1	0	0	2	3	1	1	1	2	2	0	1	-1	0.00	0.05	-0.05
2153723	2024-08-07 18:00:00	8	3	2.76	3.10	2.51	2.78	3.15	2.50	4	0	5	4	1	3	8	1	8	1	8	1	9	1	3	1	2	1	2	1	1	-1	0.02	0.05	-0.01
2153727	2024-07-05 18:00:00	8	0	2.29	3.30	2.93	2.29	3.35	2.92	1	6	8	1	7	8	2	13	16	15	4	1	17	3	2	1	1	2	3	0	1	-1	0.00	0.05	-0.01
2153664	2024-07-03 18:00:00	8	0	1.67	4.15	4.20	1.65	4.25	4.20	1	2	2	0	5	1	1	7	3	7	1	5	8	3	1	2	1	3	2	-1	1	0	-0.02	0.10	0.00
2153665	2024-06-16 14:30:00	8	3	2.06	3.25	3.50	2.08	3.25	3.45	0	1	2	2	1	0	2	2	2	2	2	2	4	1	1	1	1	1	1	1	0	-1	0.02	0.00	-0.05
2153667	2024-05-15 18:00:00	8	3	3.85	3.70	1.81	3.75	3.65	1.85	4	2	0	1	0	4	5	2	4	1	4	2	6	1	3	2	3	1	2	-1	-1	1	-0.10	-0.05	0.04
2153668	2024-06-22 17:00:00	8	1	2.64	3.50	2.40	2.64	3.50	2.40	1	0	0	0	0	0	1	0	0	0	1	1	1	1	2	2	3	1	1	0	0	0	0.00	0.00	0.00
2153670	2024-05-15 18:30:00	8	3	1.59	4.05	4.90	1.59	4.05	4.90	0	0	1	0	1	0	0	1	1	1	0	0	1	3	1	1	1	2	2	0	0	0	0.00	0.00	0.00
2153677	2024-06-22 18:00:00	8	0	2.48	3.40	2.61	2.46	3.40	2.65	2	0	1	0	1	2	2	1	3	1	2	0	3	2	3	1	2	1	3	-1	0	1	-0.02	0.00	0.04
2153679	2024-06-26 18:00:00	8	1	3.15	3.35	2.16	3.10	3.35	2.19	1	1	0	0	2	1	1	3	1	2	0	2	3	2	1	2	1	3	1	-1	0	1	-0.05	0.00	0.03
2153683	2024-06-26 18:00:00	8	3	2.73	3.25	2.46	2.73	3.25	2.46	4	2	4	3	2	4	7	4	8	3	6	2	10	2	3	1	2	1	3	0	0	0	0.00	0.00	0.00
2153684	2024-06-22 17:30:00	8	1	3.20	3.30	2.14	3.25	3.30	2.14	1	0	0	1	0	0	2	0	0	0	2	2	2	1	2	2	3	1	1	1	0	0	0.05	0.00	0.00
2153692	2024-06-02 16:00:00	8	3	2.13	3.45	3.15	2.09	3.45	3.20	2	1	1	1	2	1	3	3	2	0	0	1	3	1	1	3	2	2	1	-1	0	1	-0.04	0.00	0.05
2153693	2024-06-26 18:00:00	8	0	2.90	3.20	2.38	2.86	3.20	2.40	2	0	2	2	1	2	4	1	4	0	3	0	4	1	3	1	2	1	2	-1	0	1	-0.04	0.00	0.02
2153760	2024-07-20 18:00:00	8	0	2.26	3.00	3.25	2.23	3.00	3.35	1	1	1	0	1	2	1	2	3	3	2	1	4	3	2	1	1	2	3	-1	0	1	-0.03	0.00	0.10
2153762	2024-08-11 18:00:00	8	0	2.82	3.60	2.23	2.81	3.60	2.23	2	0	0	0	0	0	2	0	0	0	2	2	2	1	2	2	3	1	1	-1	0	0	-0.01	0.00	0.00
2153763	2024-05-26 14:00:00	8	0	2.44	3.20	2.81	2.44	3.15	2.82	0	1	2	1	0	1	1	1	3	2	2	0	3	2	2	1	1	1	3	0	-1	1	0.00	-0.05	0.01
2153764	2024-08-11 17:00:00	8	0	1.93	3.35	3.75	1.90	3.40	3.90	2	1	1	1	1	2	3	2	3	0	1	0	3	1	3	1	2	1	2	-1	1	1	-0.03	0.05	0.15
2153765	2024-07-06 17:30:00	8	0	1.85	3.65	3.80	1.81	3.80	3.80	8	6	6	8	7	7	16	13	13	6	9	9	22	1	2	2	3	1	1	-1	1	0	-0.04	0.15	0.00
2153767	2024-07-06 17:00:00	8	3	1.47	4.35	5.80	1.46	4.35	6.10	5	6	8	6	5	7	11	11	15	4	4	0	15	2	2	1	1	1	3	-1	0	1	-0.01	0.00	0.30
2153768	2024-05-25 13:00:00	8	0	3.05	3.45	2.17	3.05	3.45	2.17	0	0	0	0	0	1	0	0	1	1	1	0	1	2	2	1	1	1	3	0	0	0	0.00	0.00	0.00
2153769	2024-08-25 17:00:00	8	3	2.94	3.20	2.35	2.94	3.20	2.35	1	0	0	0	1	0	1	1	0	0	0	1	1	1	1	3	2	2	1	0	0	0	0.00	0.00	0.00
2153770	2024-07-06 17:00:00	8	1	2.84	3.15	2.44	2.89	3.15	2.40	0	0	2	2	0	0	2	0	2	0	2	0	2	1	3	1	2	1	2	1	0	-1	0.05	0.00	-0.04
2153772	2024-11-17 13:00:00	8	1	3.10	3.40	2.16	3.10	3.40	2.16	1	0	0	0	0	1	1	0	1	0	1	0	1	1	3	1	2	1	2	0	0	0	0.00	0.00	0.00
2153773	2024-07-14 18:00:00	8	1	2.12	3.55	3.05	2.19	3.55	2.92	0	0	4	2	1	0	2	1	4	2	3	0	4	2	3	1	2	1	3	1	0	-1	0.07	0.00	-0.13
2153775	2024-08-07 18:30:00	8	3	1.55	4.45	4.85	1.57	4.40	4.70	1	3	2	1	2	3	2	5	5	3	0	0	5	3	1	1	1	2	2	1	-1	-1	0.02	-0.05	-0.15
2153776	2024-07-14 17:30:00	8	3	1.50	3.95	6.50	1.50	3.90	6.50	2	1	1	1	1	2	3	2	3	1	2	1	4	1	3	1	2	1	2	0	-1	0	0.00	-0.05	0.00
2153777	2024-06-30 18:00:00	8	3	1.95	3.30	3.75	1.94	3.35	3.75	6	2	2	2	3	3	8	5	5	0	3	3	8	1	2	2	3	1	1	-1	1	0	-0.01	0.05	0.00
2153778	2024-06-29 13:00:00	8	0	2.99	3.45	2.20	2.98	3.45	2.21	3	1	0	1	2	1	4	3	1	0	1	3	4	1	2	3	3	2	1	-1	0	1	-0.01	0.00	0.01
2153779	2024-07-06 18:00:00	8	3	2.29	3.60	2.73	2.30	3.55	2.74	1	3	1	1	2	2	2	5	3	5	2	4	7	3	1	2	1	3	2	1	-1	1	0.01	-0.05	0.01
2153780	2024-06-30 17:30:00	8	0	2.26	3.15	3.10	2.31	3.10	3.05	0	3	2	1	2	1	1	5	3	6	2	4	7	3	1	2	1	3	2	1	-1	-1	0.05	-0.05	-0.05
2153783	2024-07-13 18:00:00	8	3	2.37	3.30	2.82	2.31	3.35	2.85	4	0	3	2	1	4	6	1	7	1	6	0	7	2	3	1	2	1	3	-1	1	1	-0.06	0.05	0.03
2153785	2024-08-17 18:00:00	8	1	1.84	3.40	4.15	1.84	3.40	4.10	0	0	2	1	0	0	1	0	2	1	2	0	2	2	3	1	2	1	3	0	0	-1	0.00	0.00	-0.05
2153786	2024-08-07 18:00:00	8	1	2.78	3.20	2.44	2.81	3.20	2.44	2	0	0	3	0	0	5	0	0	0	5	5	5	1	2	2	3	1	1	1	0	0	0.03	0.00	0.00
2153787	2024-08-17 17:00:00	8	1	2.13	3.45	3.15	2.13	3.40	3.15	0	1	0	0	1	0	0	2	0	2	0	2	2	2	1	2	1	3	1	0	-1	0	0.00	-0.05	0.00
2153788	2024-08-07 18:00:00	8	3	3.00	3.60	2.13	2.92	3.65	2.16	6	1	0	1	3	2	7	4	2	0	3	5	7	1	2	3	3	2	1	-1	1	1	-0.08	0.05	0.03
2153789	2024-08-17 18:00:00	8	0	4.10	3.35	1.87	4.00	3.35	1.88	2	0	0	1	0	1	3	0	1	0	3	2	3	1	3	2	3	1	2	-1	0	1	-0.10	0.00	0.01
2153728	2024-08-25 17:30:00	8	3	1.70	3.80	4.40	1.70	3.80	4.40	1	0	1	0	1	2	1	1	3	2	2	0	3	2	2	1	1	1	3	0	0	0	0.00	0.00	0.00
2153730	2024-07-14 18:30:00	8	3	2.55	3.60	2.45	2.44	3.60	2.54	4	0	1	1	1	4	5	1	5	0	4	0	5	1	3	1	2	1	2	-1	0	1	-0.11	0.00	0.09
2153731	2024-07-21 18:00:00	8	0	5.20	4.35	1.52	5.30	4.25	1.53	6	6	4	5	4	7	11	10	11	6	7	6	17	1	3	1	2	1	2	1	-1	1	0.10	-0.10	0.01
2153732	2024-08-17 18:00:00	8	0	2.11	4.00	2.82	2.11	4.00	2.81	0	0	2	1	0	0	1	0	2	1	2	0	2	2	3	1	2	1	3	0	0	-1	0.00	0.00	-0.01
2153734	2024-09-14 17:00:00	8	1	3.05	3.35	2.19	2.93	3.30	2.29	5	4	0	5	3	2	10	7	2	4	7	12	14	1	2	3	3	2	1	-1	-1	1	-0.12	-0.05	0.10
2153735	2024-06-29 18:00:00	8	0	1.95	3.50	3.55	1.93	3.55	3.55	6	0	3	3	1	4	9	1	7	0	8	2	9	1	3	2	3	1	2	-1	1	0	-0.02	0.05	0.00
2153736	2024-06-30 17:00:00	8	3	2.42	2.90	3.10	2.40	3.00	3.05	1	16	8	0	21	8	1	37	16	38	2	23	39	3	1	2	1	3	2	-1	1	-1	-0.02	0.10	-0.05
2153737	2024-08-11 18:00:00	8	1	3.55	3.75	1.88	3.55	3.75	1.89	2	1	2	2	2	2	4	3	4	2	3	2	6	1	3	1	2	1	2	0	0	1	0.00	0.00	0.01
2153739	2024-07-20 18:00:00	8	0	1.95	3.45	3.60	1.92	3.45	3.70	13	5	4	8	5	7	21	10	11	0	11	10	21	1	3	2	3	1	2	-1	0	1	-0.03	0.00	0.10
2153740	2024-07-20 18:00:00	8	1	1.69	3.70	4.60	1.69	3.70	4.60	0	0	0	0	0	1	0	0	1	1	1	0	1	2	2	1	1	1	3	0	0	0	0.00	0.00	0.00
2153741	2024-07-20 18:00:00	8	0	2.03	3.40	3.40	2.01	3.45	3.45	4	0	1	2	1	2	6	1	3	1	6	4	7	1	3	2	3	1	2	-1	1	1	-0.02	0.05	0.05
2153743	2024-11-16 13:00:00	8	0	2.74	3.70	2.25	2.74	3.70	2.25	0	0	1	1	0	0	1	0	1	0	1	0	1	1	3	1	2	1	2	0	0	0	0.00	0.00	0.00
2153744	2024-07-06 17:30:00	8	0	1.83	3.65	3.85	1.86	3.65	3.75	4	2	3	2	2	4	6	4	7	4	6	3	10	2	3	1	2	1	3	1	0	-1	0.03	0.00	-0.10
2153745	2024-08-11 18:00:00	8	1	2.20	3.35	3.05	2.21	3.35	3.05	1	0	3	2	1	1	3	1	4	1	3	0	4	2	3	1	2	1	3	1	0	0	0.01	0.00	0.00
2153747	2024-07-06 18:00:00	8	3	2.04	3.40	3.35	2.03	3.40	3.40	9	4	13	10	5	11	19	9	24	8	18	3	27	2	3	1	2	1	3	-1	0	1	-0.01	0.00	0.05
2153749	2024-08-11 17:30:00	8	3	1.71	3.75	4.40	1.72	3.70	4.40	0	1	2	1	1	1	1	2	3	2	1	0	3	3	2	1	1	2	3	1	-1	0	0.01	-0.05	0.00
2153750	2024-08-11 18:00:00	8	3	4.35	3.60	1.74	4.55	3.70	1.70	1	0	1	1	2	0	2	2	1	1	1	2	3	1	1	3	2	2	1	1	1	-1	0.20	0.10	-0.04
2153752	2024-07-14 17:30:00	8	1	3.75	3.60	1.86	3.65	3.60	1.89	1	0	1	0	0	1	1	0	2	1	2	0	2	2	3	1	2	1	3	-1	0	1	-0.10	0.00	0.03
2153753	2024-08-12 18:00:00	8	3	2.13	3.45	3.10	2.20	3.45	2.99	0	0	3	2	0	0	2	0	3	1	3	0	3	2	3	1	2	1	3	1	0	-1	0.07	0.00	-0.11
2153754	2024-06-19 18:00:00	8	3	3.60	3.90	1.83	3.40	3.85	1.90	4	1	1	0	0	5	4	1	6	2	5	0	6	2	3	1	2	1	3	-1	-1	1	-0.20	-0.05	0.07
2153755	2024-08-07 18:00:00	8	3	1.56	4.20	5.00	1.50	4.30	5.70	3	2	2	0	3	5	3	5	7	7	5	3	10	3	2	1	1	2	3	-1	1	1	-0.06	0.10	0.70
2153758	2024-06-30 17:30:00	8	3	1.72	3.65	4.40	1.71	3.70	4.45	2	0	0	0	1	2	2	1	2	0	1	0	2	1	3	1	2	1	2	-1	1	1	-0.01	0.05	0.05
2153759	2024-08-11 18:30:00	8	0	2.73	3.70	2.26	2.73	3.70	2.26	1	0	0	0	1	0	1	1	0	0	0	1	1	1	1	3	2	2	1	0	0	0	0.00	0.00	0.00
2153828	2024-08-07 18:00:00	8	0	3.70	3.45	1.93	3.70	3.40	1.94	1	2	3	2	2	2	3	4	5	3	2	1	6	3	2	1	1	2	3	0	-1	1	0.00	-0.05	0.01
2153831	2024-07-20 17:00:00	8	0	1.97	3.85	3.20	2.20	3.65	2.85	6	6	10	10	3	7	16	9	17	5	12	4	21	2	3	1	2	1	3	1	-1	-1	0.23	-0.20	-0.35
2153832	2024-08-17 18:00:00	8	0	2.60	3.30	2.55	2.60	3.30	2.55	5	1	3	3	1	3	8	2	6	0	6	2	8	1	3	2	3	1	2	0	0	0	0.00	0.00	0.00
2153834	2024-06-30 18:00:00	8	0	3.15	3.25	2.20	3.10	3.35	2.16	9	3	2	3	5	3	12	8	5	1	5	8	13	1	2	3	3	2	1	-1	1	-1	-0.05	0.10	-0.04
2153835	2024-12-01 13:00:00	8	3	1.35	5.10	7.00	1.33	5.30	7.40	2	0	0	0	2	5	2	2	5	3	3	0	5	2	2	1	1	1	3	-1	1	1	-0.02	0.20	0.40
2153853	2024-09-21 18:00:00	8	0	1.97	3.45	3.55	1.96	3.40	3.65	2	3	2	2	3	4	4	6	6	7	5	5	11	3	1	1	1	2	2	-1	-1	1	-0.01	-0.05	0.10
2153792	2024-07-06 17:00:00	8	3	1.97	3.25	3.75	1.89	3.35	4.00	12	3	8	10	5	10	22	8	18	0	14	4	22	1	3	2	3	1	2	-1	1	1	-0.08	0.10	0.25
2153793	2024-07-14 18:00:00	8	3	2.23	3.40	2.98	2.03	3.50	3.35	6	0	2	2	2	6	8	2	8	1	7	1	9	1	3	1	2	1	2	-1	1	1	-0.20	0.10	0.37
2153795	2024-07-20 18:00:00	8	0	1.50	4.30	5.50	1.57	4.20	4.90	0	2	3	2	1	2	2	3	5	5	4	2	7	3	2	1	1	2	3	1	-1	-1	0.07	-0.10	-0.60
2153797	2024-07-20 18:00:00	8	0	2.26	3.55	2.80	2.26	3.60	2.79	0	0	2	0	1	0	0	1	2	2	1	0	2	3	2	1	1	2	3	0	1	-1	0.00	0.05	-0.01
2153798	2024-08-16 18:30:00	8	3	2.13	3.55	3.05	2.17	3.55	2.95	0	2	3	1	1	3	1	3	6	6	4	1	7	3	2	1	1	2	3	1	0	-1	0.04	0.00	-0.10
2153799	2024-07-06 17:30:00	8	1	3.20	3.60	2.04	3.00	3.55	2.14	3	1	1	0	0	3	3	1	4	2	4	1	5	2	3	1	2	1	3	-1	-1	1	-0.20	-0.05	0.10
2153800	2024-08-10 13:00:00	8	1	2.68	3.15	2.57	2.65	3.15	2.59	4	0	3	3	0	4	7	0	7	0	7	0	7	1	3	1	2	1	2	-1	0	1	-0.03	0.00	0.02
2153802	2024-07-14 17:00:00	8	0	4.00	3.30	1.91	3.85	3.30	1.93	3	1	3	2	1	2	5	2	5	1	4	1	6	1	3	1	2	1	2	-1	0	1	-0.15	0.00	0.02
2153803	2024-07-20 18:00:00	8	0	2.40	3.25	2.81	2.51	3.20	2.70	0	1	3	1	0	3	1	1	6	5	5	0	6	2	2	1	1	1	3	1	-1	-1	0.11	-0.05	-0.11
2153804	2024-07-14 18:00:00	8	0	3.00	3.45	2.17	3.05	3.50	2.16	2	0	2	2	1	2	4	1	4	1	4	1	5	1	3	1	2	1	2	1	1	-1	0.05	0.05	-0.01
2153807	2024-09-13 18:00:00	8	3	1.43	4.65	6.00	1.43	4.70	5.90	2	2	3	2	3	3	4	5	6	3	2	1	7	3	2	1	1	2	3	0	1	-1	0.00	0.05	-0.10
2153809	2024-06-30 17:00:00	8	0	3.15	3.10	2.25	3.15	3.10	2.28	1	0	0	0	0	1	1	0	1	1	2	1	2	1	3	1	2	1	2	0	0	1	0.00	0.00	0.03
2153810	2024-08-11 18:00:00	8	3	2.17	3.10	3.35	2.36	3.10	3.00	1	1	4	5	0	0	6	1	4	1	6	3	7	1	3	2	3	1	2	1	0	-1	0.19	0.00	-0.35
2153811	2024-08-24 18:00:00	8	3	1.97	3.70	3.30	1.95	3.65	3.40	4	2	2	1	2	4	5	4	6	4	5	3	9	2	3	1	2	1	3	-1	-1	1	-0.02	-0.05	0.10
2153813	2024-07-20 17:00:00	8	3	1.79	3.65	4.05	1.77	3.65	4.15	1	1	2	1	2	1	2	3	3	2	1	1	4	3	1	1	1	2	2	-1	0	1	-0.02	0.00	0.10
2153814	2024-06-30 18:00:00	8	0	2.05	3.35	3.40	2.04	3.35	3.40	6	5	9	5	5	8	11	10	17	8	9	2	19	2	3	1	2	1	3	-1	0	0	-0.01	0.00	0.00
2153816	2024-07-13 13:00:00	8	1	6.70	4.45	1.42	6.70	4.45	1.42	2	2	2	5	2	1	7	4	3	0	3	4	7	1	2	3	3	2	1	0	0	0	0.00	0.00	0.00
2153817	2024-08-07 18:00:00	8	1	2.17	3.25	3.25	2.25	3.20	3.10	0	1	2	2	0	0	2	1	2	1	2	1	3	1	3	1	2	1	2	1	-1	-1	0.08	-0.05	-0.15
2153818	2024-09-01 13:00:00	8	3	3.20	3.80	1.97	3.25	3.85	1.96	0	0	2	1	1	1	1	1	3	3	3	1	4	2	2	1	1	1	3	1	1	-1	0.05	0.05	-0.01
2153819	2024-08-17 18:00:00	8	1	2.50	3.15	2.75	2.46	3.15	2.79	5	2	3	3	1	6	8	3	9	2	7	1	10	2	3	1	2	1	3	-1	0	1	-0.04	0.00	0.04
2153820	2024-07-07 18:00:00	8	0	2.08	3.20	3.50	2.07	3.20	3.55	4	4	2	4	5	4	8	9	6	3	2	5	11	2	1	3	2	3	1	-1	0	1	-0.01	0.00	0.05
2153822	2024-06-29 18:00:00	8	1	3.10	3.45	2.14	3.10	3.50	2.12	2	5	2	3	5	1	5	10	3	9	4	11	14	2	1	3	2	3	1	0	1	-1	0.00	0.05	-0.02
2153892	2024-12-08 13:00:00	8	3	1.37	4.65	7.40	1.37	4.60	7.40	0	1	1	0	1	1	0	2	2	3	1	1	3	3	1	1	1	2	2	0	-1	0	0.00	-0.05	0.00
2153893	2024-10-30 18:00:00	8	1	2.33	3.70	2.64	2.30	3.75	2.65	6	1	2	2	2	3	8	3	5	1	6	4	9	1	3	2	3	1	2	-1	1	1	-0.03	0.05	0.01
2153898	2024-10-05 15:00:00	8	0	2.16	3.45	3.05	2.05	3.50	3.25	3	1	2	2	2	3	5	3	5	0	2	0	5	1	3	1	2	1	2	-1	1	1	-0.11	0.05	0.20
2153903	2024-09-21 17:00:00	8	1	2.08	3.45	3.25	2.12	3.40	3.15	2	2	1	1	2	1	3	4	2	3	2	4	6	2	1	3	2	3	1	1	-1	-1	0.04	-0.05	-0.10
2153905	2024-11-30 13:00:00	8	3	1.61	3.95	4.90	1.63	3.90	4.80	3	2	3	3	2	3	6	4	6	0	2	0	6	1	3	1	2	1	2	1	-1	-1	0.02	-0.05	-0.10
2153907	2024-09-27 18:00:00	8	3	2.02	3.65	3.20	2.05	3.65	3.15	2	1	1	3	1	0	5	2	1	0	3	4	5	1	2	3	3	2	1	1	0	-1	0.03	0.00	-0.05
2153908	2024-12-08 13:00:00	8	3	3.85	3.65	1.82	3.85	3.70	1.82	1	0	0	0	1	1	1	1	1	1	1	1	2	1	1	1	1	1	1	0	1	0	0.00	0.05	0.00
2153914	2024-11-30 13:00:00	8	0	2.42	3.35	2.72	2.45	3.30	2.72	1	1	1	3	0	3	4	1	4	0	3	0	4	1	3	1	2	1	2	1	-1	0	0.03	-0.05	0.00
2153915	2024-09-28 18:00:00	8	3	1.81	3.65	3.95	1.74	3.70	4.25	2	0	1	0	2	2	2	2	3	1	1	0	3	2	2	1	1	1	3	-1	1	1	-0.07	0.05	0.30
2153856	2024-11-10 13:00:00	8	1	3.80	3.35	1.93	3.70	3.45	1.93	2	0	3	1	2	2	3	2	5	4	5	2	7	2	3	1	2	1	3	-1	1	0	-0.10	0.10	0.00
2153858	2024-11-10 14:00:00	8	3	4.00	3.65	1.79	4.05	3.65	1.79	1	1	0	1	0	1	2	1	1	0	1	1	2	1	2	2	3	1	1	1	0	0	0.05	0.00	0.00
2153862	2024-09-22 17:30:00	8	3	1.69	4.15	4.05	1.71	4.10	3.95	0	2	3	1	2	2	1	4	5	8	5	4	9	3	2	1	1	2	3	1	-1	-1	0.02	-0.05	-0.10
2153866	2024-10-19 13:00:00	8	1	1.83	3.20	4.55	1.87	3.15	4.35	0	2	4	2	2	1	2	4	5	4	2	1	6	3	2	1	1	2	3	1	-1	-1	0.04	-0.05	-0.20
2153868	2024-10-23 18:00:00	8	3	2.25	3.15	3.15	2.31	3.10	3.05	0	2	1	1	2	0	1	4	1	3	0	3	4	2	1	2	1	3	1	1	-1	-1	0.06	-0.05	-0.10
2153884	2024-11-01 18:00:00	8	3	1.34	4.80	8.00	1.33	4.95	8.00	1	1	3	1	5	4	2	6	7	8	4	3	10	3	2	1	1	2	3	-1	1	0	-0.01	0.15	0.00
2153887	2024-11-30 13:00:00	8	1	3.40	3.20	2.05	3.40	3.15	2.14	2	1	2	3	1	2	5	2	4	1	4	2	6	1	3	2	3	1	2	0	-1	1	0.00	-0.05	0.09
1961949	2023-06-24 18:30:00	8	1	2.56	3.20	2.64	2.54	3.15	2.71	2	1	3	4	0	4	6	1	7	1	6	0	7	2	3	1	2	1	3	-1	-1	1	-0.02	-0.05	0.07
2153952	2024-07-14 17:00:00	8	3	2.68	3.20	2.54	2.74	3.20	2.47	2	0	3	2	0	2	4	0	5	1	5	0	5	2	3	1	2	1	3	1	0	-1	0.06	0.00	-0.07
1961948	2023-06-25 18:00:00	8	0	3.25	3.25	2.17	3.25	3.25	2.17	0	0	0	0	0	1	0	0	1	1	1	0	1	2	2	1	1	1	3	0	0	0	0.00	0.00	0.00
2153958	2024-06-22 14:00:00	8	1	1.78	3.35	4.55	1.78	3.35	4.55	0	0	1	1	0	0	1	0	1	0	1	0	1	1	3	1	2	1	2	0	0	0	0.00	0.00	0.00
1961946	2023-06-24 18:00:00	8	0	2.17	3.70	2.87	2.23	3.60	2.84	2	2	2	1	1	4	3	3	6	4	4	1	7	2	2	1	1	1	3	1	-1	-1	0.06	-0.10	-0.03
1961941	2023-06-24 13:00:00	8	0	1.96	3.80	3.25	2.03	3.75	3.10	2	2	4	4	2	1	6	4	5	1	3	2	7	1	3	2	3	1	2	1	-1	-1	0.07	-0.05	-0.15
1961940	2023-06-11 17:00:00	8	3	2.01	3.40	3.45	1.97	3.45	3.55	3	0	0	0	1	3	3	1	3	0	2	0	3	1	3	1	2	1	2	-1	1	1	-0.04	0.05	0.10
1961943	2023-06-24 18:00:00	8	3	2.90	3.15	2.40	2.90	3.15	2.40	1	0	0	0	1	0	1	1	0	0	0	1	1	1	1	3	2	2	1	0	0	0	0.00	0.00	0.00
1961936	2023-06-11 15:00:00	8	3	1.85	3.10	4.55	1.83	3.15	4.60	1	1	1	1	1	1	2	2	2	1	1	1	3	1	1	1	1	1	1	-1	1	1	-0.02	0.05	0.05
1961939	2023-06-11 18:00:00	8	3	2.55	3.25	2.65	2.41	3.20	2.84	2	1	1	2	0	4	4	1	5	1	4	0	5	2	3	1	2	1	3	-1	-1	1	-0.14	-0.05	0.19
1961933	2023-06-10 18:00:00	8	3	2.93	3.35	2.28	2.93	3.35	2.28	1	0	0	0	1	1	1	1	1	0	0	0	1	1	1	1	1	1	1	0	0	0	0.00	0.00	0.00
1961932	2023-06-04 13:00:00	8	3	1.45	4.35	6.20	1.44	4.35	6.30	3	3	4	3	2	3	6	5	7	1	2	0	7	2	3	1	2	1	3	-1	0	1	-0.01	0.00	0.10
1961934	2023-06-10 18:00:00	8	1	3.40	3.65	1.94	3.20	3.75	2.00	2	2	1	2	1	2	4	3	3	0	1	1	4	1	2	2	3	1	1	-1	1	1	-0.20	0.10	0.06
1961931	2023-06-10 15:00:00	8	3	1.64	4.20	4.40	1.59	4.35	4.60	3	1	1	1	2	3	4	3	4	1	2	1	5	1	3	1	2	1	2	-1	1	1	-0.05	0.15	0.20
1961930	2023-06-04 16:00:00	8	1	2.33	3.20	2.96	2.33	3.15	3.00	0	2	3	1	1	2	1	3	5	4	2	0	5	3	2	1	1	2	3	0	-1	1	0.00	-0.05	0.04
2139129	2024-02-23 17:00:00	8	0	2.52	3.05	2.83	2.52	3.05	2.83	2	0	3	3	0	2	5	0	5	0	5	0	5	1	3	1	2	1	2	0	0	0	0.00	0.00	0.00
2139131	2024-02-23 13:00:00	8	3	2.02	3.20	3.70	2.04	3.20	3.65	2	0	2	4	0	2	6	0	4	0	6	2	6	1	3	2	3	1	2	1	0	-1	0.02	0.00	-0.05
2139132	2024-02-24 14:00:00	8	0	3.20	3.55	2.06	3.20	3.55	2.07	1	0	0	0	0	2	1	0	2	1	2	0	2	2	3	1	2	1	3	0	0	1	0.00	0.00	0.01
2139133	2024-02-25 13:00:00	8	0	4.20	3.80	1.73	4.15	3.80	1.74	1	0	1	1	1	1	2	1	2	0	1	0	2	1	3	1	2	1	2	-1	0	1	-0.05	0.00	0.01
1961923	2023-07-22 18:00:00	8	1	2.34	3.50	2.72	2.29	3.50	2.79	1	0	1	1	0	1	2	0	2	0	2	0	2	1	3	1	2	1	2	-1	0	1	-0.05	0.00	0.07
2139134	2024-03-02 14:00:00	8	1	3.65	3.50	1.92	3.55	3.45	1.96	4	1	2	2	0	6	6	1	8	2	7	0	8	2	3	1	2	1	3	-1	-1	1	-0.10	-0.05	0.04
1961981	2023-08-06 18:00:00	8	0	2.14	3.35	3.15	2.14	3.35	3.20	0	0	1	0	0	1	0	0	2	2	2	0	2	2	2	1	1	1	3	0	0	1	0.00	0.00	0.05
2153921	2024-10-06 15:00:00	8	0	5.30	4.05	1.55	5.20	4.05	1.55	1	0	0	1	0	0	2	0	0	0	2	2	2	1	2	2	3	1	1	-1	0	0	-0.10	0.00	0.00
1961983	2023-08-06 18:00:00	8	0	2.44	3.25	2.76	2.44	3.20	2.78	0	1	1	0	1	1	0	2	2	2	0	0	2	3	1	1	1	2	2	0	-1	1	0.00	-0.05	0.02
1961982	2023-08-06 18:00:00	8	0	1.80	3.65	4.00	1.80	3.65	4.00	0	0	1	0	1	0	0	1	1	1	0	0	1	3	1	1	1	2	2	0	0	0	0.00	0.00	0.00
2153925	2024-09-28 15:00:00	8	3	1.84	3.45	4.10	1.85	3.45	4.00	3	0	4	3	1	3	6	1	7	1	6	0	7	2	3	1	2	1	3	1	0	-1	0.01	0.00	-0.10
1961969	2023-07-15 18:00:00	8	0	2.21	3.80	2.76	2.20	3.80	2.77	1	0	1	0	1	1	1	1	2	1	1	0	2	2	2	1	1	1	3	-1	0	1	-0.01	0.00	0.01
1961962	2023-07-08 18:00:00	8	3	2.82	3.35	2.35	2.84	3.35	2.33	2	0	1	1	1	0	3	1	1	0	2	2	3	1	2	2	3	1	1	1	0	-1	0.02	0.00	-0.02
1961957	2023-07-01 18:00:00	8	1	1.88	3.85	3.50	1.88	3.85	3.50	1	0	0	0	1	1	1	1	1	0	0	0	1	1	1	1	1	1	1	0	0	0	0.00	0.00	0.00
1961959	2023-07-07 18:00:00	8	0	3.40	3.50	2.00	3.50	3.55	1.96	1	0	2	1	2	1	2	2	3	1	1	0	3	2	2	1	1	1	3	1	1	-1	0.10	0.05	-0.04
1961958	2023-07-02 18:00:00	8	3	1.42	4.90	5.80	1.42	4.80	6.10	3	2	2	3	3	2	6	5	4	0	1	2	6	1	2	3	3	2	1	0	-1	1	0.00	-0.10	0.30
1961953	2023-07-01 17:00:00	8	3	2.27	3.20	3.05	2.30	3.20	2.99	1	0	1	1	0	1	2	0	2	0	2	0	2	1	3	1	2	1	2	1	0	-1	0.03	0.00	-0.06
2153949	2024-06-26 18:00:00	8	3	1.80	3.80	3.85	1.72	3.80	4.25	2	4	4	0	5	8	2	9	12	11	4	1	13	3	2	1	1	2	3	-1	0	1	-0.08	0.00	0.40
2334752	2024-12-08 21:30:00	9	3	1.87	3.20	3.95	1.87	3.20	3.95	0	0	0	0	0	0	0	0	0	1	1	1	1	1	1	1	1	1	1	0	0	0	0.00	0.00	0.00
2158124	2024-04-01 20:30:00	9	0	4.75	4.05	1.61	5.30	4.10	1.62	2	2	1	2	1	3	4	3	4	1	2	1	5	1	3	1	2	1	2	1	1	1	0.55	0.05	0.01
2158126	2024-04-01 23:00:00	9	3	1.39	4.70	6.80	1.39	4.90	8.10	3	0	1	2	4	5	5	4	6	2	3	1	7	2	3	1	2	1	3	0	1	1	0.00	0.20	1.30
2158132	2024-04-07 20:30:00	9	1	2.35	3.55	2.91	2.35	3.55	2.91	0	0	0	0	1	1	0	1	1	1	0	0	1	3	1	1	1	2	2	0	0	0	0.00	0.00	0.00
2158133	2024-04-07 23:00:00	9	0	5.50	3.95	1.54	5.80	4.30	1.53	1	1	2	1	1	2	2	2	4	3	3	1	5	2	2	1	1	1	3	1	1	-1	0.30	0.35	-0.01
2158134	2024-07-04 01:00:00	9	0	2.26	3.35	2.78	2.36	3.55	2.91	2	1	4	3	1	4	5	2	8	3	6	0	8	2	3	1	2	1	3	1	1	1	0.10	0.20	0.13
2158137	2024-04-07 23:00:00	9	3	2.36	3.65	2.84	2.36	3.65	2.84	0	0	0	1	1	1	1	1	1	0	0	0	1	1	1	1	1	1	1	0	0	0	0.00	0.00	0.00
2158140	2024-04-14 20:30:00	9	1	2.58	3.50	2.46	2.58	3.75	2.53	4	0	3	5	1	5	9	1	8	0	8	1	9	1	3	2	3	1	2	0	1	1	0.00	0.25	0.07
2158178	2024-05-12 23:00:00	9	0	2.62	3.65	2.54	2.61	3.65	2.53	1	0	1	1	1	1	2	1	2	0	1	0	2	1	3	1	2	1	2	-1	0	-1	-0.01	0.00	-0.01
2158184	2024-05-17 00:00:00	9	0	5.30	4.20	1.60	5.30	4.20	1.60	0	0	0	1	1	0	1	1	0	0	0	1	1	1	1	3	2	2	1	0	0	0	0.00	0.00	0.00
2158185	2024-05-17 00:00:00	9	0	1.65	4.00	4.50	1.65	4.15	4.95	0	1	3	0	3	3	0	4	6	7	3	1	7	3	2	1	1	2	3	0	1	1	0.00	0.15	0.45
2158188	2024-05-20 23:00:00	9	1	1.84	3.60	3.85	1.83	3.75	4.25	2	5	4	1	5	8	3	10	12	9	2	0	12	3	2	1	1	2	3	-1	1	1	-0.01	0.15	0.40
2158189	2024-05-20 23:00:00	9	1	4.90	4.25	1.56	6.40	4.50	1.49	1	0	1	3	3	0	4	3	1	1	2	4	5	1	2	3	3	2	1	1	1	-1	1.50	0.25	-0.07
2158191	2024-05-20 23:00:00	9	0	1.42	5.00	5.90	1.41	5.30	6.70	4	1	5	3	4	11	7	5	16	9	11	0	16	2	3	1	2	1	3	-1	1	1	-0.01	0.30	0.80
2158192	2024-05-20 23:00:00	9	0	2.74	3.60	2.29	2.69	3.80	2.40	6	0	0	5	1	1	11	1	1	0	10	10	11	1	2	2	3	1	1	-1	1	1	-0.05	0.20	0.11
2158195	2024-05-25 01:00:00	9	1	1.24	5.90	9.80	1.26	6.10	10.00	4	4	3	4	4	4	8	8	7	7	7	8	15	1	1	3	2	2	1	1	1	1	0.02	0.20	0.20
2158196	2024-05-26 23:00:00	9	3	2.16	3.55	3.25	2.16	3.55	3.25	0	0	0	0	1	1	0	1	1	1	0	0	1	3	1	1	1	2	2	0	0	0	0.00	0.00	0.00
2158197	2024-05-26 00:00:00	9	1	1.77	3.75	4.00	1.77	3.85	4.45	0	2	1	0	3	2	0	5	3	6	1	3	6	3	1	2	1	3	2	0	1	1	0.00	0.10	0.45
2158198	2024-05-26 23:00:00	9	3	2.68	3.55	2.35	2.85	3.65	2.35	1	1	0	1	1	1	2	2	1	0	0	1	2	1	1	3	2	2	1	1	1	0	0.17	0.10	0.00
2158199	2024-05-26 23:00:00	9	3	1.55	4.35	5.70	1.55	4.35	5.70	0	0	0	1	1	1	1	1	1	0	0	0	1	1	1	1	1	1	1	0	0	0	0.00	0.00	0.00
2158200	2024-05-26 23:00:00	9	0	2.09	3.75	3.30	2.09	3.75	3.30	0	0	0	0	1	1	0	1	1	1	0	0	1	3	1	1	1	2	2	0	0	0	0.00	0.00	0.00
2158201	2024-05-26 23:00:00	9	3	1.56	4.45	5.40	1.56	4.45	5.40	0	0	0	1	1	1	1	1	1	0	0	0	1	1	1	1	1	1	1	0	0	0	0.00	0.00	0.00
2158202	2024-05-27 01:15:00	9	0	1.80	3.90	4.20	1.74	4.05	4.40	4	1	2	1	4	4	5	5	6	2	2	1	7	2	2	1	1	1	3	-1	1	1	-0.06	0.15	0.20
2158203	2024-06-02 00:00:00	9	0	4.35	3.95	1.68	4.80	4.05	1.68	1	0	0	2	1	0	3	1	0	0	2	3	3	1	2	3	3	2	1	1	1	0	0.45	0.10	0.00
2158204	2024-06-02 20:30:00	9	1	1.66	4.35	4.60	1.66	4.35	4.60	0	0	0	0	1	1	0	1	1	1	0	0	1	3	1	1	1	2	2	0	0	0	0.00	0.00	0.00
2158205	2024-06-02 23:00:00	9	0	4.75	4.10	1.60	5.40	4.20	1.60	0	0	1	2	2	0	2	2	1	0	0	1	2	1	1	3	2	2	1	1	1	0	0.65	0.10	0.00
2158206	2024-06-02 23:00:00	9	1	2.16	3.50	3.05	2.08	3.60	3.40	6	3	2	3	4	7	9	7	9	4	6	4	13	1	3	1	2	1	2	-1	1	1	-0.08	0.10	0.35
2158207	2024-06-02 23:00:00	9	3	2.63	3.60	2.36	2.67	3.70	2.46	4	2	0	1	2	4	5	4	4	1	2	2	6	1	2	2	3	1	1	1	1	1	0.04	0.10	0.10
2158147	2024-04-21 20:30:00	9	0	2.45	3.40	2.88	2.45	3.40	2.88	0	0	0	1	1	1	1	1	1	0	0	0	1	1	1	1	1	1	1	0	0	0	0.00	0.00	0.00
2158156	2024-04-28 00:00:00	9	0	3.90	3.90	1.77	4.20	4.00	1.78	1	0	0	2	1	1	3	1	1	0	2	2	3	1	2	2	3	1	1	1	1	1	0.30	0.10	0.01
2158159	2024-04-28 23:00:00	9	3	1.24	6.10	9.80	1.26	6.20	11.00	9	1	11	10	2	12	19	3	23	4	20	0	23	2	3	1	2	1	3	1	1	1	0.02	0.10	1.20
2158164	2024-05-05 23:00:00	9	3	1.27	5.70	8.70	1.27	6.00	10.00	1	1	2	2	2	2	3	3	4	2	2	1	5	2	2	1	1	1	3	0	1	1	0.00	0.30	1.30
2158167	2024-05-05 00:00:00	9	3	1.55	4.45	5.60	1.52	4.55	5.90	1	0	0	0	2	2	1	2	2	1	0	0	2	3	1	1	1	2	2	-1	1	1	-0.03	0.10	0.30
2158171	2024-05-12 20:30:00	9	0	6.30	4.50	1.43	6.60	4.80	1.45	1	0	0	1	2	1	2	2	1	0	0	1	2	1	1	3	2	2	1	1	1	1	0.30	0.30	0.02
2158175	2024-05-12 23:00:00	9	3	1.77	3.90	4.35	1.77	3.90	4.35	0	0	0	0	1	1	0	1	1	1	0	0	1	3	1	1	1	2	2	0	0	0	0.00	0.00	0.00
2158240	2024-07-21 02:15:00	9	0	1.44	4.40	6.30	1.46	4.55	7.00	4	7	7	7	6	6	11	13	13	6	4	4	17	3	1	1	1	2	2	1	1	1	0.02	0.15	0.70
2158244	2024-07-28 00:00:00	9	1	2.13	3.45	3.10	2.11	3.50	3.40	2	1	1	1	2	2	3	3	3	3	3	3	6	1	1	1	1	1	1	-1	1	1	-0.02	0.05	0.30
2158245	2024-07-27 22:00:00	9	1	4.40	4.15	1.64	4.85	4.25	1.64	1	2	0	3	2	0	4	4	0	1	1	5	5	1	1	3	2	2	1	1	1	0	0.45	0.10	0.00
2158246	2024-07-28 23:00:00	9	1	1.87	3.90	3.45	1.90	4.00	3.65	1	1	1	3	1	1	4	2	2	1	3	3	5	1	2	2	3	1	1	1	1	1	0.03	0.10	0.20
2158247	2024-07-28 23:00:00	9	3	2.56	3.60	2.43	2.63	3.75	2.49	1	0	1	1	2	2	2	2	3	1	1	0	3	2	2	1	1	1	3	1	1	1	0.07	0.15	0.06
2158248	2024-07-28 23:00:00	9	3	1.94	3.65	3.40	1.93	3.80	3.70	2	0	0	0	1	1	2	1	1	1	2	2	3	1	2	2	3	1	1	-1	1	1	-0.01	0.15	0.30
2158249	2024-07-28 23:00:00	9	1	1.62	4.10	4.45	1.59	4.40	5.20	2	0	1	1	1	1	3	1	2	1	3	2	4	1	3	2	3	1	2	-1	1	1	-0.03	0.30	0.75
2158250	2024-04-18 00:00:00	9	0	1.31	5.30	8.00	1.31	5.80	8.80	1	0	1	1	2	3	2	2	4	2	2	0	4	2	2	1	1	1	3	0	1	1	0.00	0.50	0.80
2158251	2024-07-29 01:15:00	9	3	2.50	3.75	2.42	2.54	3.80	2.54	4	1	3	7	1	8	11	2	11	0	9	0	11	1	3	1	2	1	2	1	1	1	0.04	0.05	0.12
2158252	2024-08-04 23:00:00	9	1	3.15	3.60	2.19	3.20	3.60	2.19	0	0	0	2	1	0	2	1	0	0	1	2	2	1	2	3	3	2	1	1	0	0	0.05	0.00	0.00
2158253	2024-08-04 00:00:00	9	3	1.23	6.50	12.00	1.23	6.60	12.00	1	0	1	2	2	1	3	2	2	1	2	2	4	1	2	2	3	1	1	0	1	0	0.00	0.10	0.00
2158255	2024-08-04 23:00:00	9	3	3.75	3.85	1.80	3.95	3.90	1.86	3	2	0	2	1	4	5	3	4	3	5	4	8	1	3	2	3	1	2	1	1	1	0.20	0.05	0.06
2158256	2024-08-05 01:15:00	9	3	2.11	3.55	3.10	2.11	3.55	3.40	3	1	4	4	1	4	7	2	8	2	7	1	9	2	3	1	2	1	3	0	0	1	0.00	0.00	0.30
2158258	2024-08-04 23:00:00	9	0	3.00	3.60	2.13	3.25	3.80	2.09	3	0	5	5	2	4	8	2	9	1	7	0	9	2	3	1	2	1	3	1	1	-1	0.25	0.20	-0.04
2158259	2024-05-30 01:00:00	9	3	1.22	6.80	12.00	1.23	6.60	12.00	4	4	1	4	3	2	8	7	3	3	4	8	11	1	2	3	3	2	1	1	-1	0	0.01	-0.20	0.00
2158260	2024-05-30 01:00:00	9	3	2.42	3.45	2.90	2.48	3.40	2.84	3	2	3	3	2	6	6	4	9	3	5	0	9	2	3	1	2	1	3	1	-1	-1	0.06	-0.05	-0.06
2158261	2024-08-10 22:00:00	9	0	2.33	3.45	2.78	2.33	3.50	2.97	0	0	1	0	2	1	0	2	2	2	0	0	2	3	1	1	1	2	2	0	1	1	0.00	0.05	0.19
2158262	2024-08-11 23:00:00	9	3	2.25	3.55	2.81	2.33	3.70	2.86	0	2	6	1	5	3	1	7	9	9	3	1	10	3	2	1	1	2	3	1	1	1	0.08	0.15	0.05
2158263	2024-08-12 01:15:00	9	0	2.69	3.65	2.31	2.84	3.60	2.38	6	3	0	5	2	2	11	5	2	0	6	9	11	1	2	3	3	2	1	1	-1	1	0.15	-0.05	0.07
2158264	2024-08-11 23:00:00	9	1	2.47	3.75	2.44	2.53	3.80	2.55	6	2	4	5	3	4	11	5	8	3	9	6	14	1	3	2	3	1	2	1	1	1	0.06	0.05	0.11
2158265	2024-08-11 00:00:00	9	1	2.70	3.75	2.26	2.73	3.90	2.33	4	1	0	1	2	1	5	3	1	0	2	4	5	1	2	3	3	2	1	1	1	1	0.03	0.15	0.07
2158266	2024-08-10 01:00:00	9	1	2.26	3.65	2.75	2.35	3.90	2.71	0	1	6	2	2	4	2	3	10	8	7	0	10	3	2	1	1	2	3	1	1	-1	0.09	0.25	-0.04
2158268	2024-05-30 01:00:00	9	1	1.29	6.00	9.40	1.31	5.70	9.10	3	6	8	5	3	7	8	9	15	8	7	1	16	3	2	1	1	2	3	1	-1	-1	0.02	-0.30	-0.30
2158270	2024-08-18 20:30:00	9	0	2.55	3.30	2.60	2.63	3.40	2.66	1	1	2	4	2	3	5	3	5	0	2	0	5	1	3	1	2	1	2	1	1	1	0.08	0.10	0.06
2158271	2024-09-19 00:00:00	9	0	5.40	4.45	1.56	5.60	4.50	1.54	0	0	1	2	2	1	2	2	2	0	0	0	2	1	1	1	1	1	1	1	1	-1	0.20	0.05	-0.02
2158208	2024-06-02 23:00:00	9	1	1.70	4.05	4.65	1.70	4.10	4.60	0	0	1	0	1	1	0	1	2	2	1	0	2	3	2	1	1	2	3	0	1	-1	0.00	0.05	-0.05
2158209	2024-06-02 23:00:00	9	0	2.16	3.60	3.25	2.16	3.60	3.25	0	0	0	0	1	1	0	1	1	1	0	0	1	3	1	1	1	2	2	0	0	0	0.00	0.00	0.00
2158210	2024-06-03 01:15:00	9	1	2.23	3.50	3.15	2.21	3.45	3.25	1	2	2	2	2	4	3	4	6	5	4	2	8	3	2	1	1	2	3	-1	-1	1	-0.02	-0.05	0.10
2158211	2024-06-28 03:15:00	9	3	1.83	3.80	3.70	1.86	3.75	4.05	9	7	8	7	6	12	16	13	20	9	12	5	25	2	3	1	2	1	3	1	-1	1	0.03	-0.05	0.35
2158212	2024-06-29 01:00:00	9	1	1.35	5.00	7.20	1.40	5.10	7.30	4	3	11	5	5	11	9	8	22	14	15	1	23	2	3	1	2	1	3	1	1	1	0.05	0.10	0.10
2158213	2024-06-28 01:00:00	9	0	2.00	3.70	3.25	2.04	3.75	3.40	1	3	3	2	4	4	3	7	7	6	2	2	9	3	1	1	1	2	2	1	1	1	0.04	0.05	0.15
2158214	2024-06-29 01:00:00	9	1	2.05	3.60	3.20	2.07	3.80	3.30	2	2	2	2	4	2	4	6	4	5	3	5	9	2	1	2	1	3	1	1	1	1	0.02	0.20	0.10
2158215	2024-08-15 01:00:00	9	3	1.68	3.65	4.70	1.68	3.80	5.30	1	4	4	1	7	6	2	11	10	12	3	4	14	3	1	2	1	3	2	0	1	1	0.00	0.15	0.60
1946805	2023-07-31 01:15:00	9	0	1.37	5.10	8.10	1.37	5.10	8.10	0	0	0	1	1	1	1	1	1	0	0	0	1	1	1	1	1	1	1	0	0	0	0.00	0.00	0.00
2158216	2024-06-29 03:15:00	9	0	2.87	3.75	2.16	3.10	3.65	2.21	2	6	2	3	4	3	5	10	5	7	2	7	12	2	1	2	1	3	1	1	-1	1	0.23	-0.10	0.05
2158217	2024-06-29 01:00:00	9	0	3.95	4.25	1.69	4.30	4.35	1.70	4	4	1	5	5	1	9	9	2	3	3	10	12	1	1	3	2	2	1	1	1	1	0.35	0.10	0.01
2158218	2024-06-30 21:00:00	9	3	1.69	4.10	4.65	1.69	4.10	4.65	0	0	0	0	0	1	0	0	1	1	1	0	1	2	2	1	1	1	3	0	0	0	0.00	0.00	0.00
1946806	2023-08-07 01:15:00	9	3	2.77	3.95	2.29	2.67	3.95	2.36	2	1	2	3	2	2	5	3	4	0	2	1	5	1	3	2	3	1	2	-1	0	1	-0.10	0.00	0.07
2158219	2024-07-07 23:00:00	9	1	2.38	3.45	2.70	2.38	3.55	2.88	0	1	3	0	2	3	0	3	6	6	3	0	6	3	2	1	1	2	3	0	1	1	0.00	0.10	0.18
1946801	2023-07-23 23:00:00	9	0	7.60	5.30	1.32	8.20	5.50	1.34	0	0	1	2	1	1	2	1	2	0	1	0	2	1	3	1	2	1	2	1	1	1	0.60	0.20	0.02
2158220	2024-07-07 20:30:00	9	3	1.97	3.80	3.20	2.04	3.80	3.40	2	3	4	6	2	4	8	5	8	7	10	7	15	1	3	1	2	1	2	1	0	1	0.07	0.00	0.20
1946800	2023-07-23 23:00:00	9	3	2.33	3.45	3.00	2.33	3.45	3.00	0	0	0	0	1	1	0	1	1	1	0	0	1	3	1	1	1	2	2	0	0	0	0.00	0.00	0.00
2158221	2024-07-07 23:00:00	9	0	2.26	3.60	2.77	2.26	3.70	2.97	0	0	1	1	1	1	1	1	2	1	1	0	2	2	2	1	1	1	3	0	1	1	0.00	0.10	0.20
1946803	2023-07-30 23:00:00	9	3	1.80	3.65	4.55	1.80	3.65	4.55	0	0	0	0	1	1	0	1	1	1	0	0	1	3	1	1	1	2	2	0	0	0	0.00	0.00	0.00
2158222	2024-07-07 23:00:00	9	0	2.79	3.70	2.21	2.90	3.70	2.29	6	5	1	7	3	4	13	8	5	0	5	8	13	1	2	3	3	2	1	1	0	1	0.11	0.00	0.08
1946802	2023-07-25 01:00:00	9	3	1.30	5.40	8.30	1.32	5.60	8.70	2	1	3	2	2	4	4	3	7	3	4	0	7	2	3	1	2	1	3	1	1	1	0.02	0.20	0.40
2158224	2024-07-07 23:00:00	9	3	1.43	4.85	5.80	1.49	4.55	6.10	5	8	6	7	3	7	12	11	13	5	6	4	17	2	3	1	2	1	3	1	-1	1	0.06	-0.30	0.30
1946796	2023-07-08 01:00:00	9	3	2.06	3.45	3.30	2.01	3.55	3.70	6	1	4	5	3	7	11	4	11	1	8	1	12	1	3	1	2	1	2	-1	1	1	-0.05	0.10	0.40
2158225	2024-07-09 01:00:00	9	1	1.83	3.70	3.80	1.83	3.90	4.05	7	4	4	5	6	6	12	10	10	4	6	6	16	1	2	2	3	1	1	0	1	1	0.00	0.20	0.25
1946799	2023-07-16 23:00:00	9	3	1.19	7.00	11.00	1.23	6.70	11.00	1	2	1	3	0	1	4	2	2	0	2	2	4	1	2	2	3	1	1	1	-1	0	0.04	-0.30	0.00
2158226	2024-07-08 01:15:00	9	3	1.59	4.05	4.85	1.61	4.20	5.10	6	2	4	5	5	5	11	7	9	1	5	3	12	1	3	2	3	1	2	1	1	1	0.02	0.15	0.25
1946798	2023-07-16 23:00:00	9	0	2.35	3.35	2.81	2.35	3.35	2.81	0	0	1	0	1	0	0	1	1	1	0	0	1	3	1	1	1	2	2	0	0	0	0.00	0.00	0.00
2158227	2024-07-13 23:00:00	9	1	2.88	3.50	2.23	3.25	3.55	2.17	7	6	3	8	6	2	15	12	5	2	5	12	17	1	2	3	3	2	1	1	1	-1	0.37	0.05	-0.06
1946793	2023-07-02 23:00:00	9	3	2.38	3.35	2.77	2.44	3.40	2.87	2	0	0	1	1	3	3	1	3	0	2	0	3	1	3	1	2	1	2	1	1	1	0.06	0.05	0.10
2158228	2024-07-13 23:00:00	9	3	2.09	3.65	3.05	2.17	3.65	3.15	2	5	6	3	5	6	5	10	12	11	6	4	16	3	2	1	1	2	3	1	0	1	0.08	0.00	0.10
1946792	2023-06-26 01:15:00	9	3	5.80	4.40	1.47	6.10	4.75	1.50	1	2	0	1	3	3	2	5	3	3	0	2	5	3	1	2	1	3	2	1	1	1	0.30	0.35	0.03
2158229	2024-07-13 01:00:00	9	3	2.34	3.80	2.57	2.20	3.75	3.05	8	3	6	4	2	12	12	5	18	6	13	0	18	2	3	1	2	1	3	-1	-1	1	-0.14	-0.05	0.48
1946795	2023-07-03 01:15:00	9	1	1.75	4.10	3.75	1.87	4.15	3.65	1	2	6	6	3	2	7	5	8	2	4	1	9	2	3	1	2	1	3	1	1	-1	0.12	0.05	-0.10
2158230	2024-07-13 23:00:00	9	0	2.31	3.50	2.75	2.37	3.65	2.82	11	1	7	7	4	9	18	5	16	0	13	2	18	1	3	2	3	1	2	1	1	1	0.06	0.15	0.07
1946794	2023-07-02 23:00:00	9	3	2.98	3.45	2.21	3.15	3.55	2.21	3	0	0	2	3	0	5	3	0	0	2	5	5	1	2	3	3	2	1	1	1	0	0.17	0.10	0.00
2158231	2024-07-13 23:00:00	9	3	4.85	4.50	1.53	6.00	4.75	1.48	3	1	7	8	5	2	11	6	9	2	7	4	13	1	3	2	3	1	2	1	1	-1	1.15	0.25	-0.05
1946789	2023-06-11 23:00:00	9	3	3.90	3.70	1.80	4.20	3.95	1.79	1	1	2	3	2	1	4	3	3	0	1	1	4	1	2	2	3	1	1	1	1	-1	0.30	0.25	-0.01
2158232	2024-07-13 23:00:00	9	3	1.36	5.10	6.80	1.35	5.50	8.10	5	1	5	3	5	10	8	6	15	11	13	4	19	2	3	1	2	1	3	-1	1	1	-0.01	0.40	1.30
1946788	2023-06-11 23:00:00	9	3	1.17	7.60	11.00	1.17	7.90	15.00	0	1	0	0	3	1	0	4	1	4	0	3	4	3	1	2	1	3	2	0	1	1	0.00	0.30	4.00
2158233	2024-07-14 04:00:00	9	0	2.14	3.45	3.10	2.04	3.30	3.90	9	9	4	7	7	13	16	16	17	13	13	12	29	2	2	1	1	1	3	-1	-1	1	-0.10	-0.15	0.80
1946791	2023-06-25 23:00:00	9	0	2.38	3.30	3.05	2.38	3.30	3.05	0	0	0	0	1	1	0	1	1	1	0	0	1	3	1	1	1	2	2	0	0	0	0.00	0.00	0.00
2158234	2024-07-14 01:15:00	9	1	1.24	6.20	9.80	1.27	6.10	10.00	2	4	5	5	4	6	7	8	11	9	8	5	16	3	2	1	1	2	3	1	-1	1	0.03	-0.10	0.20
1946790	2023-07-20 00:00:00	9	3	1.38	4.75	7.10	1.40	4.85	7.70	1	1	3	2	3	3	3	4	6	3	2	0	6	3	2	1	1	2	3	1	1	1	0.02	0.10	0.60
2158235	2024-07-20 01:00:00	9	3	1.19	7.00	10.00	1.20	7.60	12.00	8	11	3	8	14	5	16	25	8	12	3	20	28	2	1	3	2	3	1	1	1	1	0.01	0.60	2.00
1946785	2023-06-04 23:00:00	9	0	5.40	4.20	1.60	5.40	4.20	1.60	0	0	0	1	1	0	1	1	0	0	0	1	1	1	1	3	2	2	1	0	0	0	0.00	0.00	0.00
2158236	2024-07-21 00:00:00	9	1	3.30	3.90	1.92	3.55	4.15	1.89	2	1	7	4	3	2	6	4	9	5	7	2	11	2	3	1	2	1	3	1	1	-1	0.25	0.25	-0.03
2158237	2024-07-21 23:00:00	9	0	2.56	3.30	2.59	2.67	3.40	2.64	2	0	1	3	1	2	5	1	3	0	4	2	5	1	3	2	3	1	2	1	1	1	0.11	0.10	0.05
1946787	2023-06-11 23:00:00	9	0	2.46	3.15	2.82	2.42	3.20	3.05	1	2	2	1	1	1	2	3	3	1	0	0	3	3	1	1	1	2	2	-1	1	1	-0.04	0.05	0.23
2158238	2024-07-21 20:30:00	9	0	2.07	3.50	3.20	2.08	3.55	3.45	4	0	0	3	1	1	7	1	1	1	7	7	8	1	2	2	3	1	1	1	1	1	0.01	0.05	0.25
1946786	2023-06-04 23:00:00	9	0	3.75	3.70	1.78	4.25	4.00	1.77	0	1	1	3	1	0	3	2	1	0	1	2	3	1	2	3	3	2	1	1	1	-1	0.50	0.30	-0.01
2158239	2024-07-21 23:00:00	9	3	3.10	3.60	2.07	3.35	3.70	2.07	2	2	0	2	2	1	4	4	1	2	2	5	6	1	1	3	2	2	1	1	1	0	0.25	0.10	0.00
1946844	2023-06-25 00:00:00	9	3	2.67	3.65	2.31	2.67	3.65	2.31	0	1	0	1	0	0	1	1	0	0	0	1	1	1	1	3	2	2	1	0	0	0	0.00	0.00	0.00
1946847	2023-06-25 23:00:00	9	3	2.07	3.35	3.35	2.09	3.35	3.65	3	1	1	2	2	3	5	3	4	1	3	2	6	1	3	2	3	1	2	1	0	1	0.02	0.00	0.30
2158306	2024-09-29 23:00:00	9	3	1.17	7.50	10.00	1.18	8.00	13.00	1	1	1	2	2	2	3	3	3	0	0	0	3	1	1	1	1	1	1	1	1	1	0.01	0.50	3.00
1946846	2023-06-25 23:00:00	9	0	2.07	3.65	3.40	2.07	3.80	3.30	0	0	1	0	2	1	0	2	2	2	0	0	2	3	1	1	1	2	2	0	1	-1	0.00	0.15	-0.10
2158307	2024-09-28 20:00:00	9	3	1.43	4.50	6.30	1.44	4.55	6.10	4	3	4	4	3	3	8	6	7	3	5	4	11	1	3	2	3	1	2	1	1	-1	0.01	0.05	-0.20
1946841	2023-06-11 23:00:00	9	0	1.69	3.80	4.40	1.69	3.80	4.40	1	0	0	0	1	1	1	1	1	0	0	0	1	1	1	1	1	1	1	0	0	0	0.00	0.00	0.00
1946840	2023-06-11 23:00:00	9	3	1.96	3.55	3.45	2.00	3.55	3.75	1	1	1	1	2	2	2	3	3	1	0	0	3	3	1	1	1	2	2	1	0	1	0.04	0.00	0.30
1946843	2023-06-12 01:15:00	9	1	1.55	3.80	5.80	1.59	4.25	5.40	0	1	1	1	1	1	1	2	2	1	0	0	2	3	1	1	1	2	2	1	1	-1	0.04	0.45	-0.40
1946842	2023-06-11 23:00:00	9	1	2.70	3.15	2.56	2.77	3.25	2.63	1	1	1	2	2	2	3	3	3	0	0	0	3	1	1	1	1	1	1	1	1	1	0.07	0.10	0.07
1946837	2023-06-04 23:00:00	9	0	1.82	3.70	4.35	1.82	3.70	4.35	1	0	0	0	1	1	1	1	1	0	0	0	1	1	1	1	1	1	1	0	0	0	0.00	0.00	0.00
1946836	2023-06-04 23:00:00	9	3	1.64	3.90	5.40	1.64	3.90	5.40	1	0	0	0	1	1	1	1	1	0	0	0	1	1	1	1	1	1	1	0	0	0	0.00	0.00	0.00
1946839	2023-06-11 23:00:00	9	0	2.05	3.65	3.15	2.08	4.00	3.15	1	0	1	2	2	2	3	2	3	0	1	0	3	1	3	1	2	1	2	1	1	0	0.03	0.35	0.00
1946838	2023-06-05 01:15:00	9	0	2.65	3.50	2.28	2.91	3.90	2.23	0	1	2	4	2	0	4	3	2	0	1	2	4	1	2	3	3	2	1	1	1	-1	0.26	0.40	-0.05
2158315	2024-10-20 20:30:00	9	0	2.20	3.60	2.87	2.20	3.65	3.10	0	0	1	0	1	3	0	1	4	4	3	0	4	3	2	1	1	2	3	0	1	1	0.00	0.05	0.23
2158321	2024-10-29 02:00:00	9	0	1.51	4.45	5.30	1.51	4.70	5.60	6	4	7	6	7	8	12	11	15	6	7	3	18	2	3	1	2	1	3	0	1	1	0.00	0.25	0.30
2158324	2024-10-28 00:00:00	9	3	1.68	3.90	4.40	1.70	4.00	4.70	0	1	2	1	2	2	1	3	4	4	2	1	5	3	2	1	1	2	3	1	1	1	0.02	0.10	0.30
2158331	2024-11-04 00:00:00	9	1	2.36	3.70	2.59	2.36	3.80	2.75	0	0	1	0	1	1	0	1	2	2	1	0	2	3	2	1	1	2	3	0	1	1	0.00	0.10	0.16
2158272	2024-08-19 01:15:00	9	3	2.36	3.70	2.81	2.29	3.70	2.92	4	0	3	2	1	5	6	1	8	2	7	0	8	2	3	1	2	1	3	-1	0	1	-0.07	0.00	0.11
1946876	2023-08-06 23:00:00	9	0	2.42	3.40	2.56	2.42	3.40	2.56	1	0	0	0	0	1	1	0	1	0	1	0	1	1	3	1	2	1	2	0	0	0	0.00	0.00	0.00
2158273	2024-08-18 23:00:00	9	1	1.70	4.05	4.65	1.70	4.05	4.65	0	0	0	0	1	1	0	1	1	1	0	0	1	3	1	1	1	2	2	0	0	0	0.00	0.00	0.00
1946879	2023-08-06 00:00:00	9	0	2.26	3.70	2.97	2.33	3.70	2.86	2	1	1	1	2	3	3	3	4	1	1	0	4	2	2	1	1	1	3	1	0	-1	0.07	0.00	-0.11
2158274	2024-08-18 00:00:00	9	3	2.20	3.65	2.84	2.26	3.75	2.93	0	2	4	1	3	3	1	5	7	6	2	0	7	3	2	1	1	2	3	1	1	1	0.06	0.10	0.09
1946878	2023-08-06 23:00:00	9	3	4.20	4.20	1.62	4.45	4.40	1.67	2	1	0	1	2	3	3	3	3	0	0	0	3	1	1	1	1	1	1	1	1	1	0.25	0.20	0.05
2158275	2024-08-24 22:00:00	9	3	1.39	5.10	6.00	1.39	5.20	7.20	1	2	3	2	2	1	3	4	4	2	1	1	5	3	1	1	1	2	2	0	1	1	0.00	0.10	1.20
1946873	2023-07-30 23:00:00	9	3	1.46	4.85	6.30	1.46	4.85	6.30	0	0	0	1	1	1	1	1	1	0	0	0	1	1	1	1	1	1	1	0	0	0	0.00	0.00	0.00
1946872	2023-07-30 00:00:00	9	0	5.00	4.05	1.66	4.95	4.05	1.66	1	0	0	1	1	0	2	1	0	0	1	2	2	1	2	3	3	2	1	-1	0	0	-0.05	0.00	0.00
1946875	2023-07-29 21:30:00	9	0	1.49	4.20	5.30	1.52	4.40	6.40	1	2	0	1	1	2	2	3	2	1	0	1	3	2	1	2	1	3	1	1	1	1	0.03	0.20	1.10
1946874	2023-07-30 23:00:00	9	3	1.49	4.50	6.40	1.47	4.60	6.60	1	0	0	1	2	2	2	2	2	0	0	0	2	1	1	1	1	1	1	-1	1	1	-0.02	0.10	0.20
1946869	2023-07-23 23:00:00	9	3	2.76	3.45	2.33	2.94	3.45	2.38	2	0	0	1	0	2	3	0	2	0	3	1	3	1	3	2	3	1	2	1	0	1	0.18	0.00	0.05
2158280	2024-08-26 01:15:00	9	0	3.15	3.75	2.01	3.50	3.90	1.97	3	1	3	3	3	3	6	4	6	2	4	2	8	1	3	1	2	1	2	1	1	-1	0.35	0.15	-0.04
1946868	2023-07-23 23:00:00	9	3	2.20	3.45	2.99	2.20	3.50	3.20	0	0	1	0	2	1	0	2	2	2	0	0	2	3	1	1	1	2	2	0	1	1	0.00	0.05	0.21
1946871	2023-07-30 23:00:00	9	0	1.82	3.75	3.50	1.77	4.15	4.10	4	0	0	0	2	3	4	2	3	0	2	1	4	1	3	2	3	1	2	-1	1	1	-0.05	0.40	0.60
1946870	2023-07-24 01:15:00	9	0	2.30	3.60	2.74	2.36	3.65	2.83	1	0	3	3	1	2	4	1	5	1	4	0	5	2	3	1	2	1	3	1	1	1	0.06	0.05	0.09
1946865	2023-07-16 23:00:00	9	3	1.30	5.30	8.40	1.30	5.50	10.00	3	0	0	1	2	5	4	2	5	1	3	0	5	2	3	1	2	1	3	0	1	1	0.00	0.20	1.60
1946864	2023-07-17 01:15:00	9	3	1.44	4.80	5.60	1.39	5.30	7.20	6	2	6	5	7	9	11	9	15	5	7	1	16	2	3	1	2	1	3	-1	1	1	-0.05	0.50	1.60
2158285	2024-08-31 01:00:00	9	3	2.20	3.50	2.95	2.23	3.45	3.20	3	6	8	2	4	10	5	10	18	18	13	5	23	3	2	1	1	2	3	1	-1	1	0.03	-0.05	0.25
1946867	2023-07-23 23:00:00	9	3	3.35	3.55	2.12	3.35	3.55	2.12	0	0	0	1	1	0	1	1	0	0	0	1	1	1	1	3	2	2	1	0	0	0	0.00	0.00	0.00
1946866	2023-07-23 00:00:00	9	3	1.46	4.80	5.40	1.46	5.00	6.00	1	0	0	1	1	3	2	1	3	1	2	0	3	2	3	1	2	1	3	0	1	1	0.00	0.20	0.60
1946861	2023-07-16 23:00:00	9	0	1.38	4.95	6.60	1.40	5.10	7.20	2	1	0	1	3	4	3	4	4	2	1	1	5	3	1	1	1	2	2	1	1	1	0.02	0.15	0.60
2158288	2024-09-01 23:00:00	9	3	2.18	3.70	2.87	2.37	3.65	2.83	1	1	2	3	1	2	4	2	4	1	3	1	5	1	3	1	2	1	2	1	-1	-1	0.19	-0.05	-0.04
1946860	2023-07-16 00:00:00	9	0	3.45	3.75	1.91	3.80	3.90	1.89	2	2	7	7	4	2	9	6	9	1	4	1	10	1	3	1	2	1	2	1	1	-1	0.35	0.15	-0.02
1946863	2023-07-16 23:00:00	9	3	2.03	3.35	3.85	2.08	3.35	3.70	1	0	2	2	1	1	3	1	3	0	2	0	3	1	3	1	2	1	2	1	0	-1	0.05	0.00	-0.15
2158290	2024-09-14 01:00:00	9	3	1.21	6.50	10.00	1.25	6.50	11.00	2	2	3	3	3	5	5	5	8	6	6	3	11	2	2	1	1	1	3	1	0	1	0.04	0.00	1.00
1946862	2023-07-16 23:00:00	9	0	3.05	3.60	2.25	2.96	3.60	2.31	1	0	0	1	0	1	2	0	1	0	2	1	2	1	3	2	3	1	2	-1	0	1	-0.09	0.00	0.06
1946857	2023-07-09 23:00:00	9	3	2.70	3.75	2.26	2.89	3.80	2.26	1	1	0	2	2	0	3	3	0	0	0	3	3	1	1	3	2	2	1	1	1	0	0.19	0.05	0.00
1946856	2023-07-09 23:00:00	9	1	2.42	3.45	2.67	2.42	3.40	2.68	0	1	0	0	1	1	0	2	1	2	0	1	2	3	1	2	1	3	2	0	-1	1	0.00	-0.05	0.01
1946859	2023-07-10 01:15:00	9	3	2.04	3.80	3.05	2.02	3.90	3.35	2	0	1	1	2	1	3	2	2	0	1	1	3	1	2	2	3	1	1	-1	1	1	-0.02	0.10	0.30
1946858	2023-07-09 23:00:00	9	1	2.20	3.45	3.30	2.20	3.45	3.30	0	0	0	0	1	1	0	1	1	1	0	0	1	3	1	1	1	2	2	0	0	0	0.00	0.00	0.00
1946853	2023-07-02 23:00:00	9	3	1.24	6.20	8.80	1.25	6.50	11.00	1	2	1	2	2	2	3	4	3	1	0	1	4	2	1	2	1	3	1	1	1	1	0.01	0.30	2.20
2158296	2024-09-15 20:30:00	9	3	2.83	3.30	2.36	3.00	3.40	2.36	1	0	0	2	1	0	3	1	0	0	2	3	3	1	2	3	3	2	1	1	1	0	0.17	0.10	0.00
1946852	2023-07-04 01:00:00	9	0	2.12	3.60	3.35	2.12	3.60	3.35	1	0	0	0	1	1	1	1	1	0	0	0	1	1	1	1	1	1	1	0	0	0	0.00	0.00	0.00
1946855	2023-07-09 23:00:00	9	0	2.29	3.45	2.82	2.29	3.50	2.80	0	0	3	0	1	0	0	1	3	3	2	0	3	3	2	1	1	2	3	0	1	-1	0.00	0.05	-0.02
1946854	2023-07-09 00:00:00	9	3	1.37	4.95	7.00	1.39	5.00	7.80	1	0	0	1	1	4	2	1	4	2	3	0	4	2	3	1	2	1	3	1	1	1	0.02	0.05	0.80
1946849	2023-07-02 00:00:00	9	0	2.38	3.70	2.56	2.38	3.70	2.77	0	0	1	1	0	2	1	0	3	2	3	0	3	2	3	1	2	1	3	0	0	1	0.00	0.00	0.21
2158300	2024-09-22 20:30:00	9	3	2.56	3.75	2.36	2.72	3.85	2.36	1	0	0	1	1	0	2	1	0	0	1	2	2	1	2	3	3	2	1	1	1	0	0.16	0.10	0.00
1946848	2023-06-25 23:00:00	9	3	1.18	6.90	12.00	1.20	7.10	15.00	0	0	0	1	2	2	1	2	2	1	0	0	2	3	1	1	1	2	2	1	1	1	0.02	0.20	3.00
2158301	2024-09-24 01:00:00	9	1	3.05	3.55	2.14	3.40	3.65	2.07	2	3	3	6	3	2	8	6	5	1	3	4	9	1	2	3	3	2	1	1	1	-1	0.35	0.10	-0.07
1946851	2023-07-02 23:00:00	9	0	1.69	3.85	4.40	1.66	4.00	5.10	2	0	0	0	3	3	2	3	3	1	0	0	3	3	1	1	1	2	2	-1	1	1	-0.03	0.15	0.70
1946850	2023-07-02 23:00:00	9	3	1.40	4.85	6.40	1.40	5.10	7.20	1	0	0	0	2	2	1	2	2	1	0	0	2	3	1	1	1	2	2	0	1	1	0.00	0.25	0.80
1946909	2023-09-17 00:00:00	9	3	1.28	5.40	7.60	1.31	5.70	9.30	5	5	6	5	6	9	10	11	15	5	4	0	15	3	2	1	1	2	3	1	1	1	0.03	0.30	1.70
1946911	2023-08-27 00:00:00	9	3	2.07	3.60	2.94	1.98	3.75	3.60	5	1	4	3	3	6	8	4	10	2	6	0	10	2	3	1	2	1	3	-1	1	1	-0.09	0.15	0.66
1946905	2023-08-21 01:15:00	9	0	3.20	3.80	2.11	3.10	3.80	2.14	2	1	0	1	2	1	3	3	1	2	2	4	5	1	1	3	2	2	1	-1	0	1	-0.10	0.00	0.03
1946904	2023-09-03 23:00:00	9	3	2.17	3.45	3.00	2.12	3.45	3.45	1	1	1	0	1	4	1	2	5	5	4	1	6	3	2	1	1	2	3	-1	0	1	-0.05	0.00	0.45
1946896	2023-08-28 01:15:00	9	3	1.46	4.45	5.40	1.48	4.65	6.20	3	3	4	3	4	4	6	7	8	4	3	2	10	3	2	1	1	2	3	1	1	1	0.02	0.20	0.80
1946892	2023-08-20 23:00:00	9	0	5.40	4.35	1.46	5.90	4.80	1.48	1	0	1	2	2	1	3	2	2	0	1	1	3	1	2	2	3	1	1	1	1	1	0.50	0.45	0.02
1946889	2023-08-27 23:00:00	9	1	1.78	3.65	3.75	1.73	3.75	4.85	2	1	0	0	1	3	2	2	3	2	2	1	4	2	2	1	1	1	3	-1	1	1	-0.05	0.10	1.10
1946888	2023-08-13 00:00:00	9	0	1.53	4.65	5.40	1.53	4.65	5.40	0	0	0	1	1	1	1	1	1	0	0	0	1	1	1	1	1	1	1	0	0	0	0.00	0.00	0.00
1946885	2023-08-14 01:15:00	9	1	1.70	4.10	4.60	1.68	4.10	4.70	2	2	1	1	2	2	3	4	3	1	0	1	4	2	1	2	1	3	1	-1	0	1	-0.02	0.00	0.10
1946882	2023-08-06 23:00:00	9	3	2.13	3.35	3.00	2.17	3.45	3.35	0	1	0	1	1	2	1	2	2	1	0	0	2	3	1	1	1	2	2	1	1	1	0.04	0.10	0.35
1946937	2023-11-27 00:00:00	9	1	1.60	4.20	5.40	1.60	4.20	5.40	0	0	0	1	1	1	1	1	1	0	0	0	1	1	1	1	1	1	1	0	0	0	0.00	0.00	0.00
2158340	2024-11-11 02:15:00	9	1	1.35	5.00	7.50	1.35	5.10	8.70	2	1	5	3	1	4	5	2	9	6	9	2	11	2	3	1	2	1	3	0	1	1	0.00	0.10	1.20
1946935	2023-11-06 00:00:00	9	3	1.22	5.80	9.90	1.25	6.20	11.00	0	2	3	3	2	1	3	4	4	1	0	0	4	3	1	1	1	2	2	1	1	1	0.03	0.40	1.10
2158350	2024-11-24 00:00:00	9	0	8.70	6.20	1.25	11.00	6.30	1.25	1	0	3	5	2	3	6	2	6	2	6	2	8	1	3	1	2	1	2	1	1	0	2.30	0.10	0.00
2158351	2024-11-24 00:00:00	9	1	1.46	4.75	5.40	1.49	4.75	6.00	1	1	1	2	2	2	3	3	3	3	3	3	6	1	1	1	1	1	1	1	0	1	0.03	0.00	0.60
1946925	2023-09-24 23:00:00	9	3	1.25	5.60	8.80	1.30	6.00	8.80	1	0	0	1	2	1	2	2	1	0	0	1	2	1	1	3	2	2	1	1	1	0	0.05	0.40	0.00
2158352	2024-11-24 00:00:00	9	3	2.35	3.75	2.58	2.47	3.75	2.65	2	1	3	4	1	4	6	2	7	2	6	1	8	2	3	1	2	1	3	1	0	1	0.12	0.00	0.07
1946924	2023-09-03 23:00:00	9	0	4.40	4.00	1.65	5.00	4.20	1.63	2	1	1	1	1	2	3	2	3	0	1	0	3	1	3	1	2	1	2	1	1	-1	0.60	0.20	-0.02
2158353	2024-11-24 00:00:00	9	3	1.47	4.55	5.60	1.47	4.65	6.50	5	1	3	3	3	6	8	4	9	3	7	2	11	2	3	1	2	1	3	0	1	1	0.00	0.10	0.90
2158354	2024-11-24 00:00:00	9	3	1.72	3.85	4.15	1.68	4.00	4.90	2	3	2	2	4	5	4	7	7	5	2	2	9	3	1	1	1	2	2	-1	1	1	-0.04	0.15	0.75
2158357	2024-12-02 00:00:00	9	1	1.82	4.10	3.90	1.82	4.10	3.90	0	0	0	0	1	1	0	1	1	1	0	0	1	3	1	1	1	2	2	0	0	0	0.00	0.00	0.00
1946916	2023-08-20 00:00:00	9	1	1.42	4.50	5.70	1.48	4.65	6.30	3	4	5	7	2	5	10	6	10	1	5	1	11	1	3	1	2	1	2	1	1	1	0.06	0.15	0.60
2158361	2024-12-02 00:00:00	9	3	2.26	3.60	2.76	2.33	3.70	2.85	1	0	1	1	1	2	2	1	3	1	2	0	3	2	3	1	2	1	3	1	1	1	0.07	0.10	0.09
1946913	2023-09-03 00:00:00	9	1	1.58	4.15	4.75	1.61	4.25	5.20	1	0	0	1	1	2	2	1	2	0	1	0	2	1	3	1	2	1	2	1	1	1	0.03	0.10	0.45
1946914	2023-09-17 23:00:00	9	1	3.25	3.75	1.91	3.65	4.05	1.89	2	2	2	4	3	4	6	5	6	1	2	1	7	1	3	1	2	1	2	1	1	-1	0.40	0.30	-0.02
2132320	2023-12-11 00:00:00	9	0	1.38	4.30	6.50	1.38	4.60	6.60	3	2	3	4	5	5	7	7	8	2	2	1	9	2	2	1	1	1	3	0	1	1	0.00	0.30	0.10
1946972	2023-11-27 00:00:00	9	3	1.89	3.95	3.20	1.98	4.10	3.10	1	0	1	3	1	1	4	1	2	0	3	2	4	1	3	2	3	1	2	1	1	-1	0.09	0.15	-0.10
1946975	2023-11-27 00:00:00	9	3	1.59	3.95	5.00	1.54	4.25	6.20	3	1	3	3	4	4	6	5	7	2	3	1	8	2	3	1	2	1	3	-1	1	1	-0.05	0.30	1.20
1946968	2023-11-13 00:00:00	9	3	1.86	4.15	3.30	1.89	4.30	3.45	1	0	3	2	2	2	3	2	5	2	3	0	5	2	3	1	2	1	3	1	1	1	0.03	0.15	0.15
1946971	2023-11-13 00:00:00	9	3	1.09	12.00	12.00	1.08	13.00	21.00	1	0	1	0	1	1	1	1	2	1	1	0	2	2	2	1	1	1	3	-1	1	1	-0.01	1.00	9.00
1946962	2023-11-06 00:00:00	9	3	3.35	3.70	1.88	3.75	4.00	1.88	1	0	0	1	3	0	2	3	0	1	0	3	3	2	1	3	2	3	1	1	1	0	0.40	0.30	0.00
1946957	2023-10-30 00:00:00	9	1	1.58	4.50	5.10	1.58	4.50	5.10	0	0	0	1	1	1	1	1	1	0	0	0	1	1	1	1	1	1	1	0	0	0	0.00	0.00	0.00
1946955	2023-10-31 04:00:00	9	0	1.58	4.25	5.50	1.60	4.25	5.30	1	1	2	3	2	1	4	3	3	1	2	2	5	1	2	2	3	1	1	1	0	-1	0.02	0.00	-0.20
1946985	2023-12-04 00:00:00	9	1	1.26	6.50	9.80	1.26	6.50	9.90	0	0	0	0	0	1	0	0	1	2	2	1	2	2	2	1	1	1	3	0	0	1	0.00	0.00	0.10
1946983	2023-12-04 00:00:00	9	3	1.38	5.30	6.00	1.43	5.60	5.80	2	0	2	2	2	2	4	2	4	0	2	0	4	1	3	1	2	1	2	1	1	-1	0.05	0.30	-0.20
2253356	2024-07-20 23:30:00	10	0	2.38	3.65	2.59	2.48	3.70	2.67	3	0	1	2	1	3	5	1	4	0	4	1	5	1	3	2	3	1	2	1	1	1	0.10	0.05	0.08
2137609	2024-10-20 20:00:00	10	3	2.33	3.40	2.80	2.33	3.35	2.82	0	1	0	0	0	2	0	1	2	3	2	1	3	3	2	1	1	2	3	0	-1	1	0.00	-0.05	0.02
2329100	2024-11-24 22:00:00	10	3	1.56	3.95	5.40	1.56	3.95	5.40	0	0	0	0	0	0	0	0	0	1	1	1	1	1	1	1	1	1	1	0	0	0	0.00	0.00	0.00
2137617	2024-10-29 02:10:00	10	3	1.45	4.20	6.30	1.45	4.75	6.70	11	6	11	7	10	13	18	16	24	12	14	6	30	2	3	1	2	1	3	0	1	1	0.00	0.55	0.40
2137619	2024-10-26 21:00:00	10	0	2.82	3.60	2.23	3.15	3.70	2.16	0	0	2	3	2	1	3	2	3	0	1	0	3	1	3	1	2	1	2	1	1	-1	0.33	0.10	-0.07
2137627	2024-11-02 22:00:00	10	1	1.78	3.85	3.90	1.72	3.95	4.65	4	2	2	3	3	6	7	5	8	2	4	1	9	2	3	1	2	1	3	-1	1	1	-0.06	0.10	0.75
2137630	2024-11-10 22:00:00	10	3	1.32	5.00	8.60	1.35	5.10	8.90	1	1	2	2	3	3	3	4	5	2	1	0	5	3	2	1	1	2	3	1	1	1	0.03	0.10	0.30
1946301	2023-07-02 21:00:00	10	1	4.35	4.00	1.75	4.35	4.00	1.75	0	0	1	1	1	0	1	1	1	0	0	0	1	1	1	1	1	1	1	0	0	0	0.00	0.00	0.00
1946300	2023-07-02 21:00:00	10	1	2.54	3.20	2.67	2.56	3.30	2.81	3	0	0	1	1	4	4	1	4	0	3	0	4	1	3	1	2	1	2	1	1	1	0.02	0.10	0.14
1946303	2023-07-04 01:00:00	10	3	1.60	4.20	5.40	1.57	4.30	5.60	2	0	1	0	2	2	2	2	3	1	1	0	3	2	2	1	1	1	3	-1	1	1	-0.03	0.10	0.20
1946302	2023-07-02 23:30:00	10	3	1.17	6.50	14.00	1.19	6.70	17.00	1	0	0	1	3	2	2	3	2	1	0	1	3	2	1	2	1	3	1	1	1	1	0.02	0.20	3.00
1946297	2023-07-01 21:00:00	10	0	2.79	3.35	2.37	2.82	3.35	2.34	0	0	2	2	0	0	2	0	2	0	2	0	2	1	3	1	2	1	2	1	0	-1	0.03	0.00	-0.03
1946296	2023-06-11 23:30:00	10	3	1.34	4.70	8.00	1.36	5.00	8.60	1	1	2	2	2	2	3	3	4	1	1	0	4	2	2	1	1	1	3	1	1	1	0.02	0.30	0.60
1946299	2023-07-01 23:30:00	10	3	1.27	5.40	9.70	1.29	5.70	9.90	1	0	1	1	2	2	2	2	3	1	1	0	3	2	2	1	1	1	3	1	1	1	0.02	0.30	0.20
1946293	2023-06-11 21:00:00	10	0	3.15	3.25	2.20	3.25	3.50	2.20	0	1	0	1	1	1	1	2	1	1	0	1	2	2	1	2	1	3	1	1	1	0	0.10	0.25	0.00
1946292	2023-06-10 23:30:00	10	0	2.69	3.20	2.53	2.76	3.30	2.60	0	0	1	2	1	1	2	1	2	0	1	0	2	1	3	1	2	1	2	1	1	1	0.07	0.10	0.07
1946295	2023-06-11 23:30:00	10	1	1.53	3.95	5.80	1.54	4.10	6.30	0	1	2	2	1	1	2	2	3	1	1	0	3	2	2	1	1	1	3	1	1	1	0.01	0.15	0.50
1946294	2023-06-11 21:00:00	10	3	2.19	3.50	2.97	2.19	3.55	3.20	0	1	1	0	2	2	0	3	3	3	0	0	3	3	1	1	1	2	2	0	1	1	0.00	0.05	0.23
1946289	2023-06-10 21:00:00	10	3	1.63	3.80	4.95	1.62	3.95	5.60	1	0	0	0	1	2	1	1	2	1	1	0	2	2	2	1	1	1	3	-1	1	1	-0.01	0.15	0.65
1946288	2023-06-06 01:10:00	10	3	1.17	6.90	12.00	1.20	7.10	14.00	1	4	1	4	2	1	5	6	2	2	1	5	7	2	1	3	2	3	1	1	1	1	0.03	0.20	2.00
1946291	2023-06-10 21:00:00	10	0	5.60	4.05	1.53	6.10	4.15	1.55	0	0	1	2	2	1	2	2	2	0	0	0	2	1	1	1	1	1	1	1	1	1	0.50	0.10	0.02
1946290	2023-06-10 01:00:00	10	3	1.70	4.05	4.70	1.67	4.00	5.00	1	3	2	2	4	4	3	7	6	4	0	1	7	3	1	2	1	3	2	-1	-1	1	-0.03	-0.05	0.30
1946285	2023-06-04 23:30:00	10	1	1.98	3.65	3.70	1.97	3.65	3.70	3	0	1	1	0	3	4	0	4	1	5	1	5	1	3	1	2	1	2	-1	0	0	-0.01	0.00	0.00
1946284	2023-06-04 21:00:00	10	1	3.35	3.35	2.21	3.35	3.35	2.21	0	0	0	1	1	0	1	1	0	0	0	1	1	1	1	3	2	2	1	0	0	0	0.00	0.00	0.00
1946287	2023-06-06 01:00:00	10	0	7.00	4.85	1.37	7.30	5.00	1.40	4	2	3	4	3	4	8	5	7	0	3	1	8	1	3	2	3	1	2	1	1	1	0.30	0.15	0.03
1946333	2023-07-30 21:00:00	10	3	1.88	3.70	4.05	1.88	3.70	4.05	0	0	0	1	0	1	1	0	1	0	1	0	1	1	3	1	2	1	2	0	0	0	0.00	0.00	0.00
1946332	2023-07-30 02:00:00	10	0	1.89	3.55	4.15	1.99	3.45	3.85	5	3	7	8	2	6	13	5	13	1	9	1	14	1	3	1	2	1	2	1	-1	-1	0.10	-0.10	-0.30
1946335	2023-07-30 21:00:00	10	0	3.60	3.30	2.13	3.60	3.30	2.13	0	0	0	1	1	0	1	1	0	0	0	1	1	1	1	3	2	2	1	0	0	0	0.00	0.00	0.00
1946334	2023-08-01 01:00:00	10	3	1.26	5.30	10.00	1.33	5.20	8.90	3	2	4	4	3	5	7	5	9	2	4	0	9	2	3	1	2	1	3	1	-1	-1	0.07	-0.10	-1.10
1946329	2023-07-29 23:30:00	10	3	2.80	3.50	2.30	2.75	3.65	2.42	1	0	1	1	1	1	2	1	2	0	1	0	2	1	3	1	2	1	2	-1	1	1	-0.05	0.15	0.12
1946328	2023-07-22 23:30:00	10	3	3.95	4.10	1.72	4.50	4.05	1.72	3	2	2	3	3	1	6	5	3	1	2	4	7	1	2	3	3	2	1	1	-1	0	0.55	-0.05	0.00
1946331	2023-07-29 21:00:00	10	3	2.26	3.65	2.76	2.34	3.60	2.66	1	1	1	1	1	1	2	2	2	0	0	0	2	1	1	1	1	1	1	1	-1	-1	0.08	-0.05	-0.10
1946330	2023-07-30 23:30:00	10	3	2.16	3.25	3.60	2.16	3.25	3.60	0	0	0	0	1	1	0	1	1	1	0	0	1	3	1	1	1	2	2	0	0	0	0.00	0.00	0.00
1946325	2023-07-23 23:30:00	10	1	2.14	3.40	3.45	2.13	3.40	3.50	1	0	0	0	1	2	1	1	2	1	1	0	2	2	2	1	1	1	3	-1	0	1	-0.01	0.00	0.05
1946324	2023-07-23 23:30:00	10	3	1.52	3.95	5.80	1.58	3.95	6.20	0	0	2	2	0	1	2	0	3	1	3	0	3	2	3	1	2	1	3	1	0	1	0.06	0.00	0.40
1946327	2023-07-25 01:00:00	10	0	2.17	3.45	3.35	2.21	3.45	3.25	0	0	1	1	1	1	1	1	2	1	1	0	2	2	2	1	1	1	3	1	0	-1	0.04	0.00	-0.10
1946326	2023-07-23 21:00:00	10	3	1.58	4.20	5.60	1.58	4.20	5.60	0	0	0	1	1	1	1	1	1	0	0	0	1	1	1	1	1	1	1	0	0	0	0.00	0.00	0.00
1946320	2023-07-18 01:00:00	10	0	3.85	3.45	1.89	4.40	3.40	1.89	3	1	2	2	0	3	5	1	5	0	4	0	5	1	3	1	2	1	2	1	-1	0	0.55	-0.05	0.00
1946322	2023-07-22 01:00:00	10	3	2.80	3.50	2.29	3.00	3.55	2.31	1	1	0	4	2	1	5	3	1	0	2	4	5	1	2	3	3	2	1	1	1	1	0.20	0.05	0.02
1946317	2023-07-16 21:00:00	10	3	1.84	3.60	3.90	1.86	3.65	4.20	0	1	2	2	1	1	2	2	3	2	2	1	4	2	2	1	1	1	3	1	1	1	0.02	0.05	0.30
1946316	2023-07-16 21:00:00	10	1	1.27	5.30	9.70	1.30	5.40	10.00	2	2	2	3	3	3	5	5	5	0	0	0	5	1	1	1	1	1	1	1	1	1	0.03	0.10	0.30
1946318	2023-07-16 23:30:00	10	0	2.20	3.35	3.40	2.20	3.35	3.40	0	0	0	0	1	1	0	1	1	1	0	0	1	3	1	1	1	2	2	0	0	0	0.00	0.00	0.00
1946313	2023-07-15 21:00:00	10	1	2.40	3.20	2.84	2.40	3.20	2.84	0	0	0	0	0	1	0	0	1	1	1	0	1	2	2	1	1	1	3	0	0	0	0.00	0.00	0.00
1946312	2023-07-11 01:00:00	10	0	1.98	3.55	3.80	2.02	3.55	3.65	1	0	2	2	1	1	3	1	3	2	4	2	5	1	3	1	2	1	2	1	0	-1	0.04	0.00	-0.15
1946315	2023-07-15 23:30:00	10	3	1.24	6.10	9.30	1.28	6.10	9.40	1	1	1	1	2	2	2	3	3	1	0	0	3	3	1	1	1	2	2	1	0	1	0.04	0.00	0.10
1946314	2023-07-15 23:30:00	10	0	2.70	3.50	2.35	2.71	3.50	2.35	0	0	1	2	0	0	2	0	1	0	2	1	2	1	3	2	3	1	2	1	0	0	0.01	0.00	0.00
1946309	2023-07-09 21:00:00	10	0	2.65	3.40	2.44	2.77	3.65	2.42	4	0	3	4	2	4	8	2	7	0	6	1	8	1	3	2	3	1	2	1	1	-1	0.12	0.25	-0.02
1946308	2023-07-09 21:00:00	10	0	1.29	5.20	8.60	1.26	5.80	12.00	3	3	5	4	4	4	7	7	9	2	2	0	9	2	2	1	1	1	3	-1	1	1	-0.03	0.60	3.40
1946311	2023-07-11 01:00:00	10	0	1.59	3.85	5.30	1.61	3.95	5.80	3	2	1	2	3	5	5	5	6	1	1	0	6	2	2	1	1	1	3	1	1	1	0.02	0.10	0.50
1946305	2023-07-08 21:00:00	10	0	2.95	3.60	2.16	3.35	3.80	2.06	1	0	4	4	1	1	5	1	5	0	4	0	5	1	3	1	2	1	2	1	1	-1	0.40	0.20	-0.10
1946304	2023-07-04 01:00:00	10	1	2.58	3.05	2.75	2.63	3.15	2.83	3	1	4	6	1	4	9	2	8	0	7	1	9	1	3	2	3	1	2	1	1	1	0.05	0.10	0.08
1946307	2023-07-08 21:00:00	10	0	3.30	3.45	2.19	3.30	3.45	2.19	0	0	0	1	1	0	1	1	0	0	0	1	1	1	1	3	2	2	1	0	0	0	0.00	0.00	0.00
1946306	2023-07-08 23:30:00	10	0	1.88	3.80	3.95	1.88	3.80	3.95	1	0	0	0	1	1	1	1	1	0	0	0	1	1	1	1	1	1	1	0	0	0	0.00	0.00	0.00
1946364	2023-08-29 01:00:00	10	3	1.52	4.40	6.10	1.55	4.35	5.80	0	3	3	3	2	1	3	5	4	3	1	2	6	3	1	2	1	3	2	1	-1	-1	0.03	-0.05	-0.30
1946361	2023-08-29 01:00:00	10	3	1.40	4.50	7.00	1.45	4.55	7.30	2	4	5	5	3	3	7	7	8	1	1	0	8	2	2	1	1	1	3	1	1	1	0.05	0.05	0.30
1946363	2023-08-27 23:30:00	10	3	1.28	5.50	11.00	1.30	5.30	9.90	0	1	1	2	0	2	2	1	3	1	2	0	3	2	3	1	2	1	3	1	-1	-1	0.02	-0.20	-1.10
1946359	2023-08-22 01:10:00	10	3	2.68	3.40	2.41	2.89	3.40	2.43	1	1	4	6	1	3	7	2	7	0	5	0	7	1	3	1	2	1	2	1	0	1	0.21	0.00	0.02
1946358	2023-08-20 21:00:00	10	1	1.72	3.85	4.15	1.69	3.90	4.95	1	1	2	0	2	3	1	3	5	4	2	0	5	3	2	1	1	2	3	-1	1	1	-0.03	0.05	0.80
2050291	2023-07-18 01:00:00	10	3	2.60	3.45	2.47	2.69	3.40	2.61	4	1	5	6	0	5	10	1	10	0	9	0	10	1	3	1	2	1	2	1	-1	1	0.09	-0.05	0.14
1946351	2023-08-13 21:00:00	10	3	2.25	3.45	2.90	2.25	3.45	2.91	1	0	0	0	1	2	1	1	2	1	1	0	2	2	2	1	1	1	3	0	0	1	0.00	0.00	0.01
1946350	2023-08-15 01:00:00	10	3	5.10	3.65	1.73	4.70	3.60	1.79	2	2	2	2	2	2	4	4	4	0	0	0	4	1	1	1	1	1	1	-1	-1	1	-0.40	-0.05	0.06
1946345	2023-08-13 21:00:00	10	3	3.40	3.35	2.06	3.35	3.35	2.07	1	0	0	1	0	1	2	0	1	0	2	1	2	1	3	2	3	1	2	-1	0	1	-0.05	0.00	0.01
1946341	2023-08-06 21:00:00	10	3	1.26	5.80	8.90	1.31	5.70	9.00	2	1	3	4	0	3	6	1	6	0	5	0	6	1	3	1	2	1	2	1	-1	1	0.05	-0.10	0.10
1946340	2023-08-06 21:00:00	10	1	3.15	3.25	2.35	3.15	3.25	2.35	0	0	1	1	1	0	1	1	1	0	0	0	1	1	1	1	1	1	1	0	0	0	0.00	0.00	0.00
1946343	2023-08-08 01:00:00	10	3	2.17	3.45	3.35	2.17	3.45	3.35	0	0	0	0	1	1	0	1	1	1	0	0	1	3	1	1	1	2	2	0	0	0	0.00	0.00	0.00
1946342	2023-08-08 01:00:00	10	3	1.28	5.50	11.00	1.25	5.80	13.00	2	1	0	2	2	2	4	3	2	0	1	2	4	1	2	3	3	2	1	-1	1	1	-0.03	0.30	2.00
1946336	2023-08-01 01:00:00	10	0	3.10	3.40	2.33	2.98	3.35	2.40	1	1	0	1	1	1	2	2	1	0	0	1	2	1	1	3	2	2	1	-1	-1	1	-0.12	-0.05	0.07
1946339	2023-08-05 21:00:00	10	0	2.14	3.55	3.00	2.14	3.60	3.30	0	0	2	0	2	2	0	2	4	4	2	0	4	3	2	1	1	2	3	0	1	1	0.00	0.05	0.30
1946399	2023-09-30 23:30:00	10	3	2.03	3.55	3.65	2.03	3.55	3.65	1	0	0	0	1	1	1	1	1	0	0	0	1	1	1	1	1	1	1	0	0	0	0.00	0.00	0.00
1946388	2023-09-26 01:00:00	10	0	4.20	3.85	1.81	4.00	3.75	1.87	2	2	0	2	1	2	4	3	2	0	1	2	4	1	2	3	3	2	1	-1	-1	1	-0.20	-0.10	0.06
1946387	2023-09-23 21:00:00	10	0	6.70	4.65	1.40	7.20	4.85	1.42	2	1	3	4	5	3	6	6	6	0	0	0	6	1	1	1	1	1	1	1	1	1	0.50	0.20	0.02
1946382	2023-09-17 21:00:00	10	0	2.70	3.40	2.40	2.70	3.40	2.40	1	1	0	0	0	1	1	1	1	0	0	0	1	1	1	1	1	1	1	0	0	0	0.00	0.00	0.00
1946378	2023-09-16 23:30:00	10	0	1.48	4.20	6.10	1.51	4.30	6.40	1	0	0	1	2	2	2	2	2	0	0	0	2	1	1	1	1	1	1	1	1	1	0.03	0.10	0.30
1946373	2023-09-03 23:30:00	10	1	1.38	4.65	6.70	1.42	4.80	7.20	1	1	1	2	2	2	3	3	3	1	1	1	4	1	1	1	1	1	1	1	1	1	0.04	0.15	0.50
2137401	2024-03-31 20:00:00	10	3	1.84	3.65	3.55	1.87	3.70	4.10	1	3	5	4	4	4	5	7	9	5	3	1	10	3	2	1	1	2	3	1	1	1	0.03	0.05	0.55
2137402	2024-03-30 22:00:00	10	0	5.30	4.15	1.50	6.30	4.40	1.51	0	0	0	3	1	1	3	1	1	0	2	2	3	1	2	2	3	1	1	1	1	1	1.00	0.25	0.01
1946369	2023-09-03 21:00:00	10	3	4.65	4.40	1.56	5.20	4.45	1.58	0	1	1	3	2	1	3	3	2	1	1	2	4	1	1	3	2	2	1	1	1	1	0.55	0.05	0.02
2137405	2024-04-06 21:00:00	10	1	2.97	3.45	2.21	3.20	3.50	2.21	0	1	0	2	1	0	2	2	0	1	1	3	3	1	1	3	2	2	1	1	1	0	0.23	0.05	0.00
2137406	2024-04-09 01:10:00	10	1	1.79	3.90	4.25	1.80	3.90	4.20	1	1	1	1	2	2	2	3	3	1	0	0	3	3	1	1	1	2	2	1	0	-1	0.01	0.00	-0.05
2328323	2024-11-22 02:00:00	10	1	3.40	3.35	2.06	3.25	3.15	2.21	6	6	3	7	5	4	13	11	7	6	8	12	19	1	2	3	3	2	1	-1	-1	1	-0.15	-0.20	0.15
1946428	2023-11-05 22:00:00	10	3	2.95	3.80	2.09	3.50	4.00	1.95	3	0	5	5	3	0	8	3	5	1	6	4	9	1	3	2	3	1	2	1	1	-1	0.55	0.20	-0.14
1946426	2023-11-06 00:30:00	10	1	1.23	6.00	9.90	1.26	6.20	11.00	1	1	0	2	2	3	3	3	3	2	2	2	5	1	1	1	1	1	1	1	1	1	0.03	0.20	1.10
1946423	2023-10-29 22:00:00	10	0	4.85	4.15	1.59	5.40	4.40	1.57	2	1	1	2	3	0	4	4	1	0	0	3	4	1	1	3	2	2	1	1	1	-1	0.55	0.25	-0.02
1946418	2023-10-28 21:00:00	10	0	3.20	3.55	2.07	3.55	3.65	1.90	4	3	9	10	5	3	14	8	12	1	7	3	15	1	3	2	3	1	2	1	1	-1	0.35	0.10	-0.17
1946410	2023-10-22 21:00:00	10	1	2.04	3.50	3.30	2.04	3.50	3.30	1	0	0	0	0	1	1	0	1	0	1	0	1	1	3	1	2	1	2	0	0	0	0.00	0.00	0.00
1946406	2023-10-08 21:00:00	10	3	4.45	3.90	1.76	4.45	3.90	1.76	0	0	0	1	1	1	1	1	1	0	0	0	1	1	1	1	1	1	1	0	0	0	0.00	0.00	0.00
2137440	2024-04-28 22:30:00	10	0	1.56	4.55	5.30	1.56	4.55	5.30	0	0	0	0	1	1	0	1	1	1	0	0	1	3	1	1	1	2	2	0	0	0	0.00	0.00	0.00
2137442	2024-04-28 20:00:00	10	3	1.43	4.30	6.70	1.46	4.40	7.30	0	2	3	2	1	1	2	3	4	2	1	0	4	3	2	1	1	2	3	1	1	1	0.03	0.10	0.60
2137443	2024-04-30 01:00:00	10	3	2.06	3.35	3.80	2.02	3.35	3.90	3	1	2	3	2	3	6	3	5	1	4	2	7	1	3	2	3	1	2	-1	0	1	-0.04	0.00	0.10
2137445	2024-05-05 22:30:00	10	3	1.71	3.80	4.95	1.71	3.80	4.95	0	0	0	0	1	1	0	1	1	1	0	0	1	3	1	1	1	2	2	0	0	0	0.00	0.00	0.00
2137447	2024-05-05 20:00:00	10	3	3.75	3.65	1.85	4.20	3.80	1.83	1	0	3	1	1	1	2	1	4	2	3	0	4	2	3	1	2	1	3	1	1	-1	0.45	0.15	-0.02
2137450	2024-05-04 21:00:00	10	1	2.31	3.40	3.10	2.31	3.40	3.10	0	0	0	0	1	1	0	1	1	1	0	0	1	3	1	1	1	2	2	0	0	0	0.00	0.00	0.00
2137453	2024-05-11 21:00:00	10	0	1.68	3.90	5.00	1.68	3.90	5.00	0	0	0	0	1	1	0	1	1	1	0	0	1	3	1	1	1	2	2	0	0	0	0.00	0.00	0.00
2137454	2024-05-12 22:30:00	10	3	1.94	3.55	3.55	1.95	3.55	3.90	1	0	3	3	0	2	4	0	5	1	5	0	5	2	3	1	2	1	3	1	0	1	0.01	0.00	0.35
2137458	2024-05-11 21:00:00	10	0	3.00	3.15	2.49	3.00	3.15	2.49	0	0	0	1	0	0	1	0	0	0	1	1	1	1	2	2	3	1	1	0	0	0	0.00	0.00	0.00
2137459	2024-05-12 20:00:00	10	0	2.48	3.55	2.53	2.48	3.55	2.53	0	0	1	1	0	0	1	0	1	0	1	0	1	1	3	1	2	1	2	0	0	0	0.00	0.00	0.00
2137464	2024-05-17 01:00:00	10	1	2.16	3.55	2.99	2.21	3.60	3.10	0	1	2	2	2	1	2	3	3	2	1	1	4	3	1	1	1	2	2	1	1	1	0.05	0.05	0.11
2137466	2024-05-16 01:00:00	10	3	2.29	3.35	2.91	2.28	3.40	3.15	1	0	3	1	1	4	2	1	7	5	6	0	7	2	3	1	2	1	3	-1	1	1	-0.01	0.05	0.24
1946438	2023-11-12 22:00:00	10	3	1.73	3.90	4.10	1.73	4.10	4.40	0	0	0	0	1	2	0	1	2	2	1	0	2	3	2	1	1	2	3	0	1	1	0.00	0.20	0.30
1946432	2023-11-04 22:00:00	10	1	2.23	3.55	2.86	2.29	3.65	2.94	1	0	3	1	2	3	2	2	6	4	4	0	6	2	2	1	1	1	3	1	1	1	0.06	0.10	0.08
2137469	2024-05-19 20:00:00	10	3	1.96	3.75	3.30	1.93	3.75	3.40	2	0	0	0	0	3	2	0	3	1	3	0	3	2	3	1	2	1	3	-1	0	1	-0.03	0.00	0.10
2137408	2024-04-09 01:00:00	10	0	2.29	3.45	2.82	2.40	3.60	2.82	0	1	3	2	1	2	2	2	5	3	3	0	5	2	2	1	1	1	3	1	1	0	0.11	0.15	0.00
2137417	2024-04-13 21:00:00	10	1	2.64	3.15	2.62	2.64	3.20	2.78	5	0	0	2	1	7	7	1	7	0	6	0	7	1	3	1	2	1	2	0	1	1	0.00	0.05	0.16
2137418	2024-04-14 20:00:00	10	3	2.09	3.70	3.30	2.09	3.70	3.30	0	0	0	0	1	1	0	1	1	1	0	0	1	3	1	1	1	2	2	0	0	0	0.00	0.00	0.00
2137421	2024-04-21 20:00:00	10	3	2.85	3.10	2.48	2.99	3.20	2.48	1	0	3	5	1	3	6	1	6	0	5	0	6	1	3	1	2	1	2	1	1	0	0.14	0.10	0.00
2137424	2024-04-20 21:00:00	10	1	1.87	3.40	3.95	1.88	3.65	4.10	2	0	3	4	1	3	6	1	6	1	6	1	7	1	3	1	2	1	2	1	1	1	0.01	0.25	0.15
2137435	2024-04-26 01:00:00	10	3	3.00	3.50	2.16	3.25	3.60	2.16	2	0	1	2	1	1	4	1	2	0	3	2	4	1	3	2	3	1	2	1	1	0	0.25	0.10	0.00
2137504	2024-07-16 01:00:00	10	0	1.94	3.60	3.50	1.94	3.80	3.70	5	3	6	5	6	5	10	9	11	11	12	10	21	2	3	1	2	1	3	0	1	1	0.00	0.20	0.20
2137505	2024-07-14 22:30:00	10	0	2.56	3.45	2.51	2.67	3.50	2.56	2	0	2	2	2	4	4	2	6	2	4	0	6	2	3	1	2	1	3	1	1	1	0.11	0.05	0.05
2137506	2024-07-13 21:00:00	10	3	4.55	3.80	1.67	4.95	4.00	1.67	4	0	0	2	3	0	6	3	0	1	4	7	7	1	2	3	3	2	1	1	1	0	0.40	0.20	0.00
2137507	2024-07-13 23:30:00	10	3	2.16	3.50	3.00	2.16	3.55	3.25	1	2	2	2	2	3	3	4	5	5	4	3	8	3	2	1	1	2	3	0	1	1	0.00	0.05	0.25
2137508	2024-07-14 22:30:00	10	3	1.72	3.95	4.05	1.79	3.85	4.30	1	1	1	2	0	1	3	1	2	1	3	2	4	1	3	2	3	1	2	1	-1	1	0.07	-0.10	0.25
2137510	2024-07-21 22:30:00	10	3	1.97	3.60	3.40	1.97	3.75	3.60	2	2	4	2	3	3	4	5	7	3	2	0	7	3	2	1	1	2	3	0	1	1	0.00	0.15	0.20
2137511	2024-07-23 01:00:00	10	3	2.37	3.50	2.69	2.56	3.55	2.64	1	2	3	4	2	2	5	4	5	1	2	1	6	1	3	1	2	1	2	1	1	-1	0.19	0.05	-0.05
2137512	2024-07-21 22:30:00	10	1	2.08	3.55	3.15	2.17	3.65	3.20	0	1	1	1	3	1	1	4	2	4	1	3	5	3	1	2	1	3	2	1	1	1	0.09	0.10	0.05
2137513	2024-07-20 21:00:00	10	3	4.35	3.90	1.69	4.55	3.80	1.77	7	5	0	4	3	4	11	8	4	2	5	9	13	1	2	3	3	2	1	1	-1	1	0.20	-0.10	0.08
2137514	2024-07-21 20:00:00	10	3	1.91	3.85	3.40	1.89	3.80	3.90	2	4	5	5	4	4	7	8	9	5	4	3	12	3	2	1	1	2	3	-1	-1	1	-0.02	-0.05	0.50
2137515	2024-07-20 01:00:00	10	0	4.90	4.35	1.54	4.95	4.55	1.60	2	2	0	1	3	2	3	5	2	3	1	4	6	2	1	3	2	3	1	1	1	1	0.05	0.20	0.06
2137516	2024-07-30 01:00:00	10	0	1.87	3.65	3.70	1.92	3.75	3.85	5	3	6	8	3	6	13	6	12	1	8	2	14	1	3	2	3	1	2	1	1	1	0.05	0.10	0.15
2137517	2024-07-20 21:00:00	10	1	2.74	3.65	2.26	2.92	3.80	2.25	1	1	1	2	2	1	3	3	2	0	0	1	3	1	1	3	2	2	1	1	1	-1	0.18	0.15	-0.01
2137518	2024-07-28 22:30:00	10	0	2.26	3.55	2.82	2.35	3.65	2.86	2	0	3	4	1	3	6	1	6	0	5	0	6	1	3	1	2	1	2	1	1	1	0.09	0.10	0.04
2137519	2024-07-27 23:30:00	10	0	2.04	3.65	3.15	2.09	3.65	3.40	1	0	1	4	0	1	5	0	2	1	6	4	6	1	3	2	3	1	2	1	0	1	0.05	0.00	0.25
2137520	2024-07-28 22:30:00	10	3	1.68	4.30	4.50	1.68	4.30	4.50	0	0	0	0	1	1	0	1	1	1	0	0	1	3	1	1	1	2	2	0	0	0	0.00	0.00	0.00
2137521	2024-07-28 02:00:00	10	3	2.93	3.35	2.28	3.05	3.45	2.31	5	2	2	5	2	3	10	4	5	0	6	5	10	1	3	2	3	1	2	1	1	1	0.12	0.10	0.03
2137522	2024-07-28 22:30:00	10	3	2.21	3.45	2.96	2.21	3.55	3.20	0	0	1	0	1	2	0	1	3	3	2	0	3	3	2	1	1	2	3	0	1	1	0.00	0.10	0.24
2137523	2024-07-27 23:30:00	10	0	1.23	6.00	10.00	1.25	6.60	10.00	1	2	4	2	5	7	3	7	11	9	5	1	12	3	2	1	1	2	3	1	1	0	0.02	0.60	0.00
2137524	2024-07-27 21:00:00	10	3	2.26	3.55	2.82	2.25	3.70	2.98	1	2	5	0	4	8	1	6	13	12	7	0	13	3	2	1	1	2	3	-1	1	1	-0.01	0.15	0.16
2137525	2024-08-03 23:30:00	10	3	1.62	4.05	4.65	1.66	3.90	5.20	1	4	4	4	0	3	5	4	7	3	4	1	8	2	3	1	2	1	3	1	-1	1	0.04	-0.15	0.55
2137526	2024-08-04 20:00:00	10	1	1.67	3.90	4.45	1.67	4.15	4.75	0	2	3	0	4	3	0	6	6	6	0	0	6	3	1	1	1	2	2	0	1	1	0.00	0.25	0.30
2137527	2024-08-03 21:00:00	10	0	1.72	3.90	4.70	1.72	3.90	4.70	0	0	0	0	0	1	0	0	1	1	1	0	1	2	2	1	1	1	3	0	0	0	0.00	0.00	0.00
2137528	2024-08-04 22:30:00	10	0	2.86	3.55	2.23	3.15	3.55	2.23	1	0	0	1	0	1	2	0	1	0	2	1	2	1	3	2	3	1	2	1	0	0	0.29	0.00	0.00
2137529	2024-05-29 01:00:00	10	3	1.41	4.75	6.30	1.45	4.70	6.90	2	4	7	5	3	4	7	7	11	8	8	4	15	2	2	1	1	1	3	1	-1	1	0.04	-0.05	0.60
2137530	2024-05-30 01:00:00	10	3	2.47	3.65	2.69	2.51	3.65	2.64	1	1	3	4	2	2	5	3	5	0	2	0	5	1	3	1	2	1	2	1	0	-1	0.04	0.00	-0.05
2137531	2024-08-04 20:00:00	10	0	2.42	3.50	2.63	2.52	3.50	2.71	8	0	3	4	0	8	12	0	11	0	12	1	12	1	3	2	3	1	2	1	0	1	0.10	0.00	0.08
2137532	2024-08-03 21:00:00	10	0	2.36	3.50	2.68	2.51	3.50	2.73	0	0	4	4	0	2	4	0	6	2	6	0	6	2	3	1	2	1	3	1	0	1	0.15	0.00	0.05
2137533	2024-08-11 22:00:00	10	3	1.82	3.65	3.90	1.79	3.75	4.45	5	0	2	3	2	6	8	2	8	1	7	1	9	1	3	1	2	1	2	-1	1	1	-0.03	0.10	0.55
2137534	2024-08-11 22:00:00	10	3	1.69	3.90	4.30	1.72	3.95	4.65	0	3	1	1	1	3	1	4	4	4	1	1	5	3	1	1	1	2	2	1	1	1	0.03	0.05	0.35
2137535	2024-08-10 23:30:00	10	1	2.03	3.45	3.35	1.98	3.70	3.65	5	0	3	2	5	3	7	5	6	4	6	5	11	1	3	2	3	1	2	-1	1	1	-0.05	0.25	0.30
2137472	2024-05-22 01:00:00	10	3	2.20	3.30	3.10	2.26	3.40	3.20	1	2	6	2	4	5	3	6	11	8	5	0	11	3	2	1	1	2	3	1	1	1	0.06	0.10	0.10
2137473	2024-05-21 01:10:00	10	1	3.05	3.75	2.05	3.25	3.85	2.08	2	1	8	6	2	3	8	3	11	4	9	1	12	2	3	1	2	1	3	1	1	1	0.20	0.10	0.03
2137474	2024-05-19 20:00:00	10	3	2.35	3.35	2.81	2.35	3.35	2.81	0	0	1	0	0	0	0	0	1	1	1	0	1	2	2	1	1	1	3	0	0	0	0.00	0.00	0.00
2137477	2024-05-28 01:10:00	10	3	2.04	3.35	3.45	2.06	3.40	3.65	3	2	1	2	2	2	5	4	3	1	2	3	6	1	2	3	3	2	1	1	1	1	0.02	0.05	0.20
2137478	2024-05-25 01:00:00	10	3	1.32	5.10	7.90	1.35	5.20	8.50	0	2	7	3	2	4	3	4	11	8	7	0	11	3	2	1	1	2	3	1	1	1	0.03	0.10	0.60
2137479	2024-05-25 22:00:00	10	3	2.99	3.80	2.21	2.99	3.80	2.21	0	0	0	1	1	0	1	1	0	0	0	1	1	1	1	3	2	2	1	0	0	0	0.00	0.00	0.00
2137480	2024-05-26 20:00:00	10	3	2.07	3.55	3.15	2.07	3.55	3.15	0	0	1	1	0	0	1	0	1	0	1	0	1	1	3	1	2	1	2	0	0	0	0.00	0.00	0.00
2137481	2024-05-25 01:00:00	10	3	1.21	6.30	10.00	1.22	6.50	13.00	3	2	0	3	4	1	6	6	1	1	1	6	7	1	1	3	2	2	1	1	1	1	0.01	0.20	3.00
2137482	2024-05-25 23:30:00	10	0	3.05	3.25	2.23	3.35	3.30	2.23	1	0	0	2	1	0	3	1	0	0	2	3	3	1	2	3	3	2	1	1	1	0	0.30	0.05	0.00
2137483	2024-05-28 01:00:00	10	0	2.02	3.55	3.30	2.05	3.65	3.45	3	0	3	3	1	3	6	1	6	1	6	1	7	1	3	1	2	1	2	1	1	1	0.03	0.10	0.15
2137484	2024-05-26 22:30:00	10	1	2.31	3.55	2.99	2.31	3.55	2.98	0	0	1	1	1	1	1	1	2	1	1	0	2	2	2	1	1	1	3	0	0	-1	0.00	0.00	-0.01
2137485	2024-06-01 21:00:00	10	1	4.95	4.05	1.58	5.30	4.30	1.59	1	0	0	2	1	1	3	1	1	0	2	2	3	1	2	2	3	1	1	1	1	1	0.35	0.25	0.01
2137486	2024-06-02 20:00:00	10	0	1.79	3.60	4.10	1.81	3.60	4.05	1	0	1	2	0	1	3	0	2	0	3	1	3	1	3	2	3	1	2	1	0	-1	0.02	0.00	-0.05
2137487	2024-06-01 21:00:00	10	3	2.76	3.50	2.32	2.86	3.60	2.37	6	2	10	11	3	5	17	5	15	0	12	2	17	1	3	2	3	1	2	1	1	1	0.10	0.10	0.05
2137488	2024-06-02 22:30:00	10	3	2.02	3.70	3.20	2.02	3.80	3.45	0	0	0	1	1	1	1	1	1	1	1	1	2	1	1	1	1	1	1	0	1	1	0.00	0.10	0.25
2137489	2024-06-01 23:30:00	10	3	3.15	3.45	2.28	3.25	3.50	2.19	0	0	3	3	2	0	3	2	3	1	2	1	4	1	3	1	2	1	2	1	1	-1	0.10	0.05	-0.09
2137490	2024-06-02 20:00:00	10	0	2.44	3.25	2.74	2.32	3.30	2.90	4	0	2	2	1	4	6	1	6	0	5	0	6	1	3	1	2	1	2	-1	1	1	-0.12	0.05	0.16
2137491	2024-06-01 23:30:00	10	3	1.85	3.75	3.65	1.87	3.85	3.90	0	0	2	1	1	1	1	1	3	2	2	0	3	2	2	1	1	1	3	1	1	1	0.02	0.10	0.25
2137492	2024-06-02 22:30:00	10	0	2.93	3.30	2.29	3.15	3.40	2.29	1	0	0	2	1	0	3	1	0	0	2	3	3	1	2	3	3	2	1	1	1	0	0.22	0.10	0.00
2137493	2024-07-07 20:00:00	10	0	1.48	4.40	5.70	1.51	4.35	6.30	0	1	0	1	1	2	1	2	2	3	2	2	4	3	1	1	1	2	2	1	-1	1	0.03	-0.05	0.60
2137494	2024-07-06 21:00:00	10	3	1.78	3.85	3.85	1.81	3.90	4.15	1	0	2	2	2	2	3	2	4	1	2	0	4	2	3	1	2	1	3	1	1	1	0.03	0.05	0.30
2137495	2024-07-07 22:30:00	10	1	2.28	3.55	2.79	2.34	3.60	2.89	5	1	4	5	1	7	10	2	11	1	9	0	11	2	3	1	2	1	3	1	1	1	0.06	0.05	0.10
2137496	2024-07-07 22:30:00	10	3	1.15	7.40	14.00	1.19	7.20	15.00	3	3	2	3	6	2	6	9	4	4	1	6	10	2	1	3	2	3	1	1	-1	1	0.04	-0.20	1.00
2137497	2024-07-06 21:00:00	10	3	2.17	3.45	3.05	2.13	3.55	3.35	1	0	1	1	2	2	2	2	3	1	1	0	3	2	2	1	1	1	3	-1	1	1	-0.04	0.10	0.30
2137498	2024-07-09 01:00:00	10	0	4.00	3.85	1.75	4.35	3.90	1.77	6	2	4	7	2	4	13	4	8	1	10	6	14	1	3	2	3	1	2	1	1	1	0.35	0.05	0.02
2137499	2024-07-07 20:00:00	10	3	2.78	3.40	2.34	2.88	3.40	2.44	11	5	12	13	4	12	24	9	24	2	17	2	26	1	3	1	2	1	2	1	0	1	0.10	0.00	0.10
2137500	2024-07-09 01:00:00	10	0	2.65	3.60	2.36	2.67	3.80	2.42	6	1	0	5	2	1	11	3	1	0	8	10	11	1	2	3	3	2	1	1	1	1	0.02	0.20	0.06
2137501	2024-07-14 20:00:00	10	3	1.42	4.65	6.20	1.49	4.50	6.50	3	8	10	8	7	8	11	15	18	10	6	3	21	3	2	1	1	2	3	1	-1	1	0.07	-0.15	0.30
2137502	2024-07-14 22:30:00	10	0	2.06	3.80	3.00	2.01	3.95	3.35	4	1	1	1	2	4	5	3	5	3	5	3	8	1	3	1	2	1	2	-1	1	1	-0.05	0.15	0.35
2137503	2024-07-16 01:00:00	10	0	3.60	3.70	1.88	3.70	3.75	1.95	13	3	11	10	4	15	23	7	26	7	23	4	30	2	3	1	2	1	3	1	1	1	0.10	0.05	0.07
2137569	2024-09-17 01:10:00	10	1	1.59	4.20	4.75	1.54	4.35	5.80	4	2	3	3	2	5	7	4	8	2	5	1	9	2	3	1	2	1	3	-1	1	1	-0.05	0.15	1.05
2137574	2024-09-22 20:00:00	10	1	1.95	3.75	3.30	1.82	3.85	3.70	6	4	1	2	6	6	8	10	7	7	5	8	15	2	1	3	2	3	1	-1	1	1	-0.13	0.10	0.40
2137576	2024-09-24 01:00:00	10	1	1.54	4.00	5.40	1.56	4.20	5.90	3	2	5	3	5	4	6	7	9	4	3	1	10	3	2	1	1	2	3	1	1	1	0.02	0.20	0.50
2137585	2024-09-27 01:00:00	10	3	2.12	3.80	2.90	2.20	3.95	2.93	3	1	3	3	1	4	6	2	7	1	5	0	7	2	3	1	2	1	3	1	1	1	0.08	0.15	0.03
2137589	2024-09-29 20:00:00	10	3	2.13	3.35	3.20	2.16	3.40	3.40	3	3	4	4	5	3	7	8	7	6	5	6	13	2	1	2	1	3	1	1	1	1	0.03	0.05	0.20
2137591	2024-10-01 01:10:00	10	3	2.50	3.35	2.63	2.56	3.40	2.75	10	3	10	13	3	10	23	6	20	1	18	4	24	1	3	2	3	1	2	1	1	1	0.06	0.05	0.12
2137597	2024-10-06 20:00:00	10	0	1.97	3.60	3.40	1.96	3.65	3.40	3	0	2	1	1	3	4	1	5	2	5	1	6	2	3	1	2	1	3	-1	1	0	-0.01	0.05	0.00
2137536	2024-09-20 01:00:00	10	0	2.31	3.75	2.87	2.31	3.70	2.88	1	3	2	1	3	4	2	6	6	5	1	1	7	3	1	1	1	2	2	0	-1	1	0.00	-0.05	0.01
2137537	2024-08-10 21:00:00	10	0	7.80	5.20	1.31	8.60	5.70	1.32	2	1	2	4	2	3	6	3	5	0	3	1	6	1	3	2	3	1	2	1	1	1	0.80	0.50	0.01
2137538	2024-08-13 01:00:00	10	1	1.92	3.80	3.40	1.94	3.95	3.55	5	1	6	7	3	6	12	4	12	4	12	4	16	1	3	1	2	1	2	1	1	1	0.02	0.15	0.15
2137539	2024-08-10 21:00:00	10	3	2.34	3.55	2.69	2.39	3.65	2.78	11	4	11	12	5	11	23	9	22	4	18	5	27	1	3	2	3	1	2	1	1	1	0.05	0.10	0.09
2137540	2024-08-11 22:00:00	10	3	1.70	4.05	4.65	1.70	4.05	4.65	0	0	0	0	0	1	0	0	1	1	1	0	1	2	2	1	1	1	3	0	0	0	0.00	0.00	0.00
2137541	2024-08-18 20:00:00	10	0	2.63	3.90	2.26	2.60	3.95	2.26	5	1	0	1	3	0	6	4	0	0	2	6	6	1	2	3	3	2	1	-1	1	0	-0.03	0.05	0.00
2137542	2024-08-18 20:00:00	10	0	2.13	3.45	3.15	2.13	3.45	3.15	0	0	0	0	0	1	0	0	1	1	1	0	1	2	2	1	1	1	3	0	0	0	0.00	0.00	0.00
2137545	2024-08-17 21:00:00	10	3	1.30	5.30	7.80	1.33	5.50	8.60	3	1	3	4	1	5	7	2	8	1	6	0	8	2	3	1	2	1	3	1	1	1	0.03	0.20	0.80
2137554	2024-08-27 01:00:00	10	1	1.83	3.70	3.80	1.84	3.90	4.00	8	3	7	5	6	7	13	9	14	7	11	6	20	2	3	1	2	1	3	1	1	1	0.01	0.20	0.20
2137555	2024-08-27 01:00:00	10	0	2.46	3.40	2.64	2.57	3.50	2.65	2	2	4	5	2	3	7	4	7	1	4	1	8	1	3	1	2	1	2	1	1	1	0.11	0.10	0.01
2137558	2024-08-31 21:00:00	10	1	1.67	3.90	4.45	1.67	4.10	4.80	1	0	0	0	2	2	1	2	2	1	0	0	2	3	1	1	1	2	2	0	1	1	0.00	0.20	0.35
2137560	2024-09-01 20:00:00	10	3	1.57	4.00	5.20	1.58	4.20	5.60	0	1	0	1	2	1	1	3	1	2	0	2	3	2	1	2	1	3	1	1	1	1	0.01	0.20	0.40
2137562	2024-09-01 22:30:00	10	1	2.61	3.95	2.26	2.94	3.90	2.20	0	1	1	2	1	0	2	2	1	1	1	2	3	1	1	3	2	2	1	1	-1	-1	0.33	-0.05	-0.06
2137565	2024-09-15 20:00:00	10	1	3.15	3.45	2.13	3.45	3.45	2.12	0	0	1	2	0	0	2	0	1	1	3	2	3	1	3	2	3	1	2	1	0	-1	0.30	0.00	-0.01
2154272	2024-06-22 18:00:00	11	0	2.56	3.20	2.64	2.56	3.20	2.64	2	0	1	1	0	2	3	0	3	0	3	0	3	1	3	1	2	1	2	0	0	0	0.00	0.00	0.00
2154274	2024-07-14 18:00:00	11	1	4.05	3.35	1.88	4.00	3.40	1.87	1	2	2	1	4	0	2	6	2	5	1	5	7	2	1	2	1	3	1	-1	1	-1	-0.05	0.05	-0.01
2154020	2024-03-02 13:00:00	11	0	3.15	3.25	2.21	3.15	3.20	2.21	0	1	0	0	0	1	0	1	1	2	1	1	2	3	1	1	1	2	2	0	-1	0	0.00	-0.05	0.00
2154021	2024-04-13 15:00:00	11	0	3.30	3.45	2.04	3.35	3.45	2.03	1	0	1	1	0	2	2	0	3	1	3	0	3	2	3	1	2	1	3	1	0	-1	0.05	0.00	-0.01
2154277	2024-07-14 18:00:00	11	3	2.51	3.10	2.79	2.53	3.10	2.76	1	0	1	1	0	0	2	0	1	0	2	1	2	1	3	2	3	1	2	1	0	-1	0.02	0.00	-0.03
2154022	2024-03-30 17:00:00	11	1	3.45	3.25	2.07	3.45	3.25	2.07	1	0	0	0	0	1	1	0	1	0	1	0	1	1	3	1	2	1	2	0	0	0	0.00	0.00	0.00
2154279	2024-06-22 18:00:00	11	3	1.51	3.90	6.40	1.51	3.90	6.40	1	0	0	0	1	1	1	1	1	0	0	0	1	1	1	1	1	1	1	0	0	0	0.00	0.00	0.00
2154280	2024-08-03 18:00:00	11	3	3.10	3.40	2.17	2.99	3.35	2.23	6	3	1	3	2	4	9	5	5	1	5	5	10	1	2	2	3	1	1	-1	-1	1	-0.11	-0.05	0.06
1957652	2023-10-14 13:00:00	11	0	3.45	3.15	2.13	3.50	3.10	2.13	0	4	0	1	4	0	1	8	0	7	0	8	8	2	1	3	2	3	1	1	-1	0	0.05	-0.05	0.00
2154281	2024-06-29 17:00:00	11	0	3.25	3.30	2.12	3.25	3.30	2.12	0	2	0	0	1	1	0	3	1	3	0	2	3	3	1	2	1	3	2	0	0	0	0.00	0.00	0.00
2154028	2024-03-24 13:00:00	11	3	2.99	3.05	2.38	2.99	3.05	2.38	1	0	0	0	0	1	1	0	1	0	1	0	1	1	3	1	2	1	2	0	0	0	0.00	0.00	0.00
2154284	2024-07-06 18:00:00	11	3	2.21	3.30	3.10	2.26	3.25	3.00	0	1	1	1	1	0	1	2	1	1	0	1	2	2	1	2	1	3	1	1	-1	-1	0.05	-0.05	-0.10
1957648	2023-07-09 18:00:00	11	0	3.55	3.65	1.90	3.45	3.60	1.95	1	1	2	1	1	2	2	2	4	2	2	0	4	2	2	1	1	1	3	-1	-1	1	-0.10	-0.05	0.05
1957651	2023-07-15 18:00:00	11	1	2.71	3.15	2.55	2.36	3.15	2.95	3	0	1	2	0	3	5	0	4	0	5	1	5	1	3	2	3	1	2	-1	0	1	-0.35	0.00	0.40
2154030	2024-04-03 18:00:00	11	0	2.35	3.10	3.05	2.35	3.10	3.05	0	0	0	0	0	1	0	0	1	1	1	0	1	2	2	1	1	1	3	0	0	0	0.00	0.00	0.00
2154031	2024-03-20 14:50:00	11	0	2.57	3.20	2.63	2.51	3.25	2.69	5	0	0	0	1	5	5	1	5	0	4	0	5	1	3	1	2	1	2	-1	1	1	-0.06	0.05	0.06
2154287	2024-08-03 18:00:00	11	0	3.65	3.45	1.94	3.60	3.45	1.95	1	0	0	0	0	2	1	0	2	1	2	0	2	2	3	1	2	1	3	-1	0	1	-0.05	0.00	0.01
2154032	2024-03-24 13:00:00	11	0	3.25	3.25	2.14	3.25	3.25	2.14	1	0	0	0	0	1	1	0	1	0	1	0	1	1	3	1	2	1	2	0	0	0	0.00	0.00	0.00
2154288	2024-06-30 18:00:00	11	3	1.53	4.15	5.40	1.52	4.20	5.40	1	1	3	1	1	1	2	2	4	2	2	0	4	2	2	1	1	1	3	-1	1	0	-0.01	0.05	0.00
2154289	2024-06-29 18:00:00	11	1	3.00	3.40	2.21	3.10	3.40	2.17	1	0	2	2	0	1	3	0	3	0	3	0	3	1	3	1	2	1	2	1	0	-1	0.10	0.00	-0.04
2154290	2024-07-14 17:00:00	11	1	2.85	3.50	2.25	2.92	3.55	2.20	1	0	3	3	1	0	4	1	3	0	3	1	4	1	3	2	3	1	2	1	1	-1	0.07	0.05	-0.05
2154036	2024-03-10 13:00:00	11	3	3.65	3.65	1.88	3.65	3.70	1.87	1	0	2	2	1	1	3	1	3	0	2	0	3	1	3	1	2	1	2	0	1	-1	0.00	0.05	-0.01
2154292	2024-08-10 17:00:00	11	1	2.05	3.60	3.15	2.06	3.60	3.15	2	0	0	1	0	0	3	0	0	0	3	3	3	1	2	2	3	1	1	1	0	0	0.01	0.00	0.00
2154038	2024-03-24 13:00:00	11	1	2.70	3.35	2.44	2.70	3.35	2.44	1	0	0	0	0	1	1	0	1	0	1	0	1	1	3	1	2	1	2	0	0	0	0.00	0.00	0.00
2154294	2024-06-29 17:00:00	11	1	2.82	3.10	2.49	2.81	3.10	2.49	1	0	0	2	0	0	3	0	0	0	3	3	3	1	2	2	3	1	1	-1	0	0	-0.01	0.00	0.00
1957642	2023-07-09 17:00:00	11	1	2.33	2.99	3.15	2.28	3.05	3.20	1	0	2	1	2	2	2	2	4	2	2	0	4	2	2	1	1	1	3	-1	1	1	-0.05	0.06	0.05
2154039	2024-03-24 13:00:00	11	3	2.63	3.35	2.49	2.63	3.35	2.50	0	0	1	1	0	1	1	0	2	1	2	0	2	2	3	1	2	1	3	0	0	1	0.00	0.00	0.01
1957638	2023-07-05 18:00:00	11	0	2.03	3.30	3.55	2.03	3.30	3.55	0	0	0	0	1	0	0	1	0	1	0	1	1	2	1	2	1	3	1	0	0	0	0.00	0.00	0.00
2154044	2024-03-24 13:00:00	11	1	4.05	3.55	1.81	4.05	3.55	1.81	3	1	2	1	1	3	4	2	5	1	3	0	5	2	3	1	2	1	3	0	0	0	0.00	0.00	0.00
2154302	2024-11-10 13:00:00	11	3	2.70	3.55	2.33	2.71	3.55	2.33	0	1	0	1	0	1	1	1	1	1	1	1	2	1	1	1	1	1	1	1	0	0	0.01	0.00	0.00
2153984	2024-04-14 13:00:00	11	1	3.10	3.00	2.35	3.05	3.05	2.36	1	0	0	0	2	1	1	2	1	2	1	2	3	2	1	2	1	3	1	-1	1	1	-0.05	0.05	0.01
2154240	2024-06-29 17:00:00	11	3	2.07	3.50	3.25	2.12	3.45	3.15	2	2	3	4	2	2	6	4	5	1	3	2	7	1	3	2	3	1	2	1	-1	-1	0.05	-0.05	-0.10
2153986	2024-03-30 15:00:00	11	3	2.41	3.35	2.74	2.36	3.35	2.81	5	0	3	3	0	4	8	0	7	0	8	1	8	1	3	2	3	1	2	-1	0	1	-0.05	0.00	0.07
2153987	2024-03-24 13:00:00	11	1	1.83	3.40	4.15	1.81	3.45	4.25	1	0	1	1	1	1	2	1	2	0	1	0	2	1	3	1	2	1	2	-1	1	1	-0.02	0.05	0.10
2154243	2024-06-30 17:00:00	11	3	1.97	3.40	3.60	1.99	3.40	3.55	2	0	2	2	0	1	4	0	3	0	4	1	4	1	3	2	3	1	2	1	0	-1	0.02	0.00	-0.05
2154248	2024-08-31 18:00:00	11	3	2.44	3.30	2.73	2.44	3.30	2.73	0	0	1	0	0	0	0	0	1	1	1	0	1	2	2	1	1	1	3	0	0	0	0.00	0.00	0.00
2154249	2024-08-25 18:00:00	11	3	2.08	3.40	3.30	2.09	3.40	3.25	1	0	1	1	1	0	2	1	1	0	1	1	2	1	2	2	3	1	1	1	0	-1	0.01	0.00	-0.05
2154762	2024-03-20 13:00:00	11	1	2.03	3.50	3.35	1.99	3.50	3.45	8	3	4	5	4	6	13	7	10	2	8	5	15	1	3	2	3	1	2	-1	0	1	-0.04	0.00	0.10
2154251	2024-07-14 18:00:00	11	0	4.25	3.65	1.75	4.15	3.65	1.77	2	1	0	0	0	2	2	1	2	0	1	0	2	1	3	1	2	1	2	-1	0	1	-0.10	0.00	0.02
1957681	2023-07-29 18:00:00	11	3	2.55	3.35	2.55	2.52	3.35	2.59	2	0	1	1	0	2	3	0	3	0	3	0	3	1	3	1	2	1	2	-1	0	1	-0.03	0.00	0.04
2154764	2024-05-12 15:00:00	11	1	2.80	3.40	2.33	2.80	3.40	2.33	1	0	0	0	0	1	1	0	1	0	1	0	1	1	3	1	2	1	2	0	0	0	0.00	0.00	0.00
1957680	2023-07-29 18:00:00	11	1	2.16	3.80	2.82	2.20	3.80	2.75	0	1	3	2	1	0	2	2	3	1	1	0	3	2	2	1	1	1	3	1	0	-1	0.04	0.00	-0.07
2153998	2024-03-24 13:00:00	11	1	2.23	3.35	3.00	2.23	3.30	3.00	6	1	5	5	0	5	11	1	10	0	10	1	11	1	3	2	3	1	2	0	-1	0	0.00	-0.05	0.00
1957677	2023-07-29 17:00:00	11	1	1.87	3.50	3.85	1.87	3.50	3.85	2	0	1	2	1	1	4	1	2	0	3	2	4	1	3	2	3	1	2	0	0	0	0.00	0.00	0.00
2154000	2024-03-09 13:00:00	11	3	2.31	3.25	2.95	2.31	3.25	2.95	0	0	1	1	0	0	1	0	1	0	1	0	1	1	3	1	2	1	2	0	0	0	0.00	0.00	0.00
2154002	2024-04-20 13:00:00	11	3	1.84	3.50	3.95	1.87	3.50	3.85	0	1	3	4	0	0	4	1	3	0	3	1	4	1	3	2	3	1	2	1	0	-1	0.03	0.00	-0.10
2154260	2024-06-29 18:00:00	11	0	2.89	3.15	2.40	2.77	3.15	2.49	3	0	0	1	0	1	4	0	1	0	4	3	4	1	3	2	3	1	2	-1	0	1	-0.12	0.00	0.09
2154261	2024-06-22 18:00:00	11	3	2.47	3.20	2.77	2.44	3.20	2.80	2	0	0	0	0	2	2	0	2	0	2	0	2	1	3	1	2	1	2	-1	0	1	-0.03	0.00	0.03
2154262	2024-06-22 18:00:00	11	3	4.60	3.65	1.70	4.60	3.65	1.70	0	0	1	1	0	0	1	0	1	0	1	0	1	1	3	1	2	1	2	0	0	0	0.00	0.00	0.00
2154263	2024-07-14 17:00:00	11	3	2.51	2.95	2.92	2.54	2.92	2.91	2	6	3	4	2	4	6	8	7	4	2	3	10	3	1	2	1	3	2	1	-1	-1	0.03	-0.03	-0.01
1957669	2023-07-23 18:00:00	11	1	5.50	3.95	1.54	5.50	3.95	1.54	1	1	0	0	0	1	1	1	1	0	0	0	1	1	1	1	1	1	1	0	0	0	0.00	0.00	0.00
2154264	2024-08-03 18:00:00	11	0	1.56	4.00	5.30	1.56	4.00	5.30	1	0	0	0	1	1	1	1	1	0	0	0	1	1	1	1	1	1	1	0	0	0	0.00	0.00	0.00
2154265	2024-07-07 18:00:00	11	0	2.20	3.25	3.15	2.21	3.25	3.15	2	2	1	1	1	2	3	3	3	1	1	1	4	1	1	1	1	1	1	1	0	0	0.01	0.00	0.00
2154266	2024-07-14 17:00:00	11	1	4.75	3.65	1.68	4.80	3.65	1.68	1	0	0	1	0	0	2	0	0	0	2	2	2	1	2	2	3	1	1	1	0	0	0.05	0.00	0.00
2154011	2024-04-07 14:00:00	11	1	3.40	3.25	2.09	3.40	3.25	2.09	1	0	0	0	0	1	1	0	1	0	1	0	1	1	3	1	2	1	2	0	0	0	0.00	0.00	0.00
1957665	2023-07-22 18:00:00	11	0	2.09	3.35	3.30	2.09	3.35	3.30	0	0	1	1	0	0	1	0	1	0	1	0	1	1	3	1	2	1	2	0	0	0	0.00	0.00	0.00
2154015	2024-03-10 16:00:00	11	0	4.30	3.40	1.80	4.45	3.45	1.77	1	0	1	1	1	0	2	1	1	0	1	1	2	1	2	2	3	1	1	1	1	-1	0.15	0.05	-0.03
2154271	2024-06-29 18:00:00	11	3	1.73	3.50	4.60	1.73	3.50	4.60	1	0	0	0	0	1	1	0	1	0	1	0	1	1	3	1	2	1	2	0	0	0	0.00	0.00	0.00
1957725	2023-08-27 17:00:00	11	1	4.25	3.40	1.81	4.25	3.45	1.81	0	1	0	0	1	0	0	2	0	2	0	2	2	2	1	2	1	3	1	0	1	0	0.00	0.05	0.00
2154080	2024-06-16 17:00:00	11	0	1.99	3.25	3.70	2.01	3.25	3.65	1	0	2	2	0	2	3	0	4	1	4	0	4	2	3	1	2	1	3	1	0	-1	0.02	0.00	-0.05
2335073	2024-12-07 12:05:00	11	3	2.23	3.20	3.10	2.23	3.20	3.10	0	0	2	1	0	1	1	0	3	2	3	0	3	2	3	1	2	1	3	0	0	0	0.00	0.00	0.00
2154084	2024-06-09 18:00:00	11	1	1.85	3.55	3.90	1.85	3.55	3.90	0	0	0	1	0	0	1	0	0	0	1	1	1	1	2	2	3	1	1	0	0	0	0.00	0.00	0.00
2154085	2024-04-27 13:00:00	11	0	2.90	3.20	2.36	2.90	3.20	2.36	1	0	0	0	0	1	1	0	1	0	1	0	1	1	3	1	2	1	2	0	0	0	0.00	0.00	0.00
2154090	2024-06-16 16:00:00	11	3	2.56	2.93	2.87	2.56	2.92	2.88	1	3	1	2	1	3	3	4	4	1	0	0	4	3	1	1	1	2	2	0	-1	1	0.00	-0.01	0.01
2154347	2024-09-22 13:00:00	11	3	1.49	4.25	5.70	1.49	4.25	5.70	0	0	2	0	0	1	0	0	3	3	3	0	3	2	2	1	1	1	3	0	0	0	0.00	0.00	0.00
2154099	2024-06-16 17:00:00	11	3	5.70	4.10	1.52	5.70	4.10	1.52	0	1	0	0	2	0	0	3	0	3	0	3	3	2	1	2	1	3	1	0	0	0	0.00	0.00	0.00
2154100	2024-06-09 13:00:00	11	1	2.25	3.25	3.05	2.25	3.35	2.97	0	0	3	1	2	1	1	2	4	3	2	0	4	3	2	1	1	2	3	0	1	-1	0.00	0.10	-0.08
2154101	2024-05-26 13:00:00	11	1	1.75	3.40	4.65	1.75	3.40	4.65	0	0	1	1	0	0	1	0	1	0	1	0	1	1	3	1	2	1	2	0	0	0	0.00	0.00	0.00
2154103	2024-06-01 17:00:00	11	3	1.35	4.70	8.20	1.35	4.65	8.10	0	1	2	1	0	0	1	1	2	1	1	0	2	2	2	1	1	1	3	0	-1	-1	0.00	-0.05	-0.10
2154361	2024-11-03 13:00:00	11	0	2.05	3.75	3.10	2.06	3.75	3.05	1	0	1	1	1	1	2	1	2	0	1	0	2	1	3	1	2	1	2	1	0	-1	0.01	0.00	-0.05
2154106	2024-06-02 13:00:00	11	3	3.75	3.20	1.99	3.65	3.20	2.02	4	1	3	2	1	6	6	2	9	3	7	0	9	2	3	1	2	1	3	-1	0	1	-0.10	0.00	0.03
2154365	2024-10-27 13:00:00	11	0	1.89	3.45	3.85	1.90	3.35	3.90	0	2	2	2	0	2	2	2	4	2	2	0	4	2	2	1	1	1	3	1	-1	1	0.01	-0.10	0.05
2154367	2024-09-29 13:00:00	11	3	2.63	2.88	2.83	2.55	2.91	2.90	5	3	2	2	4	5	7	7	7	1	1	1	8	1	1	1	1	1	1	-1	1	1	-0.08	0.03	0.07
2154050	2024-04-07 13:00:00	11	1	1.93	3.45	3.70	1.93	3.45	3.70	1	0	1	2	0	1	3	0	2	1	4	2	4	1	3	2	3	1	2	0	0	0	0.00	0.00	0.00
2154051	2024-03-10 14:00:00	11	0	2.61	3.20	2.59	2.64	3.20	2.56	0	0	2	2	0	0	2	0	2	0	2	0	2	1	3	1	2	1	2	1	0	-1	0.03	0.00	-0.03
2154054	2024-03-24 16:00:00	11	0	4.40	3.45	1.78	4.45	3.50	1.76	4	1	7	6	2	4	10	3	11	1	8	0	11	2	3	1	2	1	3	1	1	-1	0.05	0.05	-0.02
2154057	2024-03-24 13:00:00	11	1	2.28	3.25	2.99	2.28	3.25	2.98	0	0	2	1	0	0	1	0	2	1	2	0	2	2	3	1	2	1	3	0	0	-1	0.00	0.00	-0.01
2154062	2024-03-20 13:00:00	11	0	2.66	3.35	2.45	2.59	3.35	2.52	7	2	7	7	2	6	14	4	13	0	10	1	14	1	3	2	3	1	2	-1	0	1	-0.07	0.00	0.07
2154064	2024-03-16 14:00:00	11	3	3.75	3.65	1.86	3.80	3.65	1.84	2	2	3	3	2	1	5	4	4	4	5	5	9	1	2	2	3	1	1	1	0	-1	0.05	0.00	-0.02
1957743	2023-09-09 18:00:00	11	3	1.88	3.55	3.75	1.84	3.60	3.90	2	0	1	1	1	2	3	1	3	0	2	0	3	1	3	1	2	1	2	-1	1	1	-0.04	0.05	0.15
1957742	2023-09-09 18:00:00	11	3	2.20	3.45	2.99	2.20	3.45	2.99	0	0	1	1	0	0	1	0	1	0	1	0	1	1	3	1	2	1	2	0	0	0	0.00	0.00	0.00
2154070	2024-04-21 13:00:00	11	0	1.90	3.20	4.15	1.87	3.20	4.25	2	0	1	1	0	2	3	0	3	0	3	0	3	1	3	1	2	1	2	-1	0	1	-0.03	0.00	0.10
2154079	2024-06-16 15:00:00	11	1	2.20	3.30	3.10	2.20	3.35	3.05	0	0	2	1	1	0	1	1	2	1	1	0	2	2	2	1	1	1	3	0	1	-1	0.00	0.05	-0.05
1957789	2023-10-08 18:00:00	11	1	3.20	3.25	2.17	3.20	3.25	2.17	0	0	1	0	0	0	0	0	1	1	1	0	1	2	2	1	1	1	3	0	0	0	0.00	0.00	0.00
2154152	2024-05-03 13:00:00	11	3	1.80	3.45	4.30	1.82	3.40	4.20	0	1	3	3	0	0	3	1	3	0	2	0	3	1	3	1	2	1	2	1	-1	-1	0.02	-0.05	-0.10
2154153	2024-06-02 12:00:00	11	0	2.20	3.20	3.20	2.21	3.30	3.10	0	5	6	1	5	6	1	10	12	17	8	6	18	3	2	1	1	2	3	1	1	-1	0.01	0.10	-0.10
1957783	2023-10-07 13:00:00	11	3	2.19	3.55	2.82	2.09	3.42	2.86	4	1	2	1	1	2	5	2	4	0	3	1	5	1	3	2	3	1	2	-1	-1	1	-0.10	-0.13	0.04
2154155	2024-06-08 17:00:00	11	3	3.10	3.40	2.16	3.30	3.50	2.04	2	0	5	5	3	1	7	3	6	1	5	2	8	1	3	2	3	1	2	1	1	-1	0.20	0.10	-0.12
2154157	2024-06-08 17:00:00	11	3	1.43	4.45	6.40	1.44	4.35	6.20	0	3	2	2	0	0	2	3	2	1	0	1	3	2	1	2	1	3	1	1	-1	-1	0.01	-0.10	-0.20
2154161	2024-06-08 14:00:00	11	1	2.36	3.15	2.94	2.36	3.15	2.96	0	0	1	1	0	1	1	0	2	1	2	0	2	2	3	1	2	1	3	0	0	1	0.00	0.00	0.02
2154167	2024-06-15 17:00:00	11	0	4.50	3.50	1.75	4.55	3.50	1.74	1	1	1	3	1	1	4	2	2	0	2	2	4	1	2	2	3	1	1	1	0	-1	0.05	0.00	-0.01
2154170	2024-05-03 13:00:00	11	0	2.06	3.35	3.40	2.11	3.35	3.25	0	0	3	4	0	0	4	0	3	0	4	1	4	1	3	2	3	1	2	1	0	-1	0.05	0.00	-0.15
2154174	2024-06-22 18:00:00	11	3	1.57	4.20	4.85	1.55	4.25	5.00	2	1	1	0	2	2	2	3	3	2	1	1	4	3	1	1	1	2	2	-1	1	1	-0.02	0.05	0.15
2154368	2024-11-10 13:00:00	11	3	1.61	3.75	5.10	1.61	3.75	5.20	0	0	1	0	0	1	0	0	2	2	2	0	2	2	2	1	1	1	3	0	0	1	0.00	0.00	0.10
2154113	2024-06-02 13:00:00	11	0	3.00	3.20	2.31	3.00	3.20	2.31	1	0	0	0	0	1	1	0	1	0	1	0	1	1	3	1	2	1	2	0	0	0	0.00	0.00	0.00
2154114	2024-04-27 13:55:00	11	3	2.88	3.40	2.28	2.89	3.40	2.28	1	0	0	1	0	1	2	0	1	0	2	1	2	1	3	2	3	1	2	1	0	0	0.01	0.00	0.00
2154370	2024-10-20 13:00:00	11	3	2.00	3.40	3.50	2.01	3.40	3.50	1	0	0	1	0	0	2	0	0	0	2	2	2	1	2	2	3	1	1	1	0	0	0.01	0.00	0.00
2154373	2024-10-05 13:00:00	11	3	3.00	3.40	2.21	3.00	3.40	2.21	1	0	0	0	0	1	1	0	1	0	1	0	1	1	3	1	2	1	2	0	0	0	0.00	0.00	0.00
2154119	2024-06-08 17:00:00	11	0	3.60	3.20	2.04	3.55	3.20	2.07	2	0	1	1	0	4	3	0	5	2	5	0	5	2	3	1	2	1	3	-1	0	1	-0.05	0.00	0.03
2154120	2024-06-08 18:00:00	11	1	2.44	3.00	2.95	2.44	3.00	2.95	0	1	0	0	0	1	0	1	1	1	0	0	1	3	1	1	1	2	2	0	0	0	0.00	0.00	0.00
2142603	2024-02-24 13:00:00	11	3	2.48	3.35	2.64	2.48	3.35	2.64	2	0	1	1	0	2	3	0	3	0	3	0	3	1	3	1	2	1	2	0	0	0	0.00	0.00	0.00
1957809	2023-11-05 13:00:00	11	3	1.59	3.60	5.80	1.53	3.70	6.40	4	1	1	1	3	4	5	4	5	0	1	0	5	1	3	1	2	1	2	-1	1	1	-0.06	0.10	0.60
2142604	2024-02-25 13:00:00	11	1	2.01	3.45	3.45	2.01	3.45	3.45	0	0	0	1	0	0	1	0	0	0	1	1	1	1	2	2	3	1	1	0	0	0	0.00	0.00	0.00
2154127	2024-06-16 17:00:00	11	1	2.82	3.15	2.45	2.82	3.15	2.45	0	0	1	1	0	0	1	0	1	0	1	0	1	1	3	1	2	1	2	0	0	0	0.00	0.00	0.00
2154130	2024-05-06 18:00:00	11	3	2.36	3.20	2.90	2.36	3.20	2.92	0	0	1	0	0	1	0	0	2	2	2	0	2	2	2	1	1	1	3	0	0	1	0.00	0.00	0.02
2154133	2024-06-26 18:00:00	11	3	2.09	3.45	3.20	2.07	3.45	3.25	1	0	2	2	0	1	3	0	3	0	3	0	3	1	3	1	2	1	2	-1	0	1	-0.02	0.00	0.05
2154136	2024-06-16 17:30:00	11	0	3.75	3.10	2.04	3.75	3.10	2.04	0	0	0	0	0	1	0	0	1	1	1	0	1	2	2	1	1	1	3	0	0	0	0.00	0.00	0.00
2154143	2024-06-16 18:00:00	11	3	1.78	3.45	4.35	1.77	3.45	4.40	1	1	1	0	1	1	1	2	2	2	1	1	3	3	1	1	1	2	2	-1	0	1	-0.01	0.00	0.05
1957597	2023-06-17 18:00:00	11	3	2.57	3.10	2.71	2.51	3.10	2.78	3	0	1	1	0	3	4	0	4	0	4	0	4	1	3	1	2	1	2	-1	0	1	-0.06	0.00	0.07
2154208	2024-09-07 17:30:00	11	1	1.82	3.75	3.80	1.72	3.85	4.15	7	1	1	1	3	6	8	4	7	1	5	2	9	1	3	2	3	1	2	-1	1	1	-0.10	0.10	0.35
2154211	2024-08-10 18:00:00	11	1	2.51	3.40	2.59	2.49	3.40	2.62	3	0	3	3	0	3	6	0	6	0	6	0	6	1	3	1	2	1	2	-1	0	1	-0.02	0.00	0.03
2154212	2024-07-06 17:00:00	11	3	1.79	3.35	4.50	1.74	3.40	4.70	2	0	2	1	1	2	3	1	4	1	3	0	4	2	3	1	2	1	3	-1	1	1	-0.05	0.05	0.20
2327270	2024-12-01 12:05:00	11	0	2.21	3.45	2.95	2.21	3.45	2.95	0	0	1	1	0	0	1	0	1	0	1	0	1	1	3	1	2	1	2	0	0	0	0.00	0.00	0.00
2327269	2024-12-01 13:00:00	11	0	2.40	3.30	2.79	2.29	3.30	2.93	6	1	3	3	1	6	9	2	9	0	7	0	9	1	3	1	2	1	2	-1	0	1	-0.11	0.00	0.14
1957594	2023-06-11 18:00:00	11	0	3.75	3.45	1.91	3.55	3.55	1.93	1	1	2	2	1	1	3	2	3	0	1	0	3	1	3	1	2	1	2	-1	1	1	-0.20	0.10	0.02
2154215	2024-06-23 13:00:00	11	3	3.70	3.30	1.97	3.70	3.35	1.96	2	1	1	1	1	2	3	2	3	0	1	0	3	1	3	1	2	1	2	0	1	-1	0.00	0.05	-0.01
2154216	2024-08-10 17:00:00	11	0	2.89	3.20	2.38	2.89	3.20	2.38	1	0	0	0	0	0	1	0	0	0	1	1	1	1	2	2	3	1	1	0	0	0	0.00	0.00	0.00
1957588	2023-06-11 15:00:00	11	3	1.84	3.50	4.00	1.81	3.45	4.20	2	1	0	0	1	2	2	2	2	0	0	0	2	1	1	1	1	1	1	-1	-1	1	-0.03	-0.05	0.20
1957591	2023-06-11 17:00:00	11	0	3.10	3.20	2.27	3.10	3.20	2.27	1	0	1	0	1	0	1	1	1	0	0	0	1	1	1	1	1	1	1	0	0	0	0.00	0.00	0.00
1957590	2023-06-11 15:00:00	11	3	2.60	2.83	2.92	2.60	2.83	2.92	0	1	0	1	0	0	1	1	0	0	0	1	1	1	1	3	2	2	1	0	0	0	0.00	0.00	0.00
1957587	2023-06-11 13:00:00	11	3	1.99	3.50	3.40	1.99	3.50	3.40	1	0	0	0	0	1	1	0	1	0	1	0	1	1	3	1	2	1	2	0	0	0	0.00	0.00	0.00
2154222	2024-08-03 17:00:00	11	3	1.95	3.50	3.55	1.91	3.50	3.70	3	0	1	1	0	3	4	0	4	0	4	0	4	1	3	1	2	1	2	-1	0	1	-0.04	0.00	0.15
1957586	2023-06-11 13:00:00	11	3	2.05	3.15	3.65	2.01	3.15	3.75	1	0	1	1	0	1	2	0	2	0	2	0	2	1	3	1	2	1	2	-1	0	1	-0.04	0.00	0.10
2154228	2024-06-22 16:00:00	11	1	2.41	3.25	2.80	2.42	3.20	2.81	0	1	1	2	0	1	2	1	2	1	2	1	3	1	3	1	2	1	2	1	-1	1	0.01	-0.05	0.01
2153974	2024-03-16 13:00:00	11	0	2.63	3.10	2.63	2.78	3.10	2.50	5	0	8	8	0	5	13	0	13	0	13	0	13	1	3	1	2	1	2	1	0	-1	0.15	0.00	-0.13
2153975	2024-03-03 13:00:00	11	0	3.30	3.10	2.19	3.30	3.10	2.19	1	0	0	0	0	1	1	0	1	0	1	0	1	1	3	1	2	1	2	0	0	0	0.00	0.00	0.00
2154231	2024-08-03 18:00:00	11	0	3.55	3.50	1.96	3.50	3.45	1.97	1	1	2	1	1	1	2	2	3	1	1	0	3	2	2	1	1	1	3	-1	-1	1	-0.05	-0.05	0.01
2154232	2024-06-22 17:00:00	11	3	1.61	3.80	5.20	1.60	3.80	5.10	1	0	1	1	0	0	2	0	1	0	2	1	2	1	3	2	3	1	2	-1	0	-1	-0.01	0.00	-0.10
2153980	2024-03-20 14:00:00	11	0	2.98	3.40	2.21	2.95	3.40	2.23	1	2	0	1	1	1	2	3	1	2	1	3	4	2	1	3	2	3	1	-1	0	1	-0.03	0.00	0.02
2153981	2024-03-24 13:00:00	11	3	1.66	3.60	4.95	1.65	3.65	4.95	2	1	3	2	2	2	4	3	5	4	5	3	8	2	3	1	2	1	3	-1	1	0	-0.01	0.05	0.00
2154238	2024-08-03 18:00:00	11	3	2.07	3.20	3.55	2.05	3.20	3.60	3	0	0	0	0	2	3	0	2	0	3	1	3	1	3	2	3	1	2	-1	0	1	-0.02	0.00	0.05
2154176	2024-06-08 17:00:00	11	1	2.47	3.30	2.69	2.41	3.35	2.71	7	1	5	2	3	5	9	4	10	2	7	1	11	2	3	1	2	1	3	-1	1	1	-0.06	0.05	0.02
2154178	2024-05-03 15:00:00	11	3	2.98	3.35	2.25	3.00	3.30	2.26	2	1	0	1	1	1	3	2	1	0	1	2	3	1	2	3	3	2	1	1	-1	1	0.02	-0.05	0.01
2154180	2024-09-08 17:00:00	11	0	2.00	3.20	3.70	2.03	3.10	3.80	2	3	2	2	1	4	4	4	6	4	4	2	8	2	2	1	1	1	3	1	-1	1	0.03	-0.10	0.10
2154182	2024-08-10 17:30:00	11	3	1.39	4.40	7.60	1.37	4.50	7.90	3	1	1	0	2	5	3	3	6	3	3	0	6	2	2	1	1	1	3	-1	1	1	-0.02	0.10	0.30
2154183	2024-06-29 18:00:00	11	1	2.95	3.30	2.28	2.97	3.35	2.26	3	1	1	2	2	1	5	3	2	0	2	3	5	1	2	3	3	2	1	1	1	-1	0.02	0.05	-0.02
2154185	2024-06-30 12:00:00	11	0	2.42	3.05	2.95	2.56	2.99	2.82	3	19	15	4	16	16	7	35	31	29	1	5	36	3	1	2	1	3	2	1	-1	-1	0.14	-0.06	-0.13
2154187	2024-06-01 13:00:00	11	0	2.44	3.15	2.85	2.44	3.10	2.86	0	1	1	1	0	1	1	1	2	1	1	0	2	2	2	1	1	1	3	0	-1	1	0.00	-0.05	0.01
2154194	2024-06-23 18:00:00	11	3	2.42	3.05	2.94	2.42	3.10	2.92	0	0	1	0	1	1	0	1	2	2	1	0	2	3	2	1	1	2	3	0	1	-1	0.00	0.05	-0.02
2154195	2024-07-13 18:00:00	11	1	1.87	3.35	4.05	1.86	3.35	4.15	9	3	8	9	3	10	18	6	18	6	18	6	24	1	3	1	2	1	2	-1	0	1	-0.01	0.00	0.10
2154197	2024-08-24 17:00:00	11	3	1.68	3.55	4.90	1.65	3.60	5.10	3	0	0	0	1	3	3	1	3	0	2	0	3	1	3	1	2	1	2	-1	1	1	-0.03	0.05	0.20
2154202	2024-09-18 18:00:00	11	0	3.75	3.55	1.89	4.05	3.70	1.78	3	1	5	6	5	0	9	6	5	0	3	4	9	1	2	3	3	2	1	1	1	-1	0.30	0.15	-0.11
2154203	2024-07-06 17:00:00	11	0	2.31	3.30	2.91	2.31	3.30	2.92	0	7	12	0	5	16	0	12	28	28	16	0	28	3	2	1	1	2	3	0	0	1	0.00	0.00	0.01
1957600	2023-06-17 18:00:00	11	3	2.14	3.35	3.20	2.08	3.35	3.30	3	2	2	1	1	3	4	3	5	2	3	1	6	2	3	1	2	1	3	-1	0	1	-0.06	0.00	0.10
2154207	2024-08-31 18:00:00	11	0	3.50	3.45	1.99	3.50	3.45	1.98	1	0	2	1	1	1	2	1	3	1	2	0	3	2	3	1	2	1	3	0	0	-1	0.00	0.00	-0.01
1944085	2023-07-13 10:30:00	12	3	2.64	3.45	2.64	2.63	3.45	2.63	2	0	1	1	0	1	3	0	2	0	3	1	3	1	3	2	3	1	2	-1	0	-1	-0.01	0.00	-0.01
1944084	2023-07-13 08:30:00	12	0	2.02	3.70	3.50	1.92	3.85	3.75	10	2	11	11	6	11	21	8	22	3	16	2	24	2	3	1	2	1	3	-1	1	1	-0.10	0.15	0.25
1944081	2023-07-06 07:30:00	12	1	1.94	3.70	3.80	1.97	3.60	3.75	3	3	1	3	2	4	6	5	5	2	3	3	8	1	2	2	3	1	1	1	-1	-1	0.03	-0.10	-0.05
1944080	2023-07-02 07:30:00	12	1	2.06	3.75	3.35	1.98	3.85	3.50	5	4	5	2	6	8	7	10	13	9	6	3	16	3	2	1	1	2	3	-1	1	1	-0.08	0.10	0.15
1944083	2023-07-13 07:30:00	12	0	2.03	3.50	3.70	1.99	3.55	3.75	6	2	6	7	4	6	13	6	12	2	9	3	15	1	3	2	3	1	2	-1	1	1	-0.04	0.05	0.05
2139182	2024-02-25 05:45:00	12	3	1.71	3.75	5.10	1.74	3.75	4.80	0	2	4	1	3	2	1	5	6	8	4	3	9	3	2	1	1	2	3	1	0	-1	0.03	0.00	-0.30
1944082	2023-07-13 07:30:00	12	3	1.98	3.80	3.55	2.07	3.75	3.35	12	4	9	11	3	12	23	7	21	3	19	5	26	1	3	2	3	1	2	1	-1	-1	0.09	-0.05	-0.20
1944077	2023-06-22 08:30:00	12	3	1.79	3.95	4.20	1.70	4.00	4.75	3	1	2	0	3	5	3	4	7	4	3	0	7	3	2	1	1	2	3	-1	1	1	-0.09	0.05	0.55
1944076	2023-09-10 08:30:00	12	1	1.89	3.85	3.80	1.90	4.00	3.65	6	0	7	5	3	6	11	3	13	5	13	3	16	2	3	1	2	1	3	1	1	-1	0.01	0.15	-0.15
1944079	2023-07-02 10:30:00	12	3	1.90	3.60	4.10	1.96	3.50	3.95	1	2	5	4	0	3	5	2	8	3	6	0	8	2	3	1	2	1	3	1	-1	-1	0.06	-0.10	-0.15
1944078	2023-06-25 07:30:00	12	3	2.00	3.45	3.80	2.01	3.60	3.65	1	0	3	1	2	2	2	2	5	3	3	0	5	2	2	1	1	1	3	1	1	-1	0.01	0.15	-0.15
1944073	2023-06-11 10:30:00	12	1	1.97	3.65	3.35	2.06	3.50	3.60	8	10	12	11	6	13	19	16	25	15	18	9	34	2	3	1	2	1	3	1	-1	1	0.09	-0.15	0.25
2139188	2024-02-25 09:30:00	12	3	2.12	3.40	3.50	2.12	3.40	3.50	0	1	1	1	0	0	1	1	1	0	0	0	1	1	1	1	1	1	1	0	0	0	0.00	0.00	0.00
1944072	2023-06-11 07:30:00	12	1	2.40	3.30	2.76	2.52	3.30	2.86	4	1	6	6	1	5	10	2	11	1	9	0	11	2	3	1	2	1	3	1	0	1	0.12	0.00	0.10
2139189	2024-02-25 09:30:00	12	1	2.05	3.50	3.65	2.14	3.40	3.45	1	7	9	6	4	8	7	11	17	13	9	3	20	3	2	1	1	2	3	1	-1	-1	0.09	-0.10	-0.20
1944075	2023-06-22 07:30:00	12	1	1.89	3.80	3.85	1.95	3.70	3.75	4	4	6	9	3	5	13	7	11	2	8	4	15	1	3	2	3	1	2	1	-1	-1	0.06	-0.10	-0.10
1944074	2023-06-22 07:30:00	12	1	1.74	3.55	5.10	1.73	3.55	5.20	2	1	0	0	2	2	2	3	2	2	1	2	4	2	1	2	1	3	1	-1	0	1	-0.01	0.00	0.10
2139193	2024-02-26 06:00:00	12	1	2.42	3.15	3.10	2.49	2.99	3.20	0	3	2	1	0	6	1	3	8	9	7	2	10	3	2	1	1	2	3	1	-1	1	0.07	-0.16	0.10
1944070	2023-06-04 03:30:00	12	1	1.96	3.55	3.85	2.16	3.40	3.40	2	4	6	8	2	3	10	6	9	1	5	2	11	1	3	2	3	1	2	1	-1	-1	0.20	-0.15	-0.45
1944067	2023-06-01 07:00:00	12	1	1.89	3.55	3.70	1.93	3.80	3.70	3	2	7	5	2	5	8	4	12	7	11	3	15	2	3	1	2	1	3	1	1	0	0.04	0.25	0.00
1944066	2023-06-01 07:30:00	12	0	2.20	3.35	3.35	2.20	3.35	3.40	0	1	0	0	2	2	0	3	2	4	1	2	4	3	1	2	1	3	2	0	0	1	0.00	0.00	0.05
2112000	2023-10-15 08:30:00	12	1	1.40	4.80	8.10	1.41	4.75	7.90	5	7	10	7	5	6	12	12	16	4	4	0	16	2	2	1	1	1	3	1	-1	-1	0.01	-0.05	-0.20
2139656	2024-04-15 02:30:00	12	1	2.16	3.60	2.95	2.25	3.65	3.05	0	1	3	3	1	2	3	2	5	2	3	0	5	2	3	1	2	1	3	1	1	1	0.09	0.05	0.10
2139659	2024-04-21 07:30:00	12	1	1.63	4.15	5.10	1.60	4.20	5.30	4	2	2	3	4	5	7	6	7	3	4	3	10	1	3	1	2	1	2	-1	1	1	-0.03	0.05	0.20
2139237	2024-03-24 02:00:00	12	1	1.91	3.75	3.45	1.99	3.80	3.55	8	1	7	9	1	7	17	2	14	2	17	5	19	1	3	2	3	1	2	1	1	1	0.08	0.05	0.10
2139238	2024-03-24 07:30:00	12	0	1.85	3.85	4.00	1.89	3.85	3.85	11	7	13	13	8	12	24	15	25	4	13	3	28	2	3	1	2	1	3	1	0	-1	0.04	0.00	-0.15
2139239	2024-03-24 07:30:00	12	3	2.97	3.45	2.37	2.87	3.45	2.44	9	5	6	9	6	6	18	11	12	2	9	8	20	1	3	2	3	1	2	-1	0	1	-0.10	0.00	0.07
2139241	2024-03-24 07:30:00	12	3	1.56	4.35	5.90	1.67	4.10	5.00	1	7	7	8	3	3	9	10	10	3	2	2	12	3	1	1	1	2	2	1	-1	-1	0.11	-0.25	-0.90
2334314	2024-12-08 05:00:00	12	3	1.91	3.50	3.70	1.81	3.90	4.15	10	4	7	8	7	10	18	11	17	1	8	2	19	1	3	2	3	1	2	-1	1	1	-0.10	0.40	0.45
2139242	2024-03-24 07:30:00	12	3	1.87	3.60	4.20	1.88	3.45	4.35	16	7	13	15	5	19	31	12	32	7	26	6	38	2	3	1	2	1	3	1	-1	1	0.01	-0.15	0.15
2139243	2024-03-24 07:30:00	12	3	2.26	3.70	2.97	2.28	3.60	3.00	1	3	1	1	2	6	2	5	7	7	4	2	9	3	2	1	1	2	3	1	-1	1	0.02	-0.10	0.03
2139244	2024-03-24 08:30:00	12	0	2.01	3.90	3.35	2.14	3.65	3.25	11	9	14	19	4	10	30	13	24	5	22	11	35	1	3	2	3	1	2	1	-1	-1	0.13	-0.25	-0.10
2139245	2024-03-24 08:30:00	12	1	2.01	3.75	3.50	2.06	3.70	3.40	5	3	5	5	2	5	10	5	10	4	9	4	14	1	3	1	2	1	2	1	-1	-1	0.05	-0.05	-0.10
2119790	2023-11-06 08:30:00	12	0	2.65	3.80	2.44	2.65	3.75	2.47	10	5	9	10	5	11	20	10	20	4	14	4	24	1	3	1	2	1	2	0	-1	1	0.00	-0.05	0.03
2139246	2024-03-24 09:30:00	12	0	2.21	3.35	3.35	2.06	3.35	3.75	10	3	11	9	3	12	19	6	23	6	19	2	25	2	3	1	2	1	3	-1	0	1	-0.15	0.00	0.40
2139247	2024-03-24 10:30:00	12	3	1.47	4.40	7.00	1.48	4.30	7.00	1	2	5	1	1	5	2	3	10	8	7	0	10	3	2	1	1	2	3	1	-1	0	0.01	-0.10	0.00
2139248	2024-03-24 10:30:00	12	0	1.97	3.75	3.65	1.97	3.80	3.60	5	7	9	7	8	7	12	15	16	12	9	8	24	3	2	1	1	2	3	0	1	-1	0.00	0.05	-0.05
2139249	2024-03-24 10:30:00	12	3	2.46	3.30	2.93	2.44	3.25	3.00	17	7	9	14	6	15	31	13	24	4	22	11	35	1	3	2	3	1	2	-1	-1	1	-0.02	-0.05	0.07
2139255	2024-03-31 07:30:00	12	3	1.78	3.90	4.30	1.79	3.90	4.25	1	2	2	1	3	3	2	5	5	3	0	0	5	3	1	1	1	2	2	1	0	-1	0.01	0.00	-0.05
2139261	2024-03-31 09:30:00	12	3	1.79	3.85	4.30	1.62	4.15	5.20	5	1	3	1	5	6	6	6	9	4	4	1	10	2	2	1	1	1	3	-1	1	1	-0.17	0.30	0.90
2139200	2024-03-03 09:30:00	12	0	2.36	3.30	3.10	2.44	3.15	3.10	0	7	5	2	3	6	2	10	11	15	7	6	17	3	2	1	1	2	3	1	-1	0	0.08	-0.15	0.00
2139201	2024-03-03 09:30:00	12	1	2.20	3.55	3.20	2.13	3.55	3.35	2	1	0	1	1	2	3	2	2	1	2	2	4	1	2	2	3	1	1	-1	0	1	-0.07	0.00	0.15
2139202	2024-03-03 09:30:00	12	3	2.40	3.45	2.92	2.47	3.40	2.85	0	1	2	1	0	1	1	1	3	2	2	0	3	2	2	1	1	1	3	1	-1	-1	0.07	-0.05	-0.07
2139209	2024-03-10 03:00:00	12	0	1.77	3.65	4.15	1.77	3.80	4.55	1	1	2	2	2	2	3	3	4	1	1	0	4	2	2	1	1	1	3	0	1	1	0.00	0.15	0.40
2327123	2024-11-24 11:30:00	12	1	1.99	3.60	3.75	1.98	3.50	3.85	3	3	3	3	1	5	6	4	8	4	6	2	10	2	3	1	2	1	3	-1	-1	1	-0.01	-0.10	0.10
2325077	2024-11-25 07:00:00	12	3	1.68	4.25	4.55	1.83	4.00	3.90	1	6	5	5	3	3	6	9	8	5	2	3	11	3	1	2	1	3	2	1	-1	-1	0.15	-0.25	-0.65
2327124	2024-11-24 06:30:00	12	0	2.20	3.35	3.05	2.23	3.45	3.20	1	5	4	1	2	8	2	7	12	13	8	3	15	3	2	1	1	2	3	1	1	1	0.03	0.10	0.15
2332250	2024-12-01 08:30:00	12	0	1.85	3.70	4.15	1.88	3.70	4.05	1	0	3	3	0	1	4	0	4	0	4	0	4	1	3	1	2	1	2	1	0	-1	0.03	0.00	-0.10
2139226	2024-03-17 07:30:00	12	3	2.02	3.55	3.65	2.02	3.55	3.70	10	4	7	6	5	11	16	9	18	4	11	2	20	2	3	1	2	1	3	0	0	1	0.00	0.00	0.05
2139230	2024-03-17 08:30:00	12	3	2.86	3.60	2.37	2.87	3.55	2.38	5	3	4	5	2	6	10	5	10	0	5	0	10	1	3	1	2	1	2	1	-1	1	0.01	-0.05	0.01
2139300	2024-05-05 08:30:00	12	1	2.01	3.60	3.65	2.17	3.45	3.35	5	2	9	11	0	5	16	2	14	1	15	3	17	1	3	2	3	1	2	1	-1	-1	0.16	-0.15	-0.30
1944213	2023-07-16 08:30:00	12	3	1.59	4.20	5.50	1.59	4.20	5.50	1	0	1	0	1	2	1	1	3	2	2	0	3	2	2	1	1	1	3	0	0	0	0.00	0.00	0.00
2139304	2024-05-06 06:45:00	12	1	1.85	3.90	3.95	1.89	3.95	3.75	3	2	5	6	4	2	9	6	7	1	4	3	10	1	3	2	3	1	2	1	1	-1	0.04	0.05	-0.20
1944212	2023-07-09 07:30:00	12	0	2.82	3.60	2.39	2.82	3.60	2.40	2	1	1	4	2	3	6	3	4	0	3	2	6	1	3	2	3	1	2	0	0	1	0.00	0.00	0.01
2139307	2024-05-12 07:45:00	12	0	1.82	3.70	4.35	1.79	3.75	4.40	3	1	3	2	2	4	5	3	7	2	4	0	7	2	3	1	2	1	3	-1	1	1	-0.03	0.05	0.05
1944209	2023-06-25 10:30:00	12	0	2.13	3.65	3.25	2.19	3.60	3.15	0	1	2	1	1	0	1	2	2	2	1	1	3	3	1	1	1	2	2	1	-1	-1	0.06	-0.05	-0.10
1944208	2023-06-22 08:30:00	12	0	1.99	3.70	3.60	1.94	3.80	3.70	7	4	8	7	6	9	14	10	17	8	12	5	22	2	3	1	2	1	3	-1	1	1	-0.05	0.10	0.10
1944211	2023-09-11 08:00:00	12	1	1.89	4.00	3.70	1.91	4.00	3.65	3	3	4	6	4	3	9	7	7	3	5	5	12	1	2	2	3	1	1	1	0	-1	0.02	0.00	-0.05
1944210	2023-07-02 08:30:00	12	3	1.89	3.75	3.95	1.89	3.75	3.95	5	4	4	5	5	5	10	9	9	0	1	1	10	1	2	2	3	1	1	0	0	0	0.00	0.00	0.00
1944205	2023-07-13 10:30:00	12	3	1.55	4.40	5.70	1.53	4.40	5.90	1	1	0	0	2	1	1	3	1	2	0	2	3	2	1	2	1	3	1	-1	0	1	-0.02	0.00	0.20
1944207	2023-06-18 08:30:00	12	3	1.68	4.00	4.90	1.70	3.95	4.80	0	1	1	1	1	2	1	2	3	2	1	0	3	3	2	1	1	2	3	1	-1	-1	0.02	-0.05	-0.10
1944206	2023-06-12 01:00:00	12	1	2.10	3.55	3.10	1.98	3.80	3.55	4	0	2	2	1	4	6	1	6	1	6	1	7	1	3	1	2	1	2	-1	1	1	-0.12	0.25	0.45
2320560	2024-11-04 09:45:00	12	3	2.64	3.70	2.49	2.49	3.60	2.71	12	8	6	9	6	15	21	14	21	8	15	8	29	1	3	1	2	1	2	-1	-1	1	-0.15	-0.10	0.22
2139316	2024-05-12 10:30:00	12	1	2.05	3.80	3.35	2.04	4.05	3.20	12	7	13	14	7	10	26	14	23	8	20	11	34	1	3	2	3	1	2	-1	1	-1	-0.01	0.25	-0.15
2139327	2024-05-16 08:30:00	12	0	2.53	3.60	2.64	2.52	3.65	2.65	1	1	1	1	1	1	2	2	2	0	0	0	2	1	1	1	1	1	1	-1	1	1	-0.01	0.05	0.01
2139266	2024-04-07 07:30:00	12	1	1.67	4.15	4.80	1.76	4.05	4.25	1	4	8	4	3	4	5	7	12	7	5	0	12	3	2	1	1	2	3	1	-1	-1	0.09	-0.10	-0.55
2139268	2024-04-07 07:45:00	12	3	1.83	4.05	3.90	1.72	4.20	4.30	5	3	4	4	7	6	9	10	10	5	4	4	14	3	1	1	1	2	2	-1	1	1	-0.11	0.15	0.40
2325133	2024-11-09 11:30:00	12	3	1.61	4.25	5.10	1.63	4.20	4.95	2	8	6	5	5	5	7	13	11	11	5	7	18	3	1	2	1	3	2	1	-1	-1	0.02	-0.05	-0.15
2139284	2024-04-28 07:30:00	12	1	1.64	3.90	5.40	1.67	3.85	5.20	1	7	6	3	5	5	4	12	11	8	0	1	12	3	1	2	1	3	2	1	-1	-1	0.03	-0.05	-0.20
2139292	2024-05-05 07:30:00	12	0	1.74	4.15	4.25	1.74	4.25	4.15	1	4	4	1	7	3	2	11	7	10	1	5	12	3	1	2	1	3	2	0	1	-1	0.00	0.10	-0.10
1943773	2023-07-02 07:30:00	12	1	2.49	3.50	2.56	2.57	3.55	2.65	6	3	4	6	4	8	12	7	12	0	5	0	12	1	3	1	2	1	2	1	1	1	0.08	0.05	0.09
1943772	2023-07-02 07:30:00	12	0	2.36	3.60	2.88	2.29	3.65	2.93	2	1	4	1	3	3	3	4	7	4	3	0	7	3	2	1	1	2	3	-1	1	1	-0.07	0.05	0.05
2139361	2024-10-13 07:30:00	12	3	1.39	5.40	7.00	1.39	5.40	7.00	2	1	3	2	1	4	4	2	7	3	5	0	7	2	3	1	2	1	3	0	0	0	0.00	0.00	0.00
1943775	2023-07-13 10:30:00	12	3	1.75	4.10	4.25	1.74	4.20	4.20	1	4	7	0	6	5	1	10	12	15	6	4	16	3	2	1	1	2	3	-1	1	-1	-0.01	0.10	-0.05
1943774	2023-07-05 07:30:00	12	3	1.60	4.10	5.40	1.47	4.55	6.70	6	1	2	0	8	7	6	9	9	4	1	1	10	3	1	1	1	2	2	-1	1	1	-0.13	0.45	1.30
2139363	2024-05-30 07:30:00	12	3	1.60	4.05	5.80	1.64	3.95	5.50	2	3	3	2	3	4	4	6	7	3	1	0	7	3	2	1	1	2	3	1	-1	-1	0.04	-0.10	-0.30
1943769	2023-06-25 08:30:00	12	3	2.17	3.60	3.20	2.23	3.70	3.00	1	0	4	2	1	3	3	1	7	4	6	0	7	2	3	1	2	1	3	1	1	-1	0.06	0.10	-0.20
1943768	2023-06-25 07:30:00	12	3	1.65	4.05	5.10	1.63	4.25	4.95	3	1	3	3	4	4	6	5	7	2	3	1	8	2	3	1	2	1	3	-1	1	-1	-0.02	0.20	-0.15
2139365	2024-05-30 07:30:00	12	1	1.59	4.30	5.50	1.61	4.25	5.30	1	2	3	4	2	2	5	4	5	0	1	0	5	1	3	1	2	1	2	1	-1	-1	0.02	-0.05	-0.20
1943771	2023-07-02 07:30:00	12	3	1.82	3.80	4.20	1.87	3.80	3.95	0	0	2	2	1	1	2	1	3	1	2	0	3	2	3	1	2	1	3	1	0	-1	0.05	0.00	-0.25
2139366	2024-05-30 08:30:00	12	0	2.01	3.75	3.50	2.12	3.65	3.30	5	4	5	7	3	6	12	7	11	3	8	4	15	1	3	2	3	1	2	1	-1	-1	0.11	-0.10	-0.20
1943770	2023-06-25 10:30:00	12	1	1.94	3.60	3.90	1.93	3.60	3.95	2	0	4	3	1	2	5	1	6	1	5	0	6	2	3	1	2	1	3	-1	0	1	-0.01	0.00	0.05
1943765	2023-06-22 07:30:00	12	3	1.69	3.90	4.50	1.64	4.05	5.20	5	1	1	5	5	5	10	6	6	3	7	7	13	1	2	2	3	1	1	-1	1	1	-0.05	0.15	0.70
1943764	2023-06-18 07:30:00	12	3	1.90	3.70	3.95	1.80	3.80	4.30	6	1	1	2	4	7	8	5	8	0	3	0	8	1	3	1	2	1	2	-1	1	1	-0.10	0.10	0.35
1943767	2023-06-22 09:30:00	12	3	2.16	3.40	3.40	2.03	3.50	3.70	5	2	3	1	3	6	6	5	9	8	9	5	14	2	3	1	2	1	3	-1	1	1	-0.13	0.10	0.30
2139370	2024-05-30 10:30:00	12	3	1.51	4.55	6.10	1.54	4.55	5.50	7	10	11	11	11	6	18	21	17	10	7	11	28	2	1	3	2	3	1	1	0	-1	0.03	0.00	-0.60
1943766	2023-06-22 07:30:00	12	1	2.60	3.50	2.65	2.63	3.45	2.63	5	1	4	6	1	5	11	2	9	0	9	2	11	1	3	2	3	1	2	1	-1	-1	0.03	-0.05	-0.02
2139371	2024-05-30 10:45:00	12	3	1.50	4.75	5.90	1.50	4.75	6.10	7	10	11	9	9	11	16	19	22	16	13	10	32	3	2	1	1	2	3	0	0	1	0.00	0.00	0.20
1943761	2023-06-11 07:30:00	12	1	2.57	3.20	2.65	2.57	3.35	2.76	6	0	8	8	2	6	14	2	14	0	12	0	14	1	3	1	2	1	2	0	1	1	0.00	0.15	0.11
2139372	2024-05-30 10:30:00	12	1	2.04	3.65	3.50	2.08	3.65	3.40	6	1	8	8	1	5	14	2	13	0	12	1	14	1	3	2	3	1	2	1	0	-1	0.04	0.00	-0.10
2139373	2024-06-01 07:30:00	12	3	1.62	4.10	4.60	1.62	4.15	4.45	1	4	4	2	5	1	3	9	5	7	1	5	10	3	1	2	1	3	2	0	1	-1	0.00	0.05	-0.15
1943763	2023-06-11 08:30:00	12	3	1.86	3.60	3.75	1.77	3.80	4.50	14	5	8	8	8	15	22	13	23	2	11	1	24	2	3	1	2	1	3	-1	1	1	-0.09	0.20	0.75
1943762	2023-06-11 07:30:00	12	3	1.80	3.70	4.45	1.79	3.75	4.45	2	0	1	0	2	2	2	2	3	1	1	0	3	2	2	1	1	1	3	-1	1	0	-0.01	0.05	0.00
2139375	2024-09-08 07:30:00	12	0	1.86	3.70	3.70	1.89	3.80	3.90	7	3	8	10	5	7	17	8	15	4	13	6	21	1	3	2	3	1	2	1	1	1	0.03	0.10	0.20
2139377	2024-06-02 07:30:00	12	3	1.80	3.80	4.35	1.81	3.80	4.30	2	4	2	2	5	3	4	9	5	7	2	6	11	3	1	2	1	3	2	1	0	-1	0.01	0.00	-0.05
1943758	2023-06-04 07:30:00	12	0	1.85	3.50	4.45	1.86	3.50	4.45	1	1	2	2	2	3	3	3	5	3	3	1	6	2	2	1	1	1	3	1	0	0	0.01	0.00	0.00
2139379	2024-06-02 07:30:00	12	1	1.47	4.65	6.50	1.48	4.60	6.40	1	1	2	3	1	2	4	2	4	1	3	1	5	1	3	1	2	1	2	1	-1	-1	0.01	-0.05	-0.10
2139383	2024-06-02 08:30:00	12	0	1.74	3.90	4.60	1.71	3.95	4.70	2	3	5	3	3	3	5	6	8	3	2	0	8	3	2	1	1	2	3	-1	1	1	-0.03	0.05	0.10
2139384	2024-06-02 10:30:00	12	3	1.31	5.40	10.00	1.29	5.60	11.00	8	10	16	11	9	14	19	19	30	14	14	3	33	2	2	1	1	1	3	-1	1	1	-0.02	0.20	1.00
2139385	2024-06-02 10:30:00	12	1	2.21	3.70	3.05	2.20	3.65	3.10	1	3	3	2	2	3	3	5	6	3	1	0	6	3	2	1	1	2	3	-1	-1	1	-0.01	-0.05	0.05
2139387	2024-06-09 07:30:00	12	3	2.40	3.50	2.65	2.38	3.65	2.80	8	1	9	7	3	10	15	4	19	4	15	0	19	2	3	1	2	1	3	-1	1	1	-0.02	0.15	0.15
2139388	2024-06-09 08:30:00	12	3	2.77	3.60	2.44	2.66	3.45	2.61	15	5	15	16	4	20	31	9	35	6	28	2	37	2	3	1	2	1	3	-1	-1	1	-0.11	-0.15	0.17
2139389	2024-06-09 08:30:00	12	1	2.20	3.65	3.10	2.23	3.60	3.05	6	1	5	5	1	7	11	2	12	2	11	1	13	2	3	1	2	1	3	1	-1	-1	0.03	-0.05	-0.05
2139390	2024-06-09 08:30:00	12	1	1.69	4.20	4.55	1.72	4.20	4.35	1	3	4	3	4	2	4	7	6	4	1	2	8	3	1	2	1	3	2	1	0	-1	0.03	0.00	-0.20
2139391	2024-06-15 07:30:00	12	0	2.20	3.60	3.15	2.19	3.80	3.05	4	7	12	3	11	10	7	18	22	24	13	9	31	3	2	1	1	2	3	-1	1	-1	-0.01	0.20	-0.10
2139333	2024-05-19 01:45:00	12	1	1.91	3.70	3.50	1.97	3.70	3.70	2	2	4	5	2	3	7	4	7	2	5	2	9	1	3	1	2	1	2	1	0	1	0.06	0.00	0.20
2139335	2024-05-19 07:30:00	12	3	1.45	4.65	5.70	1.55	4.80	5.30	10	9	12	14	9	10	24	18	22	4	10	6	28	1	3	2	3	1	2	1	1	-1	0.10	0.15	-0.40
2139336	2024-05-19 07:30:00	12	3	2.31	3.45	3.05	2.42	3.45	2.88	0	1	6	2	2	3	2	3	9	9	8	2	11	3	2	1	1	2	3	1	0	-1	0.11	0.00	-0.17
2327242	2024-11-25 04:30:00	12	3	1.65	3.95	4.50	1.52	4.60	5.60	10	8	9	6	12	12	16	20	21	8	4	3	24	3	2	1	1	2	3	-1	1	1	-0.13	0.65	1.10
2139339	2024-05-19 08:30:00	12	3	2.19	3.55	3.20	2.31	3.55	2.97	0	1	5	3	2	2	3	3	7	4	4	0	7	2	2	1	1	1	3	1	0	-1	0.12	0.00	-0.23
2139341	2024-05-19 08:30:00	12	1	1.78	3.55	4.80	1.81	3.75	4.35	0	4	7	1	8	4	1	12	11	16	5	6	17	3	1	2	1	3	2	1	1	-1	0.03	0.20	-0.45
2139342	2024-05-19 08:30:00	12	3	1.77	4.10	4.15	1.79	4.05	4.10	1	5	6	3	5	6	4	10	12	8	2	0	12	3	2	1	1	2	3	1	-1	-1	0.02	-0.05	-0.05
2139343	2024-05-19 09:30:00	12	3	1.82	3.95	4.00	1.79	4.10	4.05	2	4	3	1	5	4	3	9	7	9	3	5	12	3	1	2	1	3	2	-1	1	1	-0.03	0.15	0.05
1943789	2023-09-03 07:30:00	12	0	1.82	3.90	4.10	1.84	3.80	4.15	2	4	3	1	3	6	3	7	9	6	2	0	9	3	2	1	1	2	3	1	-1	1	0.02	-0.10	0.05
2139347	2024-05-26 07:30:00	12	0	2.62	3.65	2.36	2.82	3.70	2.35	6	1	7	9	1	6	15	2	13	1	14	3	16	1	3	2	3	1	2	1	1	-1	0.20	0.05	-0.01
2139348	2024-05-26 07:30:00	12	1	2.38	3.55	2.89	2.56	3.50	2.67	6	2	10	9	2	7	15	4	17	3	14	1	18	2	3	1	2	1	3	1	-1	-1	0.18	-0.05	-0.22
2139349	2024-05-26 07:30:00	12	1	1.62	4.25	5.10	1.60	4.40	5.20	4	1	4	3	5	6	7	6	10	6	7	3	13	2	3	1	2	1	3	-1	1	1	-0.02	0.15	0.10
2132182	2023-12-10 05:00:00	12	3	2.19	3.55	3.20	2.23	3.50	3.15	2	2	2	2	2	3	4	4	5	3	3	2	7	2	2	1	1	1	3	1	-1	-1	0.04	-0.05	-0.05
2139350	2024-05-26 07:30:00	12	0	2.51	3.60	2.67	2.53	3.70	2.61	10	2	11	10	5	9	20	7	20	3	16	3	23	1	3	1	2	1	2	1	1	-1	0.02	0.10	-0.06
2139352	2024-05-26 07:30:00	12	1	2.54	3.45	2.73	2.68	3.40	2.62	12	4	13	14	4	10	26	8	23	2	20	5	28	1	3	2	3	1	2	1	-1	-1	0.14	-0.05	-0.11
1943780	2023-07-16 09:30:00	12	3	2.16	3.70	3.15	2.21	3.70	3.05	1	1	2	4	2	2	5	3	4	1	3	2	6	1	3	2	3	1	2	1	0	-1	0.05	0.00	-0.10
2139353	2024-05-26 07:30:00	12	0	2.83	3.55	2.40	2.85	3.55	2.39	11	1	13	16	2	12	27	3	25	2	26	4	29	1	3	2	3	1	2	1	0	-1	0.02	0.00	-0.01
2139355	2024-05-26 08:30:00	12	0	2.05	3.60	3.50	2.14	3.55	3.30	3	2	4	4	2	3	7	4	7	2	5	2	9	1	3	1	2	1	2	1	-1	-1	0.09	-0.05	-0.20
1943777	2023-07-09 09:30:00	12	3	1.96	3.80	3.65	2.00	3.75	3.50	4	3	5	5	2	4	9	5	9	1	5	1	10	1	3	1	2	1	2	1	-1	-1	0.04	-0.05	-0.15
1943776	2023-07-09 08:30:00	12	0	1.85	3.80	3.60	1.87	3.90	3.85	8	4	8	6	6	7	14	10	15	3	7	2	17	2	3	1	2	1	3	1	1	1	0.02	0.10	0.25
2139357	2024-05-26 10:30:00	12	3	1.85	3.80	4.05	1.80	4.15	3.95	9	5	9	4	10	9	13	15	18	12	10	7	25	3	2	1	1	2	3	-1	1	-1	-0.05	0.35	-0.10
1943779	2023-07-16 08:30:00	12	3	1.68	3.95	4.95	1.79	3.80	4.35	5	3	6	7	1	5	12	4	11	1	9	2	13	1	3	2	3	1	2	1	-1	-1	0.11	-0.15	-0.60
2139358	2024-05-26 10:30:00	12	3	1.98	3.95	3.45	1.98	3.85	3.50	4	7	4	5	6	4	9	13	8	7	3	8	16	2	1	3	2	3	1	0	-1	1	0.00	-0.10	0.05
1943778	2023-07-16 07:30:00	12	0	2.08	3.75	3.30	2.09	3.75	3.30	1	1	1	2	2	2	3	3	3	1	1	1	4	1	1	1	1	1	1	1	0	0	0.01	0.00	0.00
2139359	2024-05-26 10:30:00	12	1	1.86	3.90	3.95	1.89	3.75	3.90	4	4	3	5	1	4	9	5	7	1	5	3	10	1	3	2	3	1	2	1	-1	-1	0.03	-0.15	-0.05
2139425	2024-06-23 08:30:00	12	3	2.19	3.40	3.30	2.29	3.50	3.05	3	4	7	4	5	3	7	9	10	10	8	7	17	3	2	1	1	2	3	1	1	-1	0.10	0.10	-0.25
2139429	2024-06-23 10:30:00	12	3	1.45	4.40	8.00	1.52	4.15	7.00	0	4	6	4	0	3	4	4	9	5	5	0	9	2	2	1	1	1	3	1	-1	-1	0.07	-0.25	-1.00
1943835	2023-06-15 10:30:00	12	0	1.48	4.55	6.50	1.48	4.60	6.30	4	6	12	4	6	10	8	12	22	17	13	3	25	3	2	1	1	2	3	0	1	-1	0.00	0.05	-0.20
2139430	2024-06-23 10:30:00	12	3	1.37	5.20	7.60	1.40	5.20	6.90	6	3	13	9	3	8	15	6	21	11	20	5	26	2	3	1	2	1	3	1	0	-1	0.03	0.00	-0.70
2139432	2024-06-29 07:30:00	12	3	1.88	3.70	3.60	1.85	3.90	3.95	10	5	10	6	10	10	16	15	20	11	12	7	27	2	3	1	2	1	3	-1	1	1	-0.03	0.20	0.35
2139435	2024-06-30 07:30:00	12	1	1.48	4.35	5.80	1.51	4.35	6.30	1	1	2	3	1	3	4	2	5	1	3	0	5	2	3	1	2	1	3	1	0	1	0.03	0.00	0.50
2139436	2024-06-30 07:30:00	12	3	1.79	3.80	3.85	1.80	4.05	4.05	4	6	8	4	9	8	8	15	16	12	5	4	20	3	2	1	1	2	3	1	1	1	0.01	0.25	0.20
2139437	2024-06-30 07:30:00	12	3	2.39	3.60	2.62	2.47	3.75	2.65	2	0	3	2	3	3	4	3	6	3	4	1	7	2	3	1	2	1	3	1	1	1	0.08	0.15	0.03
2139440	2024-06-30 08:30:00	12	3	1.83	3.85	4.10	1.95	3.75	3.70	3	3	6	6	2	4	9	5	10	3	7	2	12	2	3	1	2	1	3	1	-1	-1	0.12	-0.10	-0.40
2139442	2024-06-30 10:30:00	12	3	1.51	4.65	5.90	1.51	4.60	5.90	1	2	3	1	3	2	2	5	5	4	1	1	6	3	1	1	1	2	2	0	-1	0	0.00	-0.05	0.00
2139443	2024-06-30 10:30:00	12	3	1.89	4.10	3.65	1.77	4.15	4.10	8	6	5	4	10	8	12	16	13	12	8	11	24	3	1	2	1	3	2	-1	1	1	-0.12	0.05	0.45
2139445	2024-06-30 10:30:00	12	3	1.56	4.20	6.00	1.59	4.20	5.60	7	4	9	7	6	7	14	10	16	4	8	2	18	2	3	1	2	1	3	1	0	-1	0.03	0.00	-0.40
2139447	2024-07-04 06:30:00	12	3	1.41	4.75	6.50	1.47	4.55	6.70	1	2	5	4	1	3	5	3	8	3	5	0	8	2	3	1	2	1	3	1	-1	1	0.06	-0.20	0.20
2139449	2024-07-04 07:45:00	12	3	2.13	3.70	3.20	2.21	3.70	3.05	3	3	8	7	3	3	10	6	11	6	10	5	16	2	3	1	2	1	3	1	0	-1	0.08	0.00	-0.15
2139450	2024-07-04 07:30:00	12	3	1.41	5.00	7.10	1.41	5.10	7.00	3	6	7	4	7	7	7	13	14	10	4	3	17	3	2	1	1	2	3	0	1	-1	0.00	0.10	-0.10
2139451	2024-07-04 07:30:00	12	0	2.31	3.65	2.90	2.36	3.70	2.81	0	2	6	1	3	4	1	5	10	9	5	0	10	3	2	1	1	2	3	1	1	-1	0.05	0.05	-0.09
2139452	2024-07-04 08:30:00	12	3	2.07	3.70	3.35	2.13	3.65	3.25	4	3	4	8	1	3	12	4	7	1	9	6	13	1	3	2	3	1	2	1	-1	-1	0.06	-0.05	-0.10
2139455	2024-07-04 09:30:00	12	3	1.77	4.00	4.25	1.79	4.00	4.15	4	5	7	6	4	5	10	9	12	3	4	1	13	2	3	1	2	1	3	1	0	-1	0.02	0.00	-0.10
2139392	2024-06-16 07:30:00	12	1	2.08	3.70	3.35	2.09	3.80	3.25	3	3	6	4	6	5	7	9	11	7	5	3	14	3	2	1	1	2	3	1	1	-1	0.01	0.10	-0.10
2139393	2024-06-16 07:30:00	12	1	1.77	3.65	4.75	1.81	3.60	4.50	1	3	6	3	3	4	4	6	10	7	5	1	11	3	2	1	1	2	3	1	-1	-1	0.04	-0.05	-0.25
1943871	2023-06-04 07:30:00	12	3	1.53	4.15	6.40	1.44	4.70	7.10	6	1	4	2	7	7	8	8	11	4	4	1	12	2	2	1	1	1	3	-1	1	1	-0.09	0.55	0.70
1943870	2023-06-04 04:30:00	12	1	1.74	3.70	4.25	1.76	3.75	4.70	0	0	1	2	1	1	2	1	2	0	1	0	2	1	3	1	2	1	2	1	1	1	0.02	0.05	0.45
2139395	2024-06-16 07:30:00	12	0	2.78	3.55	2.45	2.80	3.55	2.44	6	2	7	9	3	6	15	5	13	1	11	3	16	1	3	2	3	1	2	1	0	-1	0.02	0.00	-0.01
1943865	2023-06-01 07:30:00	12	1	1.79	3.80	4.40	1.69	3.95	4.90	3	3	3	1	7	5	4	10	8	8	2	4	12	3	1	2	1	3	2	-1	1	1	-0.10	0.15	0.50
2139396	2024-06-16 07:30:00	12	1	3.30	3.80	2.06	3.10	3.75	2.17	3	3	3	2	3	6	5	6	9	7	6	3	12	3	2	1	1	2	3	-1	-1	1	-0.20	-0.05	0.11
1943864	2023-06-01 07:30:00	12	3	1.58	4.20	5.60	1.56	4.30	5.80	2	0	1	2	3	3	4	3	4	0	1	0	4	1	3	1	2	1	2	-1	1	1	-0.02	0.10	0.20
2139397	2024-06-16 07:30:00	12	3	2.40	3.65	2.78	2.40	3.65	2.79	1	0	1	1	1	2	2	1	3	1	2	0	3	2	3	1	2	1	3	0	0	1	0.00	0.00	0.01
1943867	2023-06-01 07:30:00	12	3	1.68	4.10	4.75	1.61	4.20	5.20	2	0	0	0	2	3	2	2	3	1	1	0	3	2	2	1	1	1	3	-1	1	1	-0.07	0.10	0.45
2139399	2024-06-16 08:30:00	12	3	2.31	3.60	2.93	2.40	3.60	2.82	0	0	3	2	0	0	2	0	3	1	3	0	3	2	3	1	2	1	3	1	0	-1	0.09	0.00	-0.11
2139400	2024-06-16 09:30:00	12	3	1.62	4.25	5.10	1.55	4.40	5.70	4	5	4	4	5	5	8	10	9	8	6	7	16	3	1	2	1	3	2	-1	1	1	-0.07	0.15	0.60
2139402	2024-06-16 10:30:00	12	3	1.60	4.40	5.10	1.57	4.45	5.30	5	1	1	2	3	4	7	4	5	0	3	2	7	1	3	2	3	1	2	-1	1	1	-0.03	0.05	0.20
2139404	2024-06-16 10:30:00	12	3	1.67	4.10	4.80	1.62	4.20	5.20	3	4	4	2	4	7	5	8	11	6	3	0	11	3	2	1	1	2	3	-1	1	1	-0.05	0.10	0.40
2139406	2024-06-20 07:45:00	12	3	1.75	4.00	4.35	1.78	4.05	4.15	4	6	6	2	7	9	6	13	15	10	3	1	16	3	2	1	1	2	3	1	1	-1	0.03	0.05	-0.20
2139407	2024-06-20 07:30:00	12	0	2.06	3.85	3.00	2.06	4.00	3.20	3	1	3	1	4	5	4	5	8	5	4	1	9	3	2	1	1	2	3	0	1	1	0.00	0.15	0.20
2139409	2024-06-20 07:30:00	12	0	2.20	3.45	3.25	2.23	3.45	3.20	2	1	2	2	2	3	4	3	5	1	2	0	5	2	3	1	2	1	3	1	0	-1	0.03	0.00	-0.05
2139410	2024-06-20 07:30:00	12	1	2.98	3.45	2.19	3.20	3.50	2.20	5	2	1	3	2	5	8	4	6	1	5	3	9	1	3	2	3	1	2	1	1	1	0.22	0.05	0.01
2139411	2024-06-20 08:30:00	12	1	3.70	3.85	1.93	3.40	3.75	2.05	6	3	4	4	2	6	10	5	10	1	6	1	11	1	3	1	2	1	2	-1	-1	1	-0.30	-0.10	0.12
2139413	2024-06-20 08:30:00	12	1	2.14	3.45	3.45	2.19	3.40	3.30	2	1	3	2	1	2	4	2	5	1	3	0	5	2	3	1	2	1	3	1	-1	-1	0.05	-0.05	-0.15
2139414	2024-06-20 08:30:00	12	0	2.04	3.90	3.30	2.06	3.95	3.20	3	1	4	3	3	2	6	4	6	3	5	3	9	1	3	1	2	1	2	1	1	-1	0.02	0.05	-0.10
2139415	2024-06-20 08:30:00	12	0	2.63	3.70	2.50	2.59	3.70	2.54	7	0	5	5	0	6	12	0	11	0	12	1	12	1	3	2	3	1	2	-1	0	1	-0.04	0.00	0.04
2139416	2024-06-20 10:30:00	12	3	2.03	3.95	3.30	1.99	4.10	3.30	6	2	4	3	5	5	9	7	9	8	10	8	17	1	3	1	2	1	2	-1	1	0	-0.04	0.15	0.00
2139417	2024-06-20 10:30:00	12	0	1.98	3.90	3.45	2.07	3.95	3.20	4	0	6	7	1	4	11	1	10	1	11	2	12	1	3	2	3	1	2	1	1	-1	0.09	0.05	-0.25
2125595	2023-11-26 09:00:00	12	3	1.85	3.85	4.00	1.76	4.00	4.30	5	3	8	4	6	7	9	9	15	9	9	3	18	2	2	1	1	1	3	-1	1	1	-0.09	0.15	0.30
2139419	2024-06-23 07:30:00	12	3	1.48	4.70	6.20	1.49	4.65	6.10	1	2	3	3	2	3	4	4	6	5	5	3	9	2	2	1	1	1	3	1	-1	-1	0.01	-0.05	-0.10
2125596	2023-11-27 08:00:00	12	3	1.82	3.75	4.30	1.82	3.65	4.40	3	6	7	2	7	9	5	13	16	15	7	4	20	3	2	1	1	2	3	0	-1	1	0.00	-0.10	0.10
2139423	2024-06-23 07:30:00	12	3	1.60	4.15	5.40	1.60	4.15	5.40	4	3	3	4	4	4	8	7	7	1	2	2	9	1	2	2	3	1	1	0	0	0	0.00	0.00	0.00
1943901	2023-07-09 10:30:00	12	3	2.54	3.65	2.62	2.49	3.70	2.64	4	0	5	4	1	4	8	1	9	2	9	1	10	2	3	1	2	1	3	-1	1	1	-0.05	0.05	0.02
1943900	2023-07-16 07:30:00	12	3	1.97	3.60	3.75	2.01	3.55	3.70	9	4	9	10	4	9	19	8	18	1	12	2	20	1	3	2	3	1	2	1	-1	-1	0.04	-0.05	-0.05
1943903	2023-07-16 10:30:00	12	1	1.69	3.75	5.20	1.64	3.90	5.40	4	5	7	1	8	8	5	13	15	14	6	4	19	3	2	1	1	2	3	-1	1	1	-0.05	0.15	0.20
1943902	2023-07-16 10:30:00	12	3	2.19	3.70	3.10	2.17	3.70	3.15	2	1	1	0	1	3	2	2	4	2	2	0	4	2	2	1	1	1	3	-1	0	1	-0.02	0.00	0.05
1943897	2023-07-13 08:30:00	12	0	2.14	3.45	3.40	2.12	3.50	3.45	3	0	3	3	2	4	6	2	7	2	6	1	8	2	3	1	2	1	3	-1	1	1	-0.02	0.05	0.05
2139492	2024-07-18 07:30:00	12	1	1.43	4.70	7.30	1.44	4.75	7.10	8	5	13	9	8	14	17	13	27	11	15	1	28	2	3	1	2	1	3	1	1	-1	0.01	0.05	-0.20
1943896	2023-07-13 08:30:00	12	1	1.97	3.80	3.60	2.16	3.75	3.15	6	2	10	12	2	6	18	4	16	1	15	3	19	1	3	2	3	1	2	1	-1	-1	0.19	-0.05	-0.45
1943899	2023-07-09 09:30:00	12	3	2.13	3.30	3.60	2.13	3.35	3.50	1	2	5	1	4	2	2	6	7	5	1	0	7	3	2	1	1	2	3	0	1	-1	0.00	0.05	-0.10
1943898	2023-07-09 07:30:00	12	1	1.85	3.70	3.70	1.78	3.90	4.30	4	1	5	3	3	4	7	4	9	2	5	0	9	2	3	1	2	1	3	-1	1	1	-0.07	0.20	0.60
1943893	2023-07-05 07:30:00	12	1	2.82	3.70	2.36	2.88	3.70	2.31	3	1	2	3	2	4	6	3	6	1	4	1	7	1	3	1	2	1	2	1	0	-1	0.06	0.00	-0.05
2139496	2024-07-18 08:30:00	12	0	2.66	3.55	2.56	2.71	3.60	2.49	8	1	9	8	3	9	16	4	18	3	15	1	19	2	3	1	2	1	3	1	1	-1	0.05	0.05	-0.07
1943892	2023-07-03 04:00:00	12	3	2.40	3.65	2.79	2.31	3.70	2.88	2	0	3	1	2	3	3	2	6	3	4	0	6	2	3	1	2	1	3	-1	1	1	-0.09	0.05	0.09
2139497	2024-07-18 10:45:00	12	1	1.51	4.70	5.90	1.46	5.00	6.10	14	12	19	11	16	18	25	28	37	16	13	4	41	3	2	1	1	2	3	-1	1	1	-0.05	0.30	0.20
1943895	2023-07-05 08:30:00	12	0	2.36	3.35	3.05	2.35	3.45	2.98	2	3	7	2	5	5	4	8	12	13	9	5	17	3	2	1	1	2	3	-1	1	-1	-0.01	0.10	-0.07
2139499	2024-07-18 10:30:00	12	3	1.65	4.10	4.95	1.57	4.30	5.60	7	3	6	3	7	9	10	10	15	6	6	1	16	2	2	1	1	1	3	-1	1	1	-0.08	0.20	0.65
1943889	2023-07-02 07:30:00	12	3	2.00	3.50	3.75	2.03	3.45	3.70	9	6	9	11	6	11	20	12	20	4	12	4	24	1	3	1	2	1	2	1	-1	-1	0.03	-0.05	-0.05
1943888	2023-06-25 10:30:00	12	1	2.04	3.45	3.70	2.05	3.50	3.65	1	2	4	3	3	1	4	5	5	4	3	3	8	3	1	1	1	2	2	1	1	-1	0.01	0.05	-0.05
1943891	2023-07-02 08:30:00	12	3	2.09	3.60	3.40	2.03	3.65	3.55	1	0	1	1	1	1	2	1	2	1	2	1	3	1	3	1	2	1	2	-1	1	1	-0.06	0.05	0.15
2139502	2024-07-21 07:30:00	12	3	2.81	3.70	2.20	2.90	3.95	2.21	13	2	5	7	4	7	20	6	12	0	14	8	20	1	3	2	3	1	2	1	1	1	0.09	0.25	0.01
1943890	2023-07-02 08:30:00	12	3	2.88	3.60	2.36	2.91	3.55	2.35	5	3	1	4	3	1	9	6	2	0	3	7	9	1	2	3	3	2	1	1	-1	-1	0.03	-0.05	-0.01
1943885	2023-06-25 07:30:00	12	3	2.06	3.50	3.25	2.01	3.65	3.60	4	2	3	2	4	4	6	6	7	5	5	4	11	2	2	1	1	1	3	-1	1	1	-0.05	0.15	0.35
1943884	2023-06-22 10:30:00	12	0	1.81	3.80	4.30	1.74	3.90	4.60	3	1	1	0	3	3	3	4	4	4	3	3	7	3	1	1	1	2	2	-1	1	1	-0.07	0.10	0.30
1943887	2023-06-25 09:30:00	12	1	2.06	3.60	3.50	1.97	3.75	3.65	4	0	2	1	2	3	5	2	5	1	4	1	6	1	3	1	2	1	2	-1	1	1	-0.09	0.15	0.15
1943886	2023-06-25 07:30:00	12	3	1.40	4.75	8.00	1.40	4.80	7.80	8	4	7	6	7	9	14	11	16	2	5	0	16	2	3	1	2	1	3	0	1	-1	0.00	0.05	-0.20
2139507	2024-07-21 07:30:00	12	3	1.83	3.80	3.70	1.76	3.95	4.40	7	4	7	4	8	9	11	12	16	6	5	1	17	3	2	1	1	2	3	-1	1	1	-0.07	0.15	0.70
2319728	2024-10-29 09:00:00	12	1	1.85	3.60	4.30	1.86	3.65	4.20	6	5	8	4	6	8	10	11	16	9	8	3	19	3	2	1	1	2	3	1	1	-1	0.01	0.05	-0.10
1943881	2023-06-18 03:30:00	12	1	2.20	3.45	2.96	2.21	3.55	3.15	0	1	2	1	2	1	1	3	3	4	2	2	5	3	1	1	1	2	2	1	1	1	0.01	0.10	0.19
1943880	2023-06-12 10:00:00	12	3	2.13	3.50	3.40	2.14	3.50	3.35	1	1	1	3	1	0	4	2	1	0	2	3	4	1	2	3	3	2	1	1	0	-1	0.01	0.00	-0.05
2110837	2023-10-22 06:00:00	12	3	2.02	3.95	3.35	2.08	3.90	3.20	0	1	2	2	1	1	2	2	3	1	1	0	3	2	2	1	1	1	3	1	-1	-1	0.06	-0.05	-0.15
1943883	2023-06-18 10:30:00	12	1	2.16	3.55	3.30	2.36	3.50	2.94	1	3	8	6	3	3	7	6	11	5	6	1	12	2	3	1	2	1	3	1	-1	-1	0.20	-0.05	-0.36
1943882	2023-06-18 07:30:00	12	0	1.73	3.90	4.65	1.70	3.95	4.80	2	1	3	0	4	4	2	5	7	5	2	0	7	3	2	1	1	2	3	-1	1	1	-0.03	0.05	0.15
1943876	2023-06-11 08:30:00	12	0	2.49	3.45	2.77	2.49	3.50	2.77	0	1	0	1	1	1	1	2	1	1	0	1	2	2	1	2	1	3	1	0	1	0	0.00	0.05	0.00
2110841	2023-10-22 06:00:00	12	1	1.78	4.10	3.65	1.78	4.30	3.95	1	1	3	1	5	3	2	6	6	5	1	1	7	3	1	1	1	2	2	0	1	1	0.00	0.20	0.30
2139513	2024-07-21 10:45:00	12	3	1.84	4.20	3.70	2.00	4.10	3.25	10	6	16	18	5	8	28	11	24	5	22	9	33	1	3	2	3	1	2	1	-1	-1	0.16	-0.10	-0.45
1943879	2023-06-11 10:30:00	12	3	2.43	3.30	2.73	2.66	3.35	2.66	1	1	6	9	1	4	10	2	10	0	8	0	10	1	3	1	2	1	2	1	1	-1	0.23	0.05	-0.07
2110842	2023-10-22 09:00:00	12	1	2.33	3.85	2.78	2.42	3.75	2.72	3	3	4	8	2	6	11	5	10	2	8	3	13	1	3	2	3	1	2	1	-1	-1	0.09	-0.10	-0.06
2139514	2024-07-21 10:30:00	12	0	2.43	3.45	2.86	2.38	3.45	2.93	11	1	8	8	1	11	19	2	19	0	17	0	19	1	3	1	2	1	2	-1	0	1	-0.05	0.00	0.07
1943878	2023-06-11 09:30:00	12	1	2.24	3.30	3.00	2.20	3.35	3.35	2	2	1	1	1	4	3	3	5	2	2	0	5	2	2	1	1	1	3	-1	1	1	-0.04	0.05	0.35
2139515	2024-08-25 06:45:00	12	0	2.55	3.70	2.58	2.58	3.65	2.58	7	5	7	10	4	10	17	9	17	4	12	4	21	1	3	1	2	1	2	1	-1	0	0.03	-0.05	0.00
1943873	2023-06-04 07:30:00	12	3	1.62	4.15	5.20	1.63	4.10	5.10	0	2	2	2	2	3	2	4	5	4	2	1	6	3	2	1	1	2	3	1	-1	-1	0.01	-0.05	-0.10
2110844	2023-10-22 09:00:00	12	0	2.38	3.60	2.84	2.40	3.60	2.82	1	0	1	2	1	2	3	1	3	0	2	0	3	1	3	1	2	1	2	1	0	-1	0.02	0.00	-0.02
2139516	2024-10-14 07:30:00	12	0	2.69	3.70	2.45	2.62	3.70	2.52	9	2	8	11	3	8	20	5	16	0	15	4	20	1	3	2	3	1	2	-1	0	1	-0.07	0.00	0.07
1943872	2023-06-04 07:30:00	12	0	2.49	3.45	2.80	2.64	3.40	2.67	6	1	9	12	1	9	18	2	18	0	16	0	18	1	3	1	2	1	2	1	-1	-1	0.15	-0.05	-0.13
2139456	2024-07-05 08:30:00	12	3	2.26	3.70	2.97	2.40	3.65	2.77	1	1	9	3	0	3	4	1	12	8	11	0	12	2	3	1	2	1	3	1	-1	-1	0.14	-0.05	-0.20
2139457	2024-07-05 09:30:00	12	3	1.59	4.35	5.30	1.57	4.45	5.40	4	2	4	2	4	5	6	6	9	5	5	2	11	2	2	1	1	1	3	-1	1	1	-0.02	0.10	0.10
2139458	2024-07-05 10:30:00	12	0	2.94	3.90	2.20	2.82	4.05	2.23	19	5	13	17	8	10	36	13	23	0	23	13	36	1	3	2	3	1	2	-1	1	1	-0.12	0.15	0.03
2139460	2024-07-07 07:30:00	12	1	2.72	3.50	2.34	2.81	3.70	2.36	3	2	4	5	3	4	8	5	8	3	6	3	11	1	3	1	2	1	2	1	1	1	0.09	0.20	0.02
1943928	2023-09-25 01:00:00	12	3	1.45	4.75	6.90	1.42	4.85	7.30	4	1	3	1	4	6	5	5	9	5	5	1	10	2	2	1	1	1	3	-1	1	1	-0.03	0.10	0.40
2139465	2024-07-07 09:30:00	12	3	1.56	4.45	5.50	1.52	4.60	5.70	2	1	5	2	4	4	4	5	9	8	7	3	12	3	2	1	1	2	3	-1	1	1	-0.04	0.15	0.20
1943927	2023-09-24 07:30:00	12	1	2.19	3.70	3.10	2.14	3.70	3.20	2	0	2	3	1	3	5	1	5	0	4	0	5	1	3	1	2	1	2	-1	0	1	-0.05	0.00	0.10
2139466	2024-07-07 10:30:00	12	3	1.55	4.25	5.90	1.50	4.50	6.30	6	7	10	4	13	9	10	20	19	14	4	5	24	3	1	2	1	3	2	-1	1	1	-0.05	0.25	0.40
2139467	2024-09-08 08:30:00	12	1	2.00	3.75	3.50	2.02	3.80	3.45	17	11	10	12	12	9	29	23	19	16	22	26	45	1	2	3	3	2	1	1	1	-1	0.02	0.05	-0.05
1943920	2023-09-17 07:30:00	12	1	1.80	3.95	4.15	1.85	3.90	3.95	1	1	2	2	1	2	3	2	4	1	2	0	4	2	3	1	2	1	3	1	-1	-1	0.05	-0.05	-0.20
2139470	2024-07-08 10:30:00	12	3	1.82	3.95	4.05	1.89	3.90	3.75	6	6	8	7	5	4	13	11	12	3	5	4	16	1	3	2	3	1	2	1	-1	-1	0.07	-0.05	-0.30
1943919	2023-09-10 10:30:00	12	3	2.72	3.70	2.42	2.76	3.75	2.38	4	3	1	4	3	1	8	6	2	0	2	6	8	1	2	3	3	2	1	1	1	-1	0.04	0.05	-0.04
2139474	2024-07-14 07:30:00	12	3	1.92	3.55	3.60	2.01	3.70	3.55	6	2	8	12	2	7	18	4	15	1	15	4	19	1	3	2	3	1	2	1	1	-1	0.09	0.15	-0.05
2139476	2024-07-14 07:30:00	12	3	2.30	3.55	2.77	2.40	3.75	2.72	4	2	5	3	3	6	7	5	11	4	6	0	11	2	3	1	2	1	3	1	1	-1	0.10	0.20	-0.05
1943915	2023-09-03 08:30:00	12	1	2.33	3.55	2.94	2.36	3.60	2.87	1	1	4	3	3	1	4	4	5	3	3	2	7	2	2	1	1	1	3	1	1	-1	0.03	0.05	-0.07
2139478	2024-07-14 08:30:00	12	0	2.45	3.45	2.63	2.83	3.45	2.46	10	3	17	20	4	11	30	7	28	4	27	6	34	1	3	2	3	1	2	1	0	-1	0.38	0.00	-0.17
1943914	2023-09-03 07:30:00	12	0	2.65	3.70	2.49	2.76	3.70	2.40	2	0	3	5	1	3	7	1	6	0	6	1	7	1	3	2	3	1	2	1	0	-1	0.11	0.00	-0.09
2139479	2024-07-14 08:30:00	12	1	2.42	3.55	2.60	2.47	3.70	2.67	0	0	5	3	1	2	3	1	7	4	6	0	7	2	3	1	2	1	3	1	1	1	0.05	0.15	0.07
1943908	2023-10-15 10:30:00	12	1	2.46	3.95	2.56	2.26	3.95	2.83	7	10	17	6	10	18	13	20	35	23	16	1	36	3	2	1	1	2	3	-1	0	1	-0.20	0.00	0.27
2139483	2024-07-14 09:30:00	12	1	2.12	3.60	3.05	2.09	3.70	3.35	4	1	4	4	4	5	8	5	9	4	7	3	12	2	3	1	2	1	3	-1	1	1	-0.03	0.10	0.30
2139484	2024-07-14 10:30:00	12	0	1.82	3.95	3.60	1.79	4.05	4.10	10	5	9	11	7	8	21	12	17	1	10	5	22	1	3	2	3	1	2	-1	1	1	-0.03	0.10	0.50
1943904	2023-07-16 09:30:00	12	3	2.09	3.55	3.45	2.04	3.60	3.55	3	0	3	5	1	3	8	1	6	0	7	2	8	1	3	2	3	1	2	-1	1	1	-0.05	0.05	0.10
2139485	2024-07-14 10:25:00	12	3	2.28	3.70	2.68	2.16	3.95	3.00	3	0	4	2	3	4	5	3	8	4	6	1	9	2	3	1	2	1	3	-1	1	1	-0.12	0.25	0.32
1943907	2023-08-21 08:30:00	12	3	1.84	3.80	4.15	1.83	3.85	4.10	2	2	5	3	4	3	5	6	8	3	2	0	8	3	2	1	1	2	3	-1	1	-1	-0.01	0.05	-0.05
2139487	2024-07-18 07:30:00	12	1	2.26	3.65	3.00	2.47	3.75	2.63	0	2	17	3	5	7	3	7	24	22	18	1	25	3	2	1	1	2	3	1	1	-1	0.21	0.10	-0.37
1943965	2023-07-02 08:30:00	12	3	1.94	3.60	3.90	1.93	3.65	3.90	3	3	2	2	3	5	5	6	7	5	4	3	10	3	2	1	1	2	3	-1	1	0	-0.01	0.05	0.00
1943964	2023-07-02 08:30:00	12	3	1.95	3.85	3.60	1.94	3.80	3.70	5	6	7	5	5	10	10	11	17	10	9	3	20	3	2	1	1	2	3	-1	-1	1	-0.01	-0.05	0.10
1943967	2023-07-09 07:30:00	12	0	2.36	3.55	2.68	2.51	3.65	2.65	2	0	7	6	2	3	8	2	10	2	8	0	10	2	3	1	2	1	3	1	1	-1	0.15	0.10	-0.03
1943966	2023-07-02 10:30:00	12	1	2.19	3.70	3.10	2.29	3.70	2.92	2	1	4	4	1	3	6	2	7	2	6	1	8	2	3	1	2	1	3	1	0	-1	0.10	0.00	-0.18
1943961	2023-06-25 09:30:00	12	1	2.16	3.55	3.25	2.16	3.75	3.15	0	0	4	0	4	1	0	4	5	6	2	1	6	3	2	1	1	2	3	0	1	-1	0.00	0.20	-0.10
1943960	2023-06-25 08:30:00	12	0	1.74	3.85	4.65	1.74	3.95	4.50	0	6	8	0	6	7	0	12	15	15	3	0	15	3	2	1	1	2	3	0	1	-1	0.00	0.10	-0.15
1943963	2023-07-02 07:30:00	12	0	2.33	3.35	2.82	2.31	3.40	3.10	1	2	1	1	1	3	2	3	4	2	1	0	4	3	2	1	1	2	3	-1	1	1	-0.02	0.05	0.28
1943962	2023-06-25 10:30:00	12	0	1.59	4.20	5.50	1.60	4.20	5.30	0	2	4	1	3	1	1	5	5	4	0	0	5	3	1	1	1	2	2	1	0	-1	0.01	0.00	-0.20
2139559	2024-09-15 10:30:00	12	3	2.60	3.85	2.47	2.70	3.85	2.38	3	0	5	5	0	3	8	0	8	0	8	0	8	1	3	1	2	1	2	1	0	-1	0.10	0.00	-0.09
1943957	2023-06-22 10:30:00	12	3	1.88	3.75	4.00	1.84	3.75	4.20	8	3	4	6	4	7	14	7	11	3	10	6	17	1	3	2	3	1	2	-1	0	1	-0.04	0.00	0.20
2139560	2024-09-16 07:15:00	12	3	1.60	4.15	5.40	1.57	4.25	5.70	1	0	0	0	1	1	1	1	1	1	1	1	2	1	1	1	1	1	1	-1	1	1	-0.03	0.10	0.30
1943959	2023-06-25 07:30:00	12	1	1.92	3.60	3.95	1.90	3.75	3.90	4	0	2	2	2	3	6	2	5	1	5	2	7	1	3	2	3	1	2	-1	1	-1	-0.02	0.15	-0.05
1943958	2023-06-25 07:30:00	12	3	2.14	3.55	3.05	2.17	3.65	3.20	0	3	3	1	4	3	1	7	6	8	2	3	9	3	1	2	1	3	2	1	1	1	0.03	0.10	0.15
1943953	2023-06-18 08:30:00	12	0	2.42	3.55	2.81	2.38	3.55	2.87	1	2	2	0	1	3	1	3	5	4	2	0	5	3	2	1	1	2	3	-1	0	1	-0.04	0.00	0.06
1943952	2023-06-11 08:30:00	12	3	2.86	3.40	2.29	3.05	3.60	2.26	2	1	2	4	3	1	6	4	3	2	4	5	8	1	2	3	3	2	1	1	1	-1	0.19	0.20	-0.03
1943954	2023-06-22 07:30:00	12	3	2.65	3.50	2.57	2.76	3.45	2.51	7	3	9	12	3	10	19	6	19	1	14	1	20	1	3	1	2	1	2	1	-1	-1	0.11	-0.05	-0.06
1943949	2023-06-11 07:30:00	12	3	1.82	3.75	3.75	1.95	3.70	3.75	3	3	7	7	1	3	10	4	10	1	7	1	11	1	3	1	2	1	2	1	-1	0	0.13	-0.05	0.00
1943948	2023-06-08 10:30:00	12	1	1.67	4.00	4.95	1.67	4.05	4.90	0	1	1	0	1	1	0	2	2	2	0	0	2	3	1	1	1	2	2	0	1	-1	0.00	0.05	-0.05
1943951	2023-06-11 07:30:00	12	3	1.46	4.40	5.90	1.44	4.75	7.00	9	6	8	7	9	9	16	15	17	1	2	0	17	2	3	1	2	1	3	-1	1	1	-0.02	0.35	1.10
1943950	2023-06-11 07:30:00	12	3	2.17	3.30	3.20	2.57	3.40	2.73	5	2	7	4	3	8	9	5	15	7	11	1	16	2	3	1	2	1	3	1	1	-1	0.40	0.10	-0.47
2130360	2023-12-03 07:00:00	12	1	2.19	3.60	3.20	2.28	3.55	3.05	3	1	4	4	1	5	7	2	9	2	7	0	9	2	3	1	2	1	3	1	-1	-1	0.09	-0.05	-0.15
2130361	2023-12-03 10:30:00	12	3	1.61	3.80	6.00	1.67	3.75	5.50	1	3	5	3	1	2	4	4	7	5	5	2	9	2	2	1	1	1	3	1	-1	-1	0.06	-0.05	-0.50
2139583	2024-09-22 09:30:00	12	1	1.81	4.30	3.80	1.83	4.30	3.70	2	3	2	3	3	1	5	6	3	5	4	7	10	2	1	3	2	3	1	1	0	-1	0.02	0.00	-0.10
1943997	2023-09-10 07:30:00	12	1	1.77	3.80	4.50	1.70	4.05	4.65	5	3	6	1	7	9	6	10	15	11	7	2	17	3	2	1	1	2	3	-1	1	1	-0.07	0.25	0.15
1943998	2023-09-10 07:30:00	12	3	2.11	3.70	3.25	2.17	3.45	3.35	3	7	8	6	5	9	9	12	17	14	11	6	23	3	2	1	1	2	3	1	-1	1	0.06	-0.25	0.10
1943995	2023-09-04 10:00:00	12	0	1.97	3.85	3.55	1.93	3.90	3.60	10	5	9	10	6	10	20	11	19	3	12	4	23	1	3	2	3	1	2	-1	1	1	-0.04	0.05	0.05
2139526	2024-08-25 10:30:00	12	3	1.67	4.45	4.45	1.75	4.30	4.05	2	6	9	4	4	7	6	10	16	15	11	5	21	3	2	1	1	2	3	1	-1	-1	0.08	-0.15	-0.40
1943988	2023-08-31 07:30:00	12	1	1.52	4.50	5.80	1.54	4.40	5.70	13	13	19	11	13	21	24	26	40	20	18	4	44	3	2	1	1	2	3	1	-1	-1	0.02	-0.10	-0.10
1943990	2023-08-31 07:30:00	12	3	1.71	3.85	4.85	1.74	3.80	4.70	3	1	2	2	1	3	5	2	5	0	3	0	5	1	3	1	2	1	2	1	-1	-1	0.03	-0.05	-0.15
1943985	2023-08-27 07:30:00	12	0	2.40	3.65	2.78	2.40	3.60	2.80	3	2	4	4	2	6	7	4	10	3	6	0	10	2	3	1	2	1	3	0	-1	1	0.00	-0.05	0.02
1943980	2023-10-19 08:00:00	12	1	2.44	3.70	2.71	2.79	3.65	2.40	18	4	25	28	3	19	46	7	44	6	45	8	52	1	3	2	3	1	2	1	-1	-1	0.35	-0.05	-0.31
2139539	2024-09-01 10:30:00	12	0	1.64	4.20	5.00	1.69	4.10	4.65	4	7	6	6	4	4	10	11	10	4	3	4	14	2	1	2	1	3	1	1	-1	-1	0.05	-0.10	-0.35
1943977	2023-07-16 09:30:00	12	1	2.17	3.50	3.30	2.26	3.40	3.15	1	3	2	3	2	3	4	5	5	4	3	3	8	3	1	1	1	2	2	1	-1	-1	0.09	-0.10	-0.15
2139540	2024-09-01 10:30:00	12	3	2.23	3.70	3.05	2.46	3.50	2.80	2	8	7	6	5	8	8	13	15	15	10	8	23	3	2	1	1	2	3	1	-1	-1	0.23	-0.20	-0.25
1943976	2023-07-16 08:30:00	12	1	2.61	3.70	2.53	2.37	3.70	2.79	5	1	2	3	2	6	8	3	8	0	5	0	8	1	3	1	2	1	2	-1	0	1	-0.24	0.00	0.26
1943979	2023-08-21 07:30:00	12	3	1.82	3.60	4.45	1.86	3.50	4.45	1	3	2	2	3	4	3	6	6	4	1	1	7	3	1	1	1	2	2	1	-1	0	0.04	-0.10	0.00
2107798	2023-10-08 07:30:00	12	1	1.74	3.85	4.65	1.81	3.75	4.30	6	5	7	7	4	7	13	9	14	1	5	0	14	2	3	1	2	1	3	1	-1	-1	0.07	-0.10	-0.35
1943978	2023-07-16 10:30:00	12	3	1.82	4.05	3.95	1.88	4.15	3.60	1	2	6	3	4	3	4	6	9	5	3	0	9	3	2	1	1	2	3	1	1	-1	0.06	0.10	-0.35
2107799	2023-10-08 07:30:00	12	0	1.97	3.75	3.60	2.11	3.85	3.15	3	3	9	7	5	4	10	8	13	3	5	0	13	2	3	1	2	1	3	1	1	-1	0.14	0.10	-0.45
1943973	2023-07-09 08:30:00	12	3	2.44	3.40	2.90	2.49	3.35	2.86	6	7	10	8	6	12	14	13	22	9	10	1	23	2	3	1	2	1	3	1	-1	-1	0.05	-0.05	-0.04
1943972	2023-07-16 07:30:00	12	3	1.95	3.60	3.85	1.88	3.65	4.10	4	1	1	3	3	4	7	4	5	0	3	2	7	1	3	2	3	1	2	-1	1	1	-0.07	0.05	0.25
2139545	2024-09-08 07:30:00	12	1	1.66	4.10	4.90	1.71	4.05	4.55	1	3	6	3	3	3	4	6	9	7	5	2	11	3	2	1	1	2	3	1	-1	-1	0.05	-0.05	-0.35
1943975	2023-07-16 07:30:00	12	3	2.17	3.75	3.10	2.28	3.70	2.94	4	4	10	6	4	9	10	8	19	9	11	0	19	2	3	1	2	1	3	1	-1	-1	0.11	-0.05	-0.16
1943974	2023-07-16 07:30:00	12	3	2.17	3.55	3.25	2.08	3.55	3.50	4	1	3	3	2	6	7	3	9	2	6	0	9	2	3	1	2	1	3	-1	0	1	-0.09	0.00	0.25
1943969	2023-07-09 08:30:00	12	1	2.17	3.65	3.20	2.13	3.60	3.30	1	1	0	0	1	3	1	2	3	2	1	0	3	3	2	1	1	2	3	-1	-1	1	-0.04	-0.05	0.10
1943968	2023-07-13 08:30:00	12	3	1.78	3.80	4.40	1.78	3.85	4.40	1	1	2	2	1	1	3	2	3	1	2	1	4	1	3	1	2	1	2	0	1	0	0.00	0.05	0.00
1943971	2023-07-09 10:30:00	12	1	1.44	4.75	6.80	1.41	4.90	7.20	4	2	2	2	4	4	6	6	6	2	2	2	8	1	1	1	1	1	1	-1	1	1	-0.03	0.15	0.40
1943970	2023-07-09 07:30:00	12	1	1.51	4.40	6.30	1.50	4.40	6.30	3	2	4	4	3	4	7	5	8	1	3	0	8	2	3	1	2	1	3	-1	0	0	-0.01	0.00	0.00
1944024	2023-08-21 07:30:00	12	0	1.86	3.75	4.05	1.88	3.85	3.90	2	2	7	4	5	3	6	7	10	4	3	0	10	3	2	1	1	2	3	1	1	-1	0.02	0.10	-0.15
1944020	2023-07-09 07:30:00	12	1	2.53	3.50	2.72	2.47	3.45	2.80	3	3	6	5	3	4	8	6	10	2	4	0	10	2	3	1	2	1	3	-1	-1	1	-0.06	-0.05	0.08
1944023	2023-07-09 10:30:00	12	0	2.21	3.50	3.20	2.21	3.55	3.20	1	0	0	0	1	1	1	1	1	1	1	1	2	1	1	1	1	1	1	0	1	0	0.00	0.05	0.00
1944022	2023-07-09 07:30:00	12	3	1.77	3.60	4.20	1.78	3.75	4.50	2	1	6	5	4	3	7	5	9	3	5	1	10	2	3	1	2	1	3	1	1	1	0.01	0.15	0.30
1944014	2023-10-01 07:30:00	12	1	2.11	3.70	3.25	2.14	3.65	3.20	1	1	2	2	1	2	3	2	4	1	2	0	4	2	3	1	2	1	3	1	-1	-1	0.03	-0.05	-0.05
1944001	2023-09-17 05:00:00	12	3	2.48	3.75	2.43	2.21	3.80	2.99	12	2	9	9	2	13	21	4	22	1	18	0	22	2	3	1	2	1	3	-1	1	1	-0.27	0.05	0.56
2139647	2024-04-14 04:45:00	12	1	2.79	3.60	2.26	2.73	3.65	2.28	4	0	0	1	1	2	5	1	2	0	4	3	5	1	3	2	3	1	2	-1	1	1	-0.06	0.05	0.02
2139587	2024-09-23 06:15:00	12	3	1.87	4.00	3.35	1.96	4.00	3.45	4	4	4	5	4	3	9	8	7	2	3	4	11	1	2	3	3	2	1	1	0	1	0.09	0.00	0.10
2139588	2024-09-29 07:30:00	12	0	1.91	3.80	3.45	1.93	3.85	3.65	4	1	3	6	3	4	10	4	7	2	8	5	12	1	3	2	3	1	2	1	1	1	0.02	0.05	0.20
2139593	2024-09-29 07:30:00	12	1	1.64	4.45	4.65	1.65	4.50	4.50	1	4	5	2	5	4	3	9	9	6	0	0	9	3	1	1	1	2	2	1	1	-1	0.01	0.05	-0.15
1944032	2023-09-03 03:30:00	12	1	1.94	3.70	3.40	2.00	3.75	3.55	1	1	1	2	2	2	3	3	3	0	0	0	3	1	1	1	1	1	1	1	1	1	0.06	0.05	0.15
1944034	2023-09-17 03:30:00	12	1	2.14	3.40	3.45	2.19	3.40	3.35	0	1	1	1	2	1	1	3	2	2	0	1	3	3	1	2	1	3	2	1	0	-1	0.05	0.00	-0.10
2058239	2023-07-26 08:30:00	13	3	2.52	2.91	2.63	2.48	2.79	2.95	13	11	7	11	5	16	24	16	23	2	10	3	26	1	3	2	3	1	2	-1	-1	1	-0.04	-0.12	0.32
2058237	2023-07-27 08:30:00	13	0	2.40	3.25	2.83	2.40	3.25	2.83	14	6	13	17	6	18	31	12	31	2	21	2	33	1	3	1	2	1	2	0	0	0	0.00	0.00	0.00
2012730	2023-06-02 07:00:00	13	3	2.11	3.25	2.93	2.22	3.45	2.96	14	9	16	12	12	11	26	21	27	5	10	4	31	2	3	1	2	1	3	1	1	1	0.11	0.20	0.03
2095544	2023-09-18 03:00:00	13	0	1.84	3.40	3.55	1.84	3.30	3.95	3	5	3	2	4	7	5	9	10	7	3	2	12	3	2	1	1	2	3	0	-1	1	0.00	-0.10	0.40
2025482	2023-07-13 08:30:00	13	0	2.64	3.20	2.56	2.32	3.30	2.90	16	3	12	11	4	17	27	7	29	4	24	2	31	2	3	1	2	1	3	-1	1	1	-0.32	0.10	0.34
2025480	2023-07-14 07:00:00	13	0	1.59	3.55	5.20	1.64	3.75	4.90	2	4	4	4	2	2	6	6	6	6	6	6	12	1	1	1	1	1	1	1	1	-1	0.05	0.20	-0.30
2025481	2023-07-06 08:30:00	13	3	1.54	3.85	6.00	1.68	3.85	5.10	3	12	17	7	13	13	10	25	30	26	11	6	36	3	2	1	1	2	3	1	0	-1	0.14	0.00	-0.90
2025478	2023-07-16 03:30:00	13	3	1.65	3.50	4.80	1.72	3.45	4.80	0	2	3	2	2	2	2	4	5	3	1	0	5	3	2	1	1	2	3	1	-1	0	0.07	-0.05	0.00
2058247	2023-08-17 08:30:00	13	3	1.93	3.45	3.45	2.02	3.45	3.35	16	11	15	15	10	16	31	21	31	12	22	12	43	1	3	1	2	1	2	1	0	-1	0.09	0.00	-0.10
2025479	2023-07-06 06:30:00	13	3	2.84	3.15	2.44	2.77	3.25	2.63	21	15	18	24	17	14	45	32	32	3	16	16	48	1	2	2	3	1	1	-1	1	1	-0.07	0.10	0.19
2058246	2023-08-17 06:30:00	13	3	1.71	3.35	4.60	1.72	3.40	4.90	4	3	6	4	3	11	8	6	17	9	11	0	17	2	3	1	2	1	3	1	1	1	0.01	0.05	0.30
2025476	2023-07-13 06:00:00	13	1	1.48	4.20	6.10	1.46	4.30	6.20	2	3	5	3	5	7	5	8	12	8	5	1	13	3	2	1	1	2	3	-1	1	1	-0.02	0.10	0.10
2025477	2023-07-06 08:30:00	13	3	2.17	3.15	3.35	2.06	3.15	4.00	12	10	10	9	6	17	21	16	27	9	14	3	30	2	3	1	2	1	3	-1	0	1	-0.11	0.00	0.65
2100348	2023-09-25 03:00:00	13	1	2.28	3.00	3.05	2.33	3.10	3.05	0	2	3	3	1	1	3	3	4	2	2	1	5	2	2	1	1	1	3	1	1	0	0.05	0.10	0.00
2202671	2024-05-08 03:00:00	14	0	1.47	4.45	5.50	1.45	4.80	6.60	24	18	20	19	26	28	43	44	48	25	24	20	68	3	2	1	1	2	3	-1	1	1	-0.02	0.35	1.10
2202670	2024-05-02 03:00:00	14	3	2.60	3.70	2.36	2.72	3.75	2.40	9	2	9	13	3	5	22	5	14	4	21	12	26	1	3	2	3	1	2	1	1	1	0.12	0.05	0.04
2057228	2023-08-03 01:00:00	14	3	1.40	4.20	6.00	1.41	4.05	6.00	1	3	2	2	0	2	3	3	4	1	1	0	4	2	2	1	1	1	3	1	-1	0	0.01	-0.15	0.00
2057224	2023-08-02 02:00:00	14	3	3.30	3.20	1.98	3.30	3.25	1.97	0	0	2	1	1	0	1	1	2	1	1	0	2	2	2	1	1	1	3	0	1	-1	0.00	0.05	-0.01
2057223	2023-08-03 01:00:00	14	3	1.22	5.40	9.00	1.19	5.70	9.10	4	3	5	4	3	3	8	6	8	0	2	0	8	1	3	1	2	1	2	-1	1	1	-0.03	0.30	0.10
2291770	2025-01-23 04:00:00	14	3	1.44	4.35	5.80	1.54	4.25	6.00	8	12	13	10	8	10	18	20	23	10	8	5	28	3	2	1	1	2	3	1	-1	1	0.10	-0.10	0.20
2057222	2023-08-03 01:00:00	14	1	1.27	5.30	7.10	1.26	5.30	7.50	3	2	3	2	2	4	5	4	7	2	3	0	7	2	3	1	2	1	3	-1	0	1	-0.01	0.00	0.40
2070534	2023-08-10 02:30:00	14	0	3.05	3.10	2.13	3.15	3.30	2.19	3	0	1	3	3	2	6	3	3	1	4	4	7	1	2	2	3	1	1	1	1	1	0.10	0.20	0.06
2291771	2024-09-18 03:00:00	14	0	3.20	3.60	1.96	3.50	3.85	1.99	10	1	11	8	3	14	18	4	25	12	26	5	30	2	3	1	2	1	3	1	1	1	0.30	0.25	0.03
2057220	2023-07-27 01:00:00	14	3	2.85	3.00	2.28	2.82	3.00	2.31	2	0	0	0	0	2	2	0	2	0	2	0	2	1	3	1	2	1	2	-1	0	1	-0.03	0.00	0.03
2291769	2024-12-12 04:00:00	14	3	1.29	5.80	7.40	1.27	6.40	9.90	9	12	16	7	16	21	16	28	37	29	17	8	45	3	2	1	1	2	3	-1	1	1	-0.02	0.60	2.50
2070531	2023-08-10 02:45:00	14	3	1.43	4.15	5.50	1.54	4.25	5.10	2	2	4	4	3	1	6	5	5	2	3	3	8	1	2	2	3	1	1	1	1	-1	0.11	0.10	-0.40
2058242	2023-08-02 22:00:00	14	0	3.55	3.25	1.88	3.55	3.25	1.88	0	0	1	1	0	0	1	0	1	0	1	0	1	1	3	1	2	1	2	0	0	0	0.00	0.00	0.00
2070530	2023-08-09 02:45:00	14	3	4.35	3.50	1.66	5.00	3.65	1.65	1	1	4	4	3	1	5	4	5	0	1	0	5	1	3	1	2	1	2	1	1	-1	0.65	0.15	-0.01
2057216	2023-07-27 02:45:00	14	1	1.51	3.80	5.40	1.48	3.85	5.40	2	2	3	2	2	3	4	4	6	2	2	0	6	2	2	1	1	1	3	-1	1	0	-0.03	0.05	0.00
2291773	2024-12-12 04:00:00	14	3	1.34	5.30	6.70	1.29	5.70	10.00	7	2	8	5	4	9	12	6	17	5	11	0	17	2	3	1	2	1	3	-1	1	1	-0.05	0.40	3.30
2135556	2024-02-21 04:00:00	14	1	2.14	3.55	3.00	2.16	3.75	3.10	2	4	5	4	5	3	6	9	8	9	6	7	15	3	1	2	1	3	2	1	1	1	0.02	0.20	0.10
2135557	2024-02-21 04:00:00	14	3	1.82	3.40	4.25	1.81	3.50	4.70	9	3	10	7	4	12	16	7	22	8	17	2	24	2	3	1	2	1	3	-1	1	1	-0.01	0.10	0.45
2135559	2024-02-22 04:00:00	14	1	2.70	3.25	2.49	2.91	3.55	2.36	9	2	8	16	3	4	25	5	12	0	20	13	25	1	3	2	3	1	2	1	1	-1	0.21	0.30	-0.13
2135560	2024-02-22 04:00:00	14	3	5.00	3.55	1.67	5.40	3.80	1.66	7	1	4	8	3	2	15	4	6	2	13	11	17	1	3	2	3	1	2	1	1	-1	0.40	0.25	-0.01
2135561	2024-03-06 04:00:00	14	3	1.26	5.20	9.20	1.29	5.70	10.00	9	7	14	10	9	13	19	16	27	16	19	8	35	2	3	1	2	1	3	1	1	1	0.03	0.50	0.80
2135563	2024-03-07 04:00:00	14	3	1.11	7.70	15.00	1.13	8.60	20.00	6	10	7	7	12	8	13	22	15	16	7	14	29	3	1	2	1	3	2	1	1	1	0.02	0.90	5.00
2135565	2024-03-07 04:00:00	14	1	1.51	4.15	5.20	1.55	4.40	5.50	1	4	3	2	3	5	3	7	8	7	3	2	10	3	2	1	1	2	3	1	1	1	0.04	0.25	0.30
2135567	2024-03-14 04:00:00	14	3	2.09	3.70	2.84	2.21	3.80	3.00	19	4	12	15	5	12	34	9	24	3	28	13	37	1	3	2	3	1	2	1	1	1	0.12	0.10	0.16
2135568	2024-03-06 04:00:00	14	0	2.51	3.25	2.54	2.49	3.45	2.80	8	2	17	8	3	22	16	5	39	23	34	0	39	2	3	1	2	1	3	-1	1	1	-0.02	0.20	0.26
2135569	2024-03-14 04:00:00	14	3	2.96	3.35	2.42	2.89	3.45	2.42	19	7	13	21	10	13	40	17	26	3	26	17	43	1	3	2	3	1	2	-1	1	0	-0.07	0.10	0.00
2135570	2024-03-13 04:00:00	14	3	1.22	5.60	10.00	1.23	6.10	13.00	12	13	6	13	15	8	25	28	14	19	16	30	44	2	1	3	2	3	1	1	1	1	0.01	0.50	3.00
2135571	2024-03-13 04:00:00	14	3	1.90	3.60	3.35	1.80	3.95	4.15	20	3	10	9	7	17	29	10	27	5	24	7	34	1	3	2	3	1	2	-1	1	1	-0.10	0.35	0.80
2092639	2023-09-21 00:45:00	14	3	1.38	4.95	8.20	1.39	4.85	8.20	5	5	6	6	5	8	11	10	14	4	5	1	15	2	3	1	2	1	3	1	-1	0	0.01	-0.10	0.00
2092638	2023-12-13 04:00:00	14	3	1.48	4.60	6.40	1.51	4.55	6.10	2	3	5	6	3	3	8	6	8	3	5	3	11	1	3	1	2	1	2	1	-1	-1	0.03	-0.05	-0.30
2263651	2024-08-07 01:00:00	14	1	2.17	3.35	2.78	2.21	3.40	3.00	6	2	4	4	4	7	10	6	11	3	7	2	13	2	3	1	2	1	3	1	1	1	0.04	0.05	0.22
2092637	2023-11-30 04:00:00	14	1	2.11	3.45	3.15	2.06	3.65	3.40	3	0	0	0	1	3	3	1	3	1	3	1	4	1	3	1	2	1	2	-1	1	1	-0.05	0.20	0.25
2263648	2024-08-14 01:00:00	14	3	1.39	4.60	5.60	1.43	4.45	5.10	7	9	8	8	8	7	15	17	15	7	5	7	22	2	1	2	1	3	1	1	-1	-1	0.04	-0.15	-0.50
2263649	2024-08-08 02:45:00	14	0	2.66	3.40	2.23	2.72	3.65	2.28	5	2	1	3	4	2	8	6	3	0	2	5	8	1	2	3	3	2	1	1	1	1	0.06	0.25	0.05
2291809	2024-12-11 04:00:00	14	3	3.30	3.70	1.98	4.30	3.80	1.81	21	14	21	21	14	21	42	28	42	7	21	7	49	1	3	1	2	1	2	1	1	-1	1.00	0.10	-0.17
2263654	2024-08-14 01:30:00	14	1	1.87	3.45	3.40	1.91	3.45	3.25	8	5	8	9	5	7	17	10	15	0	7	2	17	1	3	2	3	1	2	1	0	-1	0.04	0.00	-0.15
2263655	2024-08-14 01:00:00	14	3	1.77	3.60	3.65	1.84	3.50	3.45	17	10	15	14	9	20	31	19	35	5	17	1	36	2	3	1	2	1	3	1	-1	-1	0.07	-0.10	-0.20
2291812	2024-11-28 04:00:00	14	1	2.03	3.70	3.15	2.11	3.75	3.25	6	3	9	12	4	6	18	7	15	7	18	10	25	1	3	2	3	1	2	1	1	1	0.08	0.05	0.10
2263653	2024-08-07 02:30:00	14	3	2.07	3.20	3.05	2.21	3.20	3.15	4	4	8	3	3	6	7	7	14	13	13	6	20	2	2	1	1	1	3	1	0	1	0.14	0.00	0.10
2092631	2023-11-09 04:00:00	14	3	1.28	5.40	8.80	1.32	5.30	9.80	4	5	11	7	5	8	11	10	19	9	10	1	20	2	3	1	2	1	3	1	-1	1	0.04	-0.10	1.00
2291818	2025-01-22 04:00:00	14	1	2.83	3.25	2.28	3.10	3.25	2.38	4	2	2	5	1	4	9	3	6	0	6	3	9	1	3	2	3	1	2	1	0	1	0.27	0.00	0.10
2092630	2023-09-21 03:00:00	14	1	1.88	3.45	3.85	1.91	3.45	4.25	11	5	12	13	4	12	24	9	24	3	18	3	27	1	3	1	2	1	2	1	0	1	0.03	0.00	0.40
2291819	2024-12-11 04:00:00	14	3	2.92	3.70	2.29	2.76	3.55	2.47	11	4	0	11	3	4	22	7	4	0	15	18	22	1	2	3	3	2	1	-1	-1	1	-0.16	-0.15	0.18
2092629	2023-11-30 04:00:00	14	3	1.31	4.90	8.70	1.33	5.20	9.40	2	2	3	2	3	3	4	5	6	3	2	1	7	3	2	1	1	2	3	1	1	1	0.02	0.30	0.70
2092628	2023-11-30 01:45:00	14	0	2.65	3.35	2.47	2.53	3.65	2.63	4	1	2	6	3	2	10	4	4	0	6	6	10	1	2	2	3	1	1	-1	1	1	-0.12	0.30	0.16
2092627	2023-11-09 04:00:00	14	3	1.73	3.90	4.10	1.74	4.00	4.45	2	1	1	1	3	3	3	4	4	1	0	0	4	3	1	1	1	2	2	1	1	1	0.01	0.10	0.35
2291822	2024-09-20 00:45:00	14	0	3.20	3.50	1.99	3.60	3.70	2.00	4	2	7	6	3	5	10	5	12	4	9	2	14	2	3	1	2	1	3	1	1	1	0.40	0.20	0.01
2092626	2023-10-25 03:00:00	14	0	4.35	3.80	1.79	4.50	3.90	1.75	4	0	7	7	3	4	11	3	11	1	9	1	12	1	3	1	2	1	2	1	1	-1	0.15	0.10	-0.04
2291823	2025-01-22 04:00:00	14	0	4.30	4.00	1.76	4.30	4.15	1.74	6	3	5	6	6	5	12	9	10	2	5	4	14	1	3	2	3	1	2	0	1	-1	0.00	0.15	-0.02
2092625	2023-09-21 03:00:00	14	3	1.35	4.85	7.50	1.39	4.95	7.70	5	3	5	5	5	5	10	8	10	2	4	2	12	1	3	1	2	1	2	1	1	1	0.04	0.10	0.20
2291821	2024-11-28 01:45:00	14	3	4.00	4.05	1.72	3.90	3.80	1.88	10	8	8	9	4	12	19	12	20	2	9	1	21	2	3	1	2	1	3	-1	-1	1	-0.10	-0.25	0.16
2291827	2024-12-12 04:00:00	14	0	2.96	4.05	2.02	3.10	3.95	2.11	25	12	25	20	12	29	45	24	54	15	36	6	60	2	3	1	2	1	3	1	-1	1	0.14	-0.10	0.09
2092617	2023-10-25 03:00:00	14	3	1.34	4.95	7.60	1.33	5.40	8.70	11	8	22	10	9	14	21	17	36	15	19	0	36	2	3	1	2	1	3	-1	1	1	-0.01	0.45	1.10
2291835	2024-12-12 04:00:00	14	3	1.39	5.10	7.40	1.37	5.30	7.80	5	1	6	4	4	10	9	5	16	7	11	0	16	2	3	1	2	1	3	-1	1	1	-0.02	0.20	0.40
2092613	2023-12-13 04:00:00	14	3	2.55	3.70	2.40	2.49	3.70	2.64	20	3	7	13	4	13	33	7	20	0	26	13	33	1	3	2	3	1	2	-1	0	1	-0.06	0.00	0.24
2291832	2024-09-20 00:45:00	14	0	3.70	3.90	1.75	4.80	4.30	1.64	4	4	3	7	7	1	11	11	4	5	5	12	16	1	1	3	2	2	1	1	1	-1	1.10	0.40	-0.11
2291833	2025-01-23 04:00:00	14	3	6.40	5.00	1.35	8.00	5.40	1.36	12	6	11	17	8	11	29	14	22	2	17	9	31	1	3	2	3	1	2	1	1	1	1.60	0.40	0.01
2291839	2024-12-11 01:45:00	14	0	6.30	4.65	1.42	6.90	4.65	1.45	14	12	10	15	8	14	29	20	24	8	17	13	37	1	3	2	3	1	2	1	0	1	0.60	0.00	0.03
2291779	2024-11-28 04:00:00	14	1	2.35	3.20	2.91	2.40	3.15	3.15	1	2	4	3	1	5	4	3	9	7	8	2	11	2	3	1	2	1	3	1	-1	1	0.05	-0.05	0.24
2092669	2023-12-14 04:00:00	14	3	2.95	3.65	2.14	3.10	3.65	2.21	3	1	1	2	1	3	5	2	4	2	5	3	7	1	3	2	3	1	2	1	0	1	0.15	0.00	0.07
2092667	2023-10-26 03:00:00	14	1	3.75	3.45	1.91	4.25	3.80	1.81	10	5	13	15	6	8	25	11	21	3	17	7	28	1	3	2	3	1	2	1	1	-1	0.50	0.35	-0.10
2291782	2024-12-11 04:00:00	14	0	2.60	3.60	2.40	2.56	3.65	2.60	6	3	6	8	2	7	14	5	13	4	13	5	18	1	3	2	3	1	2	-1	1	1	-0.04	0.05	0.20
2291783	2025-01-22 01:45:00	14	3	1.18	6.80	10.00	1.22	6.30	14.00	4	6	5	7	6	6	11	12	11	7	6	7	18	2	1	2	1	3	1	1	-1	1	0.04	-0.50	4.00
2092664	2023-12-14 04:00:00	14	3	1.59	3.90	5.10	1.61	4.00	5.60	6	4	8	8	6	6	14	10	14	2	6	2	16	1	3	1	2	1	2	1	1	1	0.02	0.10	0.50
2291781	2024-09-20 03:00:00	14	1	3.65	3.60	1.82	4.05	3.70	1.87	17	6	13	15	5	17	32	11	30	5	26	7	37	1	3	2	3	1	2	1	1	1	0.40	0.10	0.05
2291786	2024-09-20 03:00:00	14	3	1.76	3.70	3.85	1.74	4.00	4.45	8	4	4	4	6	8	12	10	12	5	7	5	17	1	3	1	2	1	2	-1	1	1	-0.02	0.30	0.60
2092662	2023-11-08 04:00:00	14	3	1.33	5.10	7.80	1.30	5.60	9.60	8	9	13	8	10	15	16	19	28	12	9	0	28	3	2	1	1	2	3	-1	1	1	-0.03	0.50	1.80
2291787	2024-12-12 01:45:00	14	3	1.07	11.00	16.00	1.06	13.00	30.00	3	2	4	1	4	9	4	6	13	14	12	5	18	3	2	1	1	2	3	-1	1	1	-0.01	2.00	14.00
2291784	2025-01-22 04:00:00	14	3	2.42	3.30	2.59	2.40	3.20	3.10	4	3	5	3	1	7	7	4	12	6	9	1	13	2	3	1	2	1	3	-1	-1	1	-0.02	-0.10	0.51
2092660	2023-11-09 04:00:00	14	0	4.95	4.10	1.58	5.10	4.05	1.65	4	4	2	5	4	5	9	8	7	0	1	2	9	1	2	3	3	2	1	1	-1	1	0.15	-0.05	0.07
2291785	2024-10-24 03:00:00	14	0	1.48	4.15	6.10	1.49	4.25	6.90	1	2	2	1	3	2	2	5	4	4	1	2	6	3	1	2	1	3	2	1	1	1	0.01	0.10	0.80
2092659	2023-11-09 01:45:00	14	3	1.77	3.55	4.30	1.80	3.65	4.50	0	2	4	1	3	3	1	5	7	7	3	1	8	3	2	1	1	2	3	1	1	1	0.03	0.10	0.20
2092658	2023-09-21 03:00:00	14	1	2.98	3.20	2.31	3.15	3.25	2.35	1	2	4	3	1	2	4	3	6	3	4	1	7	2	3	1	2	1	3	1	1	1	0.17	0.05	0.04
2291788	2024-10-24 03:00:00	14	3	2.33	3.85	2.57	2.61	4.00	2.40	0	1	5	5	1	2	5	2	7	3	6	1	8	2	3	1	2	1	3	1	1	-1	0.28	0.15	-0.17
2092656	2023-11-30 04:00:00	14	1	1.49	4.40	6.60	1.49	4.40	6.60	0	0	0	0	0	0	0	0	0	1	1	1	1	1	1	1	1	1	1	0	0	0	0.00	0.00	0.00
2291789	2024-11-27 04:00:00	14	3	1.16	8.40	15.00	1.17	8.10	14.00	3	8	6	5	8	6	8	16	12	17	9	13	25	3	1	2	1	3	2	1	-1	-1	0.01	-0.30	-1.00
2291794	2024-11-27 04:00:00	14	3	1.18	7.20	12.00	1.22	7.00	12.00	0	4	3	3	3	2	3	7	5	6	2	4	9	3	1	2	1	3	2	1	-1	0	0.04	-0.20	0.00
2291793	2024-12-11 04:00:00	14	3	2.23	3.55	2.86	2.33	3.45	3.00	2	4	8	5	3	7	7	7	15	11	11	3	18	2	2	1	1	1	3	1	-1	1	0.10	-0.10	0.14
2092651	2023-09-21 03:00:00	14	0	1.39	4.65	7.00	1.42	4.80	7.20	6	7	11	9	7	9	15	14	20	5	6	0	20	2	3	1	2	1	3	1	1	1	0.03	0.15	0.20
2291798	2025-01-22 04:00:00	14	0	3.20	3.95	2.06	2.82	3.90	2.28	12	2	10	8	2	16	20	4	26	6	22	0	26	2	3	1	2	1	3	-1	-1	1	-0.38	-0.05	0.22
2092650	2023-11-30 04:00:00	14	1	2.51	3.40	2.80	2.51	3.40	2.79	0	0	1	0	1	1	0	1	2	2	1	0	2	3	2	1	1	2	3	0	0	-1	0.00	0.00	-0.01
2291796	2024-11-07 04:00:00	14	3	1.27	5.90	8.30	1.30	6.00	9.10	8	12	20	9	10	26	17	22	46	31	26	2	48	3	2	1	1	2	3	1	1	1	0.03	0.10	0.80
2291797	2024-12-12 04:00:00	14	1	1.56	4.15	5.00	1.47	4.45	7.10	18	9	10	8	15	23	26	24	33	12	14	5	38	2	3	1	2	1	3	-1	1	1	-0.09	0.30	2.10
2092647	2023-11-30 04:00:00	14	3	1.90	3.65	3.55	1.82	3.80	4.20	4	0	1	1	2	5	5	2	6	2	5	1	7	2	3	1	2	1	3	-1	1	1	-0.08	0.15	0.65
2263643	2024-08-14 02:00:00	14	1	1.97	3.35	3.15	2.02	3.40	3.00	4	3	9	7	4	5	11	7	14	4	8	1	15	2	3	1	2	1	3	1	1	-1	0.05	0.05	-0.15
2291800	2024-11-27 04:00:00	14	3	1.60	4.50	4.30	1.56	4.60	5.20	14	12	10	10	13	14	24	25	24	7	6	7	31	2	1	2	1	3	1	-1	1	1	-0.04	0.10	0.90
2092643	2023-09-21 03:00:00	14	0	4.00	3.70	1.78	4.40	3.80	1.79	2	1	3	4	2	1	6	3	4	1	4	3	7	1	3	2	3	1	2	1	1	1	0.40	0.10	0.01
2291806	2024-11-06 04:00:00	14	0	2.60	3.45	2.66	2.52	3.55	2.69	15	5	2	15	8	5	30	13	7	1	18	24	31	1	2	3	3	2	1	-1	1	1	-0.08	0.10	0.03
2263647	2024-08-14 02:30:00	14	0	2.87	3.20	2.17	2.97	3.35	2.25	8	3	1	6	4	1	14	7	2	0	7	12	14	1	2	3	3	2	1	1	1	1	0.10	0.15	0.08
2092641	2023-11-09 04:00:00	14	3	1.25	6.40	11.00	1.23	6.60	12.00	2	3	0	3	4	2	5	7	2	2	0	5	7	2	1	3	2	3	1	-1	1	1	-0.02	0.20	1.00
2263644	2024-08-07 02:00:00	14	1	2.09	3.40	2.90	2.13	3.55	3.05	4	1	6	4	4	4	8	5	10	5	8	3	13	2	3	1	2	1	3	1	1	1	0.04	0.15	0.15
2291804	2025-01-22 04:00:00	14	3	3.30	3.50	2.16	3.25	3.45	2.21	5	4	4	5	4	6	10	8	10	4	6	4	14	1	3	1	2	1	2	-1	-1	1	-0.05	-0.05	0.05
2092640	2023-11-09 01:45:00	14	1	1.37	4.60	7.80	1.38	4.90	8.10	15	15	21	16	13	18	31	28	39	8	11	0	39	2	3	1	2	1	3	1	1	1	0.01	0.30	0.30
2263645	2024-08-14 02:45:00	14	0	1.94	3.45	3.20	2.05	3.60	3.20	13	3	17	14	4	14	27	7	31	7	27	3	34	2	3	1	2	1	3	1	1	0	0.11	0.15	0.00
2291805	2024-11-28 04:00:00	14	0	2.38	3.20	2.88	2.44	3.20	3.05	0	2	2	2	2	3	2	4	5	5	3	2	7	3	2	1	1	2	3	1	0	1	0.06	0.00	0.17
2092703	2023-12-14 04:00:00	14	3	1.42	4.50	6.70	1.49	4.25	6.70	12	20	22	19	13	21	31	33	43	19	17	7	50	3	2	1	1	2	3	1	-1	0	0.07	-0.25	0.00
2202785	2024-05-09 03:00:00	14	3	1.90	3.80	3.45	1.95	3.85	3.60	30	9	25	29	8	25	59	17	50	6	48	15	65	1	3	2	3	1	2	1	1	1	0.05	0.05	0.15
2291874	2024-10-24 03:00:00	14	0	3.60	3.95	1.82	3.95	4.00	1.82	6	3	11	10	4	5	16	7	16	4	13	4	20	1	3	1	2	1	2	1	1	0	0.35	0.05	0.00
2291875	2025-01-23 01:45:00	14	3	2.57	3.50	2.36	2.62	3.85	2.44	8	2	1	3	4	3	11	6	4	2	7	9	13	1	2	3	3	2	1	1	1	1	0.05	0.35	0.08
2291872	2024-12-11 04:00:00	14	0	2.58	3.55	2.44	2.80	3.50	2.46	0	5	9	4	5	8	4	10	17	13	7	0	17	3	2	1	1	2	3	1	-1	1	0.22	-0.05	0.02
2202786	2024-05-01 03:00:00	14	1	2.51	3.55	2.50	2.28	3.70	2.94	12	3	14	6	3	20	18	6	34	16	28	0	34	2	3	1	2	1	3	-1	1	1	-0.23	0.15	0.44
2092699	2023-11-29 04:00:00	14	3	1.49	4.20	5.90	1.47	4.40	7.00	7	6	6	8	7	8	15	13	14	5	7	6	20	1	3	2	3	1	2	-1	1	1	-0.02	0.20	1.10
2291878	2025-01-23 04:00:00	14	3	1.07	11.00	14.00	1.08	13.00	23.00	3	1	6	4	2	5	7	3	11	8	12	4	15	2	3	1	2	1	3	1	1	1	0.01	2.00	9.00
2092698	2023-10-26 00:45:00	14	3	1.20	6.00	12.00	1.21	6.80	13.00	6	5	4	5	9	5	11	14	9	5	2	7	16	2	1	3	2	3	1	1	1	1	0.01	0.80	1.00
2291879	2024-09-18 03:00:00	14	3	1.26	5.50	8.10	1.32	5.70	8.50	5	6	15	8	7	17	13	13	32	19	19	0	32	2	2	1	1	1	3	1	1	1	0.06	0.20	0.40
2291876	2024-11-06 04:00:00	14	0	1.45	4.65	6.00	1.47	4.75	6.30	11	8	14	8	13	17	19	21	31	20	18	8	39	3	2	1	1	2	3	1	1	1	0.02	0.10	0.30
2291877	2024-10-23 03:00:00	14	3	1.42	4.75	6.00	1.45	4.95	6.50	4	5	8	5	7	9	9	12	17	8	5	0	17	3	2	1	1	2	3	1	1	1	0.03	0.20	0.50
2092695	2023-11-29 04:00:00	14	3	1.32	5.10	7.90	1.36	5.20	8.10	7	4	12	8	5	11	15	9	23	12	18	4	27	2	3	1	2	1	3	1	1	1	0.04	0.10	0.20
2291883	2024-12-11 04:00:00	14	0	7.40	5.60	1.36	9.60	6.40	1.28	13	8	12	21	14	8	34	22	20	2	14	16	36	1	2	3	3	2	1	1	1	-1	2.20	0.80	-0.08
2092693	2023-10-26 03:00:00	14	0	15.00	7.30	1.18	13.00	6.80	1.21	8	7	3	6	5	7	14	12	10	9	11	13	23	1	2	3	3	2	1	-1	-1	1	-2.00	-0.50	0.03
2092691	2023-12-14 01:45:00	14	0	7.00	4.65	1.38	7.10	4.75	1.43	25	14	6	21	10	12	46	24	18	2	24	30	48	1	2	3	3	2	1	1	1	1	0.10	0.10	0.05
2092688	2023-10-26 03:00:00	14	3	1.24	6.00	9.90	1.25	6.50	10.00	7	10	7	9	9	7	16	19	14	7	4	9	23	2	1	3	2	3	1	1	1	1	0.01	0.50	0.10
2092687	2023-11-08 04:00:00	14	3	1.07	12.00	30.00	1.07	12.00	28.00	4	4	16	4	5	14	8	9	30	23	22	1	31	3	2	1	1	2	3	0	0	-1	0.00	0.00	-2.00
2083982	2023-08-24 03:00:00	14	0	2.76	3.30	2.21	2.81	3.40	2.33	10	1	9	12	2	8	22	3	17	1	20	6	23	1	3	2	3	1	2	1	1	1	0.05	0.10	0.12
2092686	2023-12-14 01:45:00	14	3	1.34	5.20	7.20	1.32	5.60	9.00	10	5	19	10	6	19	20	11	38	18	27	0	38	2	3	1	2	1	3	-1	1	1	-0.02	0.40	1.80
2083981	2023-08-24 03:00:00	14	1	2.33	3.35	2.55	2.35	3.55	2.69	6	6	12	5	9	13	11	15	25	14	10	0	25	3	2	1	1	2	3	1	1	1	0.02	0.20	0.14
2083980	2023-08-24 03:00:00	14	3	1.68	3.55	4.15	1.68	3.50	5.10	8	7	6	6	6	13	14	13	19	8	9	3	22	2	3	1	2	1	3	0	-1	1	0.00	-0.05	0.95
2092684	2023-11-29 04:00:00	14	0	2.04	3.50	3.30	2.16	3.55	3.30	2	4	9	7	4	5	9	8	14	7	8	2	16	2	3	1	2	1	3	1	1	0	0.12	0.05	0.00
2083979	2023-08-23 03:00:00	14	1	2.86	3.45	2.09	2.81	3.35	2.36	9	7	7	12	5	6	21	12	13	0	9	8	21	1	3	2	3	1	2	-1	-1	1	-0.05	-0.10	0.27
2291894	2025-01-23 04:00:00	14	0	6.60	4.70	1.36	9.00	5.10	1.34	8	3	9	12	4	6	20	7	15	0	13	5	20	1	3	2	3	1	2	1	1	-1	2.40	0.40	-0.02
2083978	2023-08-23 03:00:00	14	0	2.41	3.20	2.56	2.63	3.15	2.61	9	2	17	18	1	11	27	3	28	1	25	0	28	2	3	1	2	1	3	1	-1	1	0.22	-0.05	0.05
2092682	2023-10-26 03:00:00	14	0	1.63	3.95	4.70	1.66	4.25	4.70	1	2	5	2	4	1	3	6	6	5	2	2	8	3	1	1	1	2	2	1	1	0	0.03	0.30	0.00
2291895	2024-11-27 04:00:00	14	0	2.98	3.50	2.19	3.15	3.50	2.25	4	3	4	4	3	5	8	6	9	6	8	5	14	2	3	1	2	1	3	1	0	1	0.17	0.00	0.06
2092681	2023-11-08 04:00:00	14	3	2.94	3.50	2.20	2.84	3.55	2.40	8	1	2	3	1	8	11	2	10	1	10	2	12	1	3	2	3	1	2	-1	1	1	-0.10	0.05	0.20
2291892	2024-11-27 01:45:00	14	0	4.65	3.85	1.65	5.10	3.95	1.66	8	5	5	9	3	7	17	8	12	2	11	7	19	1	3	2	3	1	2	1	1	1	0.45	0.10	0.01
2092680	2023-12-14 04:00:00	14	0	1.98	3.65	3.30	1.91	3.90	3.70	15	4	12	10	8	15	25	12	27	13	26	11	38	2	3	1	2	1	3	-1	1	1	-0.07	0.25	0.40
2092679	2023-12-14 04:00:00	14	1	3.70	3.90	1.91	3.65	4.05	1.89	15	6	14	16	10	14	31	16	28	11	26	14	42	1	3	2	3	1	2	-1	1	-1	-0.05	0.15	-0.02
2092678	2023-11-29 04:00:00	14	1	1.61	4.10	4.70	1.71	4.10	4.50	11	9	17	18	10	13	29	19	30	6	16	5	35	2	3	1	2	1	3	1	0	-1	0.10	0.00	-0.20
2069637	2023-08-16 03:00:00	14	3	1.54	3.70	4.95	1.50	3.95	6.40	4	2	1	1	4	3	5	6	4	1	0	2	6	2	1	3	2	3	1	-1	1	1	-0.04	0.25	1.45
2092677	2023-11-08 01:45:00	14	3	2.53	3.50	2.52	2.65	3.60	2.53	18	3	14	14	4	19	32	7	33	4	29	3	36	2	3	1	2	1	3	1	1	1	0.12	0.10	0.01
2291896	2024-09-18 03:00:00	14	3	1.68	3.90	5.00	1.64	4.00	5.30	3	1	1	1	4	4	4	5	5	1	0	0	5	3	1	1	1	2	2	-1	1	1	-0.04	0.10	0.30
2069636	2023-08-10 02:00:00	14	3	3.50	3.30	1.89	3.65	3.35	1.96	14	7	10	9	7	16	23	14	26	5	14	2	28	2	3	1	2	1	3	1	1	1	0.15	0.05	0.07
2092676	2023-10-26 03:00:00	14	3	1.73	3.65	4.35	1.75	3.90	4.55	4	4	4	2	6	7	6	10	11	5	1	0	11	3	2	1	1	2	3	1	1	1	0.02	0.25	0.20
2092674	2023-09-20 03:00:00	14	3	1.84	3.90	3.55	1.78	4.25	3.95	8	4	9	3	11	11	11	15	20	10	6	1	21	3	2	1	1	2	3	-1	1	1	-0.06	0.35	0.40
2291903	2024-11-06 04:00:00	14	3	3.75	3.75	1.83	3.55	3.80	1.98	19	6	15	14	7	16	33	13	31	4	24	6	37	1	3	2	3	1	2	-1	1	1	-0.20	0.05	0.15
2092673	2023-10-26 00:45:00	14	3	1.95	3.55	3.50	1.97	3.80	3.60	2	5	6	4	6	6	6	11	12	8	3	2	14	3	2	1	1	2	3	1	1	1	0.02	0.25	0.10
2084031	2023-08-30 03:00:00	14	3	1.56	4.00	4.85	1.59	4.30	5.30	6	5	7	7	8	10	13	13	17	7	7	3	20	2	2	1	1	1	3	1	1	1	0.03	0.30	0.45
2084030	2023-08-30 03:00:00	14	3	1.78	3.65	3.80	1.82	3.90	4.10	4	2	5	3	4	6	7	6	11	4	5	0	11	2	3	1	2	1	3	1	1	1	0.04	0.25	0.30
2291843	2024-11-27 04:00:00	14	3	1.43	4.65	6.20	1.47	4.70	6.30	9	5	9	11	5	10	20	10	19	2	12	3	22	1	3	2	3	1	2	1	1	1	0.04	0.05	0.10
2084029	2023-08-30 03:00:00	14	0	2.33	3.25	2.75	2.59	3.40	2.70	6	0	10	12	1	9	18	1	19	2	19	1	20	2	3	1	2	1	3	1	1	-1	0.26	0.15	-0.05
2084028	2023-08-31 03:00:00	14	3	1.48	4.30	5.30	1.52	4.45	5.90	2	3	5	2	7	5	4	10	10	9	3	3	13	3	1	1	1	2	2	1	1	1	0.04	0.15	0.60
2291841	2024-11-07 04:00:00	14	3	2.58	3.20	2.65	2.69	3.20	2.74	10	7	20	12	7	19	22	14	39	18	26	1	40	2	3	1	2	1	3	1	0	1	0.11	0.00	0.09
2084027	2023-08-31 03:00:00	14	1	1.64	3.90	5.40	1.65	3.90	5.40	2	3	3	2	4	6	4	7	9	5	2	0	9	3	2	1	1	2	3	1	0	0	0.01	0.00	0.00
2291846	2024-09-18 00:45:00	14	3	1.86	3.50	3.60	1.88	3.70	4.05	6	4	6	6	4	7	12	8	13	3	7	2	15	2	3	1	2	1	3	1	1	1	0.02	0.20	0.45
2291847	2024-12-12 04:00:00	14	3	3.45	3.35	2.04	3.65	3.50	2.04	15	7	19	17	8	15	32	15	34	6	23	4	38	2	3	1	2	1	3	1	1	0	0.20	0.15	0.00
2291845	2024-10-23 03:00:00	14	0	1.96	3.60	3.40	2.07	3.60	3.45	11	6	11	14	4	10	25	10	21	8	23	12	33	1	3	2	3	1	2	1	0	1	0.11	0.00	0.05
2291850	2024-11-06 04:00:00	14	1	3.10	3.20	2.42	2.76	3.30	2.61	10	1	0	4	4	3	14	5	3	2	11	13	16	1	2	3	3	2	1	-1	1	1	-0.34	0.10	0.19
2291851	2024-12-12 01:45:00	14	3	1.49	4.35	5.50	1.47	4.45	6.90	6	3	3	4	5	8	10	8	11	1	3	0	11	2	3	1	2	1	3	-1	1	1	-0.02	0.10	1.40
2291854	2024-11-28 04:00:00	14	3	1.87	3.95	3.45	1.71	4.25	4.35	16	5	22	25	11	16	41	16	38	5	30	8	46	1	3	2	3	1	2	-1	1	1	-0.16	0.30	0.90
2291852	2024-11-06 04:00:00	14	3	1.71	4.10	4.50	1.84	3.95	3.95	1	5	7	5	3	4	6	8	11	5	3	0	11	3	2	1	1	2	3	1	-1	-1	0.13	-0.15	-0.55
2291853	2025-01-22 04:00:00	14	3	1.28	5.30	7.80	1.25	6.00	12.00	5	5	3	5	7	4	10	12	7	7	5	10	17	2	1	3	2	3	1	-1	1	1	-0.03	0.70	4.20
2291859	2024-09-19 03:00:00	14	1	1.52	4.40	6.10	1.49	4.45	6.50	8	6	6	6	8	11	14	14	17	4	4	1	18	2	2	1	1	1	3	-1	1	1	-0.03	0.05	0.40
2291857	2024-11-27 04:00:00	14	1	1.18	7.10	11.00	1.20	7.30	13.00	4	8	2	5	11	3	9	19	5	14	4	18	23	2	1	3	2	3	1	1	1	1	0.02	0.20	2.00
2291862	2024-11-28 04:00:00	14	0	2.26	3.60	2.79	2.40	3.65	2.79	3	3	7	5	5	5	8	8	12	11	11	7	19	2	2	1	1	1	3	1	1	0	0.14	0.05	0.00
2291863	2024-11-07 04:00:00	14	0	1.68	3.85	4.45	1.54	4.55	5.60	18	10	19	14	21	21	32	31	40	15	16	7	47	2	3	1	2	1	3	-1	1	1	-0.14	0.70	1.15
2291861	2024-09-20 03:00:00	14	3	3.65	4.05	1.73	4.50	4.25	1.69	6	4	8	12	7	4	18	11	12	4	11	10	22	1	3	2	3	1	2	1	1	-1	0.85	0.20	-0.04
2291866	2024-09-19 03:00:00	14	3	1.32	5.10	7.10	1.36	5.40	7.80	11	6	14	9	9	24	20	15	38	20	25	2	40	2	3	1	2	1	3	1	1	1	0.04	0.30	0.70
2291867	2025-01-23 04:00:00	14	3	2.49	3.85	2.57	2.36	3.70	2.80	10	5	10	6	5	17	16	10	27	11	17	0	27	2	3	1	2	1	3	-1	-1	1	-0.13	-0.15	0.23
2291864	2025-01-22 01:45:00	14	3	2.53	3.45	2.42	2.47	3.50	2.77	13	0	14	13	1	14	26	1	28	2	27	0	28	2	3	1	2	1	3	-1	1	1	-0.06	0.05	0.35
2092707	2023-12-14 04:00:00	14	3	4.95	4.25	1.56	5.60	4.25	1.57	10	3	9	10	4	8	20	7	17	1	14	4	21	1	3	2	3	1	2	1	0	1	0.65	0.00	0.01
2092706	2023-10-26 03:00:00	14	0	3.25	3.45	2.08	3.15	3.45	2.26	12	3	13	11	3	14	23	6	27	6	23	2	29	2	3	1	2	1	3	-1	0	1	-0.10	0.00	0.18
2263270	2024-08-07 02:45:00	14	3	1.58	3.65	4.60	1.76	3.60	4.30	8	10	14	14	7	10	22	17	24	6	11	4	28	2	3	1	2	1	3	1	-1	-1	0.18	-0.05	-0.30
2263271	2024-08-14 01:00:00	14	1	2.23	3.55	2.57	2.31	3.50	2.48	7	1	7	7	1	7	14	2	14	0	12	0	14	1	3	1	2	1	2	1	-1	-1	0.08	-0.05	-0.09
2254058	2024-07-23 23:00:00	14	3	1.25	5.20	8.20	1.21	5.60	8.90	19	14	20	15	18	24	34	32	44	11	13	1	45	2	3	1	2	1	3	-1	1	1	-0.04	0.40	0.70
2254059	2024-08-01 01:00:00	14	0	4.20	3.80	1.61	4.65	3.80	1.55	8	7	8	11	6	8	19	13	16	2	8	5	21	1	3	2	3	1	2	1	0	-1	0.45	0.00	-0.06
2263272	2024-08-08 01:00:00	14	3	1.83	3.65	3.35	1.98	3.55	3.40	11	11	17	16	10	14	27	21	31	11	17	7	38	2	3	1	2	1	3	1	-1	1	0.15	-0.10	0.05
2263273	2024-08-14 02:30:00	14	0	2.07	3.30	2.99	2.13	3.30	2.87	2	1	5	4	1	1	6	2	6	2	6	2	8	1	3	1	2	1	2	1	0	-1	0.06	0.00	-0.12
2070731	2023-08-16 01:00:00	14	3	1.44	4.30	5.30	1.50	4.20	5.70	3	4	4	5	3	4	8	7	8	1	2	1	9	1	3	1	2	1	2	1	-1	1	0.06	-0.10	0.40
2254070	2024-07-25 02:15:00	14	1	2.13	3.30	2.88	2.18	3.30	2.80	1	0	5	3	1	2	4	1	7	3	6	0	7	2	3	1	2	1	3	1	0	-1	0.05	0.00	-0.08
2070730	2023-08-16 01:00:00	14	1	2.11	3.25	2.94	2.21	3.35	3.05	0	3	2	2	3	6	2	6	8	7	3	1	9	3	2	1	1	2	3	1	1	1	0.10	0.10	0.11
2042569	2023-07-19 03:15:00	14	3	2.08	3.35	2.92	2.12	3.25	3.10	1	2	4	2	1	2	3	3	6	3	3	0	6	2	2	1	1	1	3	1	-1	1	0.04	-0.10	0.18
2254068	2024-07-31 01:00:00	14	3	1.13	6.90	12.00	1.12	7.10	11.00	5	8	4	6	6	4	11	14	8	4	1	7	15	2	1	3	2	3	1	-1	1	-1	-0.01	0.20	-1.00
2042568	2023-07-12 02:45:00	14	0	1.69	3.55	4.05	1.77	3.55	3.65	2	2	4	3	2	2	5	4	6	1	2	0	6	2	3	1	2	1	3	1	0	-1	0.08	0.00	-0.40
2254069	2024-07-24 03:00:00	14	0	6.60	4.40	1.35	7.80	4.75	1.29	10	9	8	11	10	7	21	19	15	0	2	6	21	1	2	3	3	2	1	1	1	-1	1.20	0.35	-0.06
2070726	2023-08-16 01:00:00	14	3	1.22	6.10	7.40	1.24	5.70	10.00	3	7	9	8	3	10	11	10	19	8	9	0	19	2	3	1	2	1	3	1	-1	1	0.02	-0.40	2.60
2254078	2024-07-24 02:00:00	14	3	1.16	6.20	10.00	1.14	6.20	12.00	13	13	7	12	13	10	25	26	17	4	3	12	29	2	1	3	2	3	1	-1	0	1	-0.02	0.00	2.00
2254076	2024-07-25 02:00:00	14	3	1.36	4.55	6.10	1.30	4.95	6.60	9	6	7	4	11	11	13	17	18	8	4	3	21	3	2	1	1	2	3	-1	1	1	-0.06	0.40	0.50
2291906	2024-11-27 04:00:00	14	0	7.40	5.10	1.39	7.60	5.20	1.38	3	1	3	5	2	3	8	3	6	0	5	2	8	1	3	2	3	1	2	1	1	-1	0.20	0.10	-0.01
2291907	2024-09-18 00:45:00	14	0	4.10	3.95	1.66	4.75	4.15	1.67	1	1	2	3	2	1	4	3	3	1	2	2	5	1	2	2	3	1	1	1	1	1	0.65	0.20	0.01
2291904	2024-12-12 04:00:00	14	3	1.34	5.80	7.60	1.33	5.90	7.80	6	5	11	6	6	12	12	11	23	12	13	1	24	2	3	1	2	1	3	-1	1	1	-0.01	0.10	0.20
2291911	2024-10-24 03:00:00	14	0	6.90	4.70	1.38	8.30	4.90	1.38	4	3	3	7	6	2	11	9	5	3	5	9	14	1	2	3	3	2	1	1	1	0	1.40	0.20	0.00
2291908	2024-11-28 01:45:00	14	3	3.15	3.60	2.05	3.40	3.60	2.09	9	5	11	8	5	11	17	10	22	12	19	7	29	2	3	1	2	1	3	1	0	1	0.25	0.00	0.04
2291909	2024-11-07 04:00:00	14	0	2.31	3.65	2.67	2.47	3.60	2.72	0	7	10	5	4	13	5	11	23	18	12	0	23	3	2	1	1	2	3	1	-1	1	0.16	-0.05	0.05
2203442	2024-06-02 03:00:00	14	0	4.45	3.90	1.67	4.90	4.10	1.66	13	10	7	14	13	6	27	23	13	8	12	22	35	1	2	3	3	2	1	1	1	-1	0.45	0.20	-0.01
2254080	2024-07-31 02:00:00	14	0	5.40	4.40	1.40	5.50	4.45	1.39	7	2	5	6	4	5	13	6	10	1	8	4	14	1	3	2	3	1	2	1	1	-1	0.10	0.05	-0.01
2254081	2024-08-01 03:00:00	14	0	4.40	3.90	1.58	4.05	3.85	1.63	13	11	7	8	8	11	21	19	18	2	4	5	23	1	2	3	3	2	1	-1	-1	1	-0.35	-0.05	0.05
2282848	2024-08-22 03:00:00	14	3	3.30	3.55	1.86	3.55	3.70	2.01	16	8	15	15	9	18	31	17	33	9	23	7	40	2	3	1	2	1	3	1	1	1	0.25	0.15	0.15
1986384	2023-06-11 03:00:00	14	3	1.46	4.35	6.10	1.48	4.45	6.60	13	14	17	15	14	15	28	28	32	10	10	6	38	2	2	1	1	1	3	1	1	1	0.02	0.10	0.50
2026366	2023-07-19 01:00:00	14	3	1.79	3.30	3.90	1.81	3.15	3.95	4	6	6	3	6	8	7	12	14	7	2	0	14	3	2	1	1	2	3	1	-1	1	0.02	-0.15	0.05
2026364	2023-07-20 00:00:00	14	3	1.08	8.60	13.00	1.10	7.90	12.00	3	4	3	4	4	3	7	8	6	2	1	3	9	2	1	3	2	3	1	1	-1	-1	0.02	-0.70	-1.00
2026363	2023-07-11 23:30:00	14	0	8.40	4.90	1.25	7.70	4.80	1.27	3	2	5	5	5	2	8	7	7	1	2	2	9	1	2	2	3	1	1	-1	-1	1	-0.70	-0.10	0.02
2026356	2023-07-19 01:00:00	14	0	4.40	3.35	1.68	4.30	3.40	1.68	6	7	7	9	5	6	15	12	13	0	3	2	15	1	3	2	3	1	2	-1	1	0	-0.10	0.05	0.00
2026354	2023-07-20 00:00:00	14	0	1.16	6.20	9.90	1.18	6.20	9.00	4	4	8	5	3	3	9	7	11	2	4	0	11	2	3	1	2	1	3	1	0	-1	0.02	0.00	-0.90
2026355	2023-07-12 02:00:00	14	3	1.13	7.10	11.00	1.15	6.80	10.00	6	9	7	7	10	11	13	19	18	10	4	5	23	3	1	2	1	3	2	1	-1	-1	0.02	-0.30	-1.00
2086258	2023-08-31 03:00:00	14	0	1.78	3.50	4.00	1.77	3.65	4.75	3	2	2	2	3	6	5	5	8	4	4	1	9	2	2	1	1	1	3	-1	1	1	-0.01	0.15	0.75
2282847	2024-08-28 03:00:00	14	0	1.37	4.75	5.60	1.34	5.50	8.30	17	12	23	15	15	23	32	27	46	19	24	5	51	2	3	1	2	1	3	-1	1	1	-0.03	0.75	2.70
2092447	2023-11-09 04:00:00	14	3	4.05	3.85	1.74	4.25	3.90	1.79	3	4	0	3	3	3	6	7	3	2	1	5	8	2	1	3	2	3	1	1	1	1	0.20	0.05	0.05
2187169	2024-04-10 03:00:00	14	1	2.63	3.50	2.42	2.69	3.50	2.56	18	6	8	22	5	10	40	11	18	2	31	24	42	1	3	2	3	1	2	1	0	1	0.06	0.00	0.14
2043806	2023-08-03 01:00:00	14	1	1.59	3.90	4.35	1.60	3.95	4.15	0	0	2	2	2	0	2	2	2	0	0	0	2	1	1	1	1	1	1	1	1	-1	0.01	0.05	-0.20
2187168	2024-04-11 03:00:00	14	0	1.99	3.60	3.30	2.05	3.75	3.40	19	9	20	23	10	15	42	19	35	10	33	17	52	1	3	2	3	1	2	1	1	1	0.06	0.15	0.10
2187171	2024-04-17 03:00:00	14	3	2.21	3.65	2.82	2.23	3.65	3.05	2	3	5	3	3	6	5	6	11	13	12	7	18	3	2	1	1	2	3	1	0	1	0.02	0.00	0.23
2187170	2024-04-11 03:00:00	14	3	1.81	3.60	4.05	1.82	3.75	4.25	8	7	16	7	9	17	15	16	33	25	24	7	40	3	2	1	1	2	3	1	1	1	0.01	0.15	0.20
2043803	2023-08-02 01:30:00	14	1	1.51	3.95	4.90	1.54	3.85	4.75	2	2	1	2	2	2	4	4	3	0	0	1	4	1	1	3	2	2	1	1	-1	-1	0.03	-0.10	-0.15
2092443	2023-12-13 04:00:00	14	0	2.81	3.85	2.31	2.77	3.85	2.33	6	2	2	5	2	2	11	4	4	2	9	9	13	1	2	2	3	1	1	-1	0	1	-0.04	0.00	0.02
2187173	2024-04-17 03:00:00	14	0	2.17	3.80	2.81	2.20	3.90	2.96	2	5	9	4	6	9	6	11	18	15	10	3	21	3	2	1	1	2	3	1	1	1	0.03	0.10	0.15
2092442	2023-11-30 01:45:00	14	1	2.46	3.55	2.56	2.81	3.80	2.31	2	0	4	6	1	0	8	1	4	0	7	4	8	1	3	2	3	1	2	1	1	-1	0.35	0.25	-0.25
2187172	2024-04-18 03:00:00	14	1	1.66	4.15	4.25	1.62	4.50	4.75	7	7	13	9	11	9	16	18	22	13	11	7	29	3	2	1	1	2	3	-1	1	1	-0.04	0.35	0.50
2092440	2023-10-25 00:45:00	14	0	6.30	4.75	1.41	6.30	4.90	1.46	18	9	11	17	9	15	35	18	26	1	18	10	36	1	3	2	3	1	2	0	1	1	0.00	0.15	0.05
2092439	2023-11-09 04:00:00	14	3	1.20	6.90	10.00	1.19	7.70	13.00	7	4	4	6	9	7	13	13	11	3	3	5	16	1	1	3	2	2	1	-1	1	1	-0.01	0.80	3.00
2092438	2023-11-30 04:00:00	14	1	1.19	6.70	11.00	1.22	6.90	11.00	1	2	1	3	3	2	4	5	3	1	0	2	5	2	1	3	2	3	1	1	1	0	0.03	0.20	0.00
2227624	2024-07-17 00:00:00	14	0	2.52	3.15	2.45	2.41	3.15	2.59	10	1	6	5	1	9	15	2	15	2	15	2	17	1	3	1	2	1	2	-1	0	1	-0.11	0.00	0.14
2092437	2023-09-21 03:00:00	14	3	1.47	4.60	5.70	1.45	4.95	6.30	12	10	15	12	13	16	24	23	31	10	11	3	34	2	3	1	2	1	3	-1	1	1	-0.02	0.35	0.60
2227637	2024-07-18 03:00:00	14	0	3.15	3.50	1.93	3.25	3.50	1.89	6	3	6	3	3	9	9	6	15	7	10	1	16	2	3	1	2	1	3	1	0	-1	0.10	0.00	-0.04
2227640	2024-07-18 01:00:00	14	1	1.64	3.65	4.20	1.64	3.65	4.20	6	8	14	11	7	8	17	15	22	6	8	1	23	2	3	1	2	1	3	0	0	0	0.00	0.00	0.00
2227644	2024-07-17 03:00:00	14	3	2.65	3.10	2.38	2.70	3.10	2.35	11	3	13	16	2	11	27	5	24	0	22	3	27	1	3	2	3	1	2	1	0	-1	0.05	0.00	-0.03
2026368	2023-07-20 02:00:00	14	0	3.65	3.50	1.78	3.55	3.55	1.80	4	3	2	3	3	3	7	6	5	1	2	3	8	1	2	3	3	2	1	-1	1	1	-0.10	0.05	0.02
2227647	2024-08-01 02:00:00	14	0	3.50	3.70	1.77	3.20	3.60	1.89	6	2	2	2	1	6	8	3	8	0	5	0	8	1	3	1	2	1	2	-1	-1	1	-0.30	-0.10	0.12
2283905	2024-08-21 03:00:00	14	3	1.64	3.80	4.40	1.77	3.90	4.40	1	4	7	4	4	6	5	8	13	11	8	3	16	3	2	1	1	2	3	1	1	0	0.13	0.10	0.00
2283912	2024-08-21 03:00:00	14	3	1.74	3.50	4.15	1.81	3.60	4.55	6	6	9	5	5	13	11	11	22	14	14	3	25	2	2	1	1	1	3	1	1	1	0.07	0.10	0.40
2283918	2024-08-22 03:00:00	14	1	1.54	3.80	4.80	1.57	4.10	5.90	5	7	12	6	8	14	11	15	26	16	12	1	27	3	2	1	1	2	3	1	1	1	0.03	0.30	1.10
2283916	2024-08-22 03:00:00	14	0	2.26	3.35	2.65	2.31	3.40	3.10	2	4	8	1	4	8	3	8	16	15	10	2	18	3	2	1	1	2	3	1	1	1	0.05	0.05	0.45
2283917	2024-08-22 03:00:00	14	0	2.82	3.35	2.14	2.84	3.70	2.35	9	4	2	9	5	3	18	9	5	0	9	13	18	1	2	3	3	2	1	1	1	1	0.02	0.35	0.21
2283922	2024-08-29 03:00:00	14	3	2.11	3.50	2.77	2.13	3.70	3.25	13	4	13	15	6	14	28	10	27	2	20	3	30	1	3	2	3	1	2	1	1	1	0.02	0.20	0.48
2283926	2024-08-29 03:00:00	14	3	2.65	3.20	2.33	2.89	3.50	2.40	9	3	0	9	6	1	18	9	1	2	11	19	20	1	2	3	3	2	1	1	1	1	0.24	0.30	0.07
2283927	2024-08-28 03:00:00	14	1	1.56	4.30	5.70	1.59	4.20	5.50	6	5	7	7	6	8	13	11	15	4	6	2	17	2	3	1	2	1	3	1	-1	-1	0.03	-0.10	-0.20
2283924	2024-08-29 03:00:00	14	3	2.38	3.40	2.46	2.51	3.25	2.89	0	6	10	2	4	15	2	10	25	24	16	1	26	3	2	1	1	2	3	1	-1	1	0.13	-0.15	0.43
2283925	2024-08-28 03:00:00	14	3	1.88	3.60	3.20	1.93	3.80	3.70	26	9	21	21	9	23	47	18	44	8	37	11	55	1	3	2	3	1	2	1	1	1	0.05	0.20	0.50
2187167	2024-04-18 03:00:00	14	3	2.31	3.65	2.68	2.49	3.65	2.67	4	5	14	5	4	14	9	9	28	21	21	2	30	2	2	1	1	1	3	1	0	-1	0.18	0.00	-0.01
2187166	2024-04-10 03:00:00	14	1	1.76	3.85	4.00	1.69	4.00	4.80	7	6	5	4	7	12	11	13	17	8	6	2	19	3	2	1	1	2	3	-1	1	1	-0.07	0.15	0.80
2085854	2023-08-23 03:00:00	14	3	2.13	3.15	3.00	2.25	3.15	3.10	2	6	7	7	3	8	9	9	15	10	10	4	19	2	2	1	1	1	3	1	0	1	0.12	0.00	0.10
2227649	2024-07-24 02:30:00	14	0	3.75	3.65	1.73	3.75	3.65	1.73	7	5	4	7	6	3	14	11	7	0	3	7	14	1	2	3	3	2	1	0	0	0	0.00	0.00	0.00
2057214	2023-07-26 00:00:00	14	3	3.90	3.55	1.72	3.85	3.55	1.72	1	1	0	0	0	1	1	1	1	1	1	1	2	1	1	1	1	1	1	-1	0	0	-0.05	0.00	0.00
2070526	2023-08-09 02:00:00	14	1	2.04	3.30	3.05	2.11	3.45	3.15	1	0	2	1	1	3	2	1	5	3	4	0	5	2	3	1	2	1	3	1	1	1	0.07	0.15	0.10
2227650	2024-07-31 01:00:00	14	3	1.25	5.20	7.60	1.24	5.30	7.90	2	1	6	3	2	6	5	3	12	7	9	0	12	2	3	1	2	1	3	-1	1	1	-0.01	0.10	0.30
2048163	2023-07-18 17:30:00	15	0	2.12	3.40	2.98	2.12	3.40	2.98	0	0	1	0	0	0	0	0	1	1	1	0	1	2	2	1	1	1	3	0	0	0	0.00	0.00	0.00
1926045	2023-07-29 18:00:00	16	3	2.81	2.98	2.33	2.61	2.97	2.50	9	6	11	12	4	10	21	10	21	0	11	0	21	1	3	1	2	1	2	-1	-1	1	-0.20	-0.01	0.17
1926040	2023-07-28 19:00:00	16	3	1.67	3.20	4.85	1.71	3.15	4.60	0	2	2	2	0	0	2	2	2	0	0	0	2	1	1	1	1	1	1	1	-1	-1	0.04	-0.05	-0.25
1926039	2023-07-28 16:30:00	16	3	1.40	3.80	6.60	1.45	3.80	6.10	1	3	4	5	3	3	6	6	7	2	2	1	8	2	2	1	1	1	3	1	0	-1	0.05	0.00	-0.50
1926033	2023-07-31 18:00:00	16	1	2.86	3.25	2.16	2.80	3.20	2.23	4	1	1	2	2	2	6	3	3	0	3	3	6	1	2	2	3	1	1	-1	-1	1	-0.06	-0.05	0.07
1926032	2023-07-29 15:30:00	16	3	1.89	3.10	3.75	1.92	2.96	3.85	8	11	13	13	5	12	21	16	25	6	11	2	27	2	3	1	2	1	3	1	-1	1	0.03	-0.14	0.10
1926034	2023-07-31 18:00:00	16	3	2.05	3.05	3.25	2.19	3.00	3.00	2	3	3	3	1	1	5	4	4	0	1	1	5	1	2	2	3	1	1	1	-1	-1	0.14	-0.05	-0.25
1926029	2023-07-26 20:00:00	16	3	1.59	3.20	5.50	1.65	3.15	5.10	0	3	2	1	1	3	1	4	5	5	2	1	6	3	2	1	1	2	3	1	-1	-1	0.06	-0.05	-0.40
1926028	2023-07-24 14:00:00	16	3	1.51	3.60	5.30	1.68	3.20	4.70	1	10	11	9	3	6	10	13	17	7	4	0	17	3	2	1	1	2	3	1	-1	-1	0.17	-0.40	-0.60
1926031	2023-07-27 18:00:00	16	0	1.38	3.95	7.10	1.45	3.70	6.10	0	3	4	5	0	0	5	3	4	0	2	1	5	1	3	2	3	1	2	1	-1	-1	0.07	-0.25	-1.00
1926025	2023-07-20 18:00:00	16	3	1.22	5.20	9.60	1.25	5.00	8.50	2	2	3	3	2	3	5	4	6	1	2	0	6	2	3	1	2	1	3	1	-1	-1	0.03	-0.20	-1.10
1926027	2023-07-21 10:30:00	16	1	9.60	5.30	1.27	8.60	4.00	1.40	49	33	25	51	21	35	100	54	60	4	50	44	104	1	3	2	3	1	2	-1	-1	1	-1.00	-1.30	0.13
1926026	2023-07-23 13:00:00	16	3	1.08	8.30	13.00	1.04	9.60	18.00	8	9	6	6	11	9	14	20	15	8	2	7	22	3	1	2	1	3	2	-1	1	1	-0.04	1.30	5.00
1926016	2023-07-31 15:00:00	16	3	3.70	3.15	1.88	3.65	3.15	1.88	3	1	1	1	0	2	4	1	3	0	3	1	4	1	3	2	3	1	2	-1	0	0	-0.05	0.00	0.00
1926019	2023-07-30 17:30:00	16	0	1.23	5.10	9.00	1.24	5.00	8.90	2	3	4	3	3	2	5	6	6	1	0	0	6	3	1	1	1	2	2	1	-1	-1	0.01	-0.10	-0.10
1926049	2023-07-23 15:30:00	16	3	1.44	4.15	5.40	1.48	4.00	5.10	2	5	5	5	3	2	7	8	7	3	2	3	10	2	1	2	1	3	1	1	-1	-1	0.04	-0.15	-0.30
1926051	2023-07-27 09:00:00	16	1	1.74	3.35	4.85	1.69	3.45	5.10	3	4	8	1	7	10	4	11	18	17	10	3	21	3	2	1	1	2	3	-1	1	1	-0.05	0.10	0.25
1926013	2023-07-30 15:00:00	16	3	1.13	7.30	9.20	1.12	7.50	10.00	6	13	7	7	9	9	13	22	16	11	2	8	24	3	1	2	1	3	2	-1	1	1	-0.01	0.20	0.80
1926012	2023-07-30 15:00:00	16	1	3.20	2.99	2.11	3.25	2.94	2.11	1	1	0	1	1	0	2	2	0	0	0	2	2	1	1	3	2	2	1	1	-1	0	0.05	-0.05	0.00
1926015	2023-07-25 10:00:00	16	3	2.99	3.05	2.40	3.40	2.79	2.35	26	18	21	32	13	21	58	31	42	1	28	17	59	1	3	2	3	1	2	1	-1	-1	0.41	-0.26	-0.05
1926008	2023-07-25 16:00:00	16	1	3.30	3.00	2.06	3.35	3.00	2.04	0	2	1	2	1	0	2	3	1	2	1	3	4	2	1	3	2	3	1	1	0	-1	0.05	0.00	-0.02
1926010	2023-07-22 15:00:00	16	0	7.70	5.60	1.24	7.20	5.30	1.26	3	1	4	5	2	2	8	3	6	0	5	2	8	1	3	2	3	1	2	-1	-1	1	-0.50	-0.30	0.02
1982582	2023-08-19 16:00:00	16	0	2.67	3.50	2.19	2.55	3.40	2.30	3	2	2	1	2	3	4	4	5	2	2	1	6	2	2	1	1	1	3	-1	-1	1	-0.12	-0.10	0.11
1926004	2023-07-20 15:00:00	16	3	7.90	5.20	1.25	6.70	4.85	1.30	6	6	4	4	3	6	10	9	10	1	2	1	11	1	3	1	2	1	2	-1	-1	1	-1.20	-0.35	0.05
1982583	2023-08-20 18:00:00	16	3	2.48	2.99	2.61	2.56	2.88	2.62	7	5	6	9	3	9	16	8	15	0	8	1	16	1	3	2	3	1	2	1	-1	1	0.08	-0.11	0.01
1926007	2023-07-25 13:30:00	16	0	1.32	4.20	7.80	1.28	4.45	9.20	2	3	4	2	3	4	4	6	8	6	4	2	10	3	2	1	1	2	3	-1	1	1	-0.04	0.25	1.40
1926006	2023-07-21 13:00:00	16	0	11.00	6.40	1.14	11.00	6.30	1.14	2	3	3	2	3	4	4	6	7	3	1	0	7	3	2	1	1	2	3	0	-1	0	0.00	-0.10	0.00
1982581	2023-08-16 18:00:00	16	0	2.93	2.86	2.33	3.05	2.91	2.23	3	5	2	6	4	1	9	9	3	1	1	7	10	1	1	3	2	2	1	1	1	-1	0.12	0.05	-0.10
2152736	2024-06-15 18:00:00	17	3	2.09	3.30	3.10	2.09	3.30	3.10	1	0	0	0	0	1	1	0	1	0	1	0	1	1	3	1	2	1	2	0	0	0	0.00	0.00	0.00
2152737	2024-06-15 19:00:00	17	3	2.19	3.45	2.82	2.23	3.45	2.76	0	2	4	1	3	2	1	5	6	5	1	0	6	3	2	1	1	2	3	1	0	-1	0.04	0.00	-0.06
2152738	2024-06-16 17:00:00	17	1	2.19	3.30	2.93	2.19	3.30	2.92	5	0	5	4	0	5	9	0	10	1	10	0	10	2	3	1	2	1	3	0	0	-1	0.00	0.00	-0.01
2152739	2024-06-16 17:00:00	17	1	1.78	3.65	3.80	1.78	3.55	3.90	0	1	1	0	1	2	0	2	3	3	1	0	3	3	2	1	1	2	3	0	-1	1	0.00	-0.10	0.10
2152740	2024-06-16 18:00:00	17	3	2.23	3.30	2.88	2.20	3.30	2.94	5	0	5	4	1	5	9	1	10	1	9	0	10	2	3	1	2	1	3	-1	0	1	-0.03	0.00	0.06
2152741	2024-06-22 18:00:00	17	3	2.84	3.20	2.19	2.75	3.20	2.25	2	0	0	2	0	1	4	0	1	0	4	3	4	1	3	2	3	1	2	-1	0	1	-0.09	0.00	0.06
2152743	2024-06-22 17:00:00	17	3	2.44	3.20	2.52	2.52	3.20	2.44	1	0	2	2	0	1	3	0	3	0	3	0	3	1	3	1	2	1	2	1	0	-1	0.08	0.00	-0.08
2152744	2024-06-23 17:00:00	17	0	3.20	3.45	1.94	3.25	3.45	1.91	0	0	1	1	1	0	1	1	1	1	1	1	2	1	1	1	1	1	1	1	0	-1	0.05	0.00	-0.03
2152745	2024-06-22 19:00:00	17	3	2.06	3.35	2.98	2.06	3.30	3.00	1	1	1	2	0	1	3	1	2	0	2	1	3	1	3	2	3	1	2	0	-1	1	0.00	-0.05	0.02
2152746	2024-06-25 18:30:00	17	3	1.93	3.35	3.30	1.93	3.35	3.30	0	1	0	1	0	0	1	1	0	0	0	1	1	1	1	3	2	2	1	0	0	0	0.00	0.00	0.00
2152747	2024-06-23 17:00:00	17	0	2.39	3.20	2.57	2.39	3.20	2.57	0	0	1	1	0	0	1	0	1	0	1	0	1	1	3	1	2	1	2	0	0	0	0.00	0.00	0.00
2152748	2024-06-26 18:30:00	17	3	2.37	3.25	2.57	2.45	3.10	2.58	0	3	2	7	0	4	7	3	6	1	5	2	8	1	3	2	3	1	2	1	-1	1	0.08	-0.15	0.01
2152749	2024-06-25 18:30:00	17	3	2.87	3.30	2.13	2.83	3.30	2.15	1	1	2	2	1	1	3	2	3	0	1	0	3	1	3	1	2	1	2	-1	0	1	-0.04	0.00	0.02
2152751	2024-06-26 18:30:00	17	3	1.63	3.75	4.10	1.60	3.80	4.30	3	0	2	1	1	3	4	1	5	2	5	1	6	2	3	1	2	1	3	-1	1	1	-0.03	0.05	0.20
2152753	2024-06-29 18:00:00	17	0	2.36	3.25	2.56	2.38	3.25	2.55	1	0	1	2	0	1	3	0	2	0	3	1	3	1	3	2	3	1	2	1	0	-1	0.02	0.00	-0.01
2152754	2024-06-26 18:30:00	17	1	2.53	3.30	2.38	2.38	3.30	2.53	4	0	1	1	0	4	5	0	5	0	5	0	5	1	3	1	2	1	2	-1	0	1	-0.15	0.00	0.15
2152755	2024-06-29 19:00:00	17	0	2.69	3.30	2.23	2.72	3.40	2.17	8	3	9	8	6	4	16	9	13	3	10	6	19	1	3	2	3	1	2	1	1	-1	0.03	0.10	-0.06
2152756	2024-06-30 17:00:00	17	3	2.83	3.40	2.12	2.77	3.35	2.16	1	1	2	2	1	1	3	2	3	0	1	0	3	1	3	1	2	1	2	-1	-1	1	-0.06	-0.05	0.04
2152757	2024-06-30 18:00:00	17	3	1.83	3.40	3.55	1.83	3.40	3.55	1	0	0	0	0	0	1	0	0	0	1	1	1	1	2	2	3	1	1	0	0	0	0.00	0.00	0.00
2152759	2024-07-05 18:30:00	17	1	2.27	3.25	2.67	2.24	3.25	2.74	9	1	10	11	1	10	20	2	20	0	18	0	20	1	3	1	2	1	2	-1	0	1	-0.03	0.00	0.07
2152761	2024-07-05 18:30:00	17	1	2.76	3.50	2.12	2.84	3.35	2.12	7	7	0	11	4	0	18	11	0	1	8	19	19	1	2	3	3	2	1	1	-1	0	0.08	-0.15	0.00
2152762	2024-07-06 18:30:00	17	1	2.75	3.25	2.23	2.81	3.25	2.19	3	1	4	5	1	1	8	2	5	2	8	5	10	1	3	2	3	1	2	1	0	-1	0.06	0.00	-0.04
2152763	2024-07-07 18:00:00	17	1	2.72	3.30	2.23	2.63	3.30	2.29	8	1	7	7	2	8	15	3	15	1	13	1	16	1	3	1	2	1	2	-1	0	1	-0.09	0.00	0.06
2152764	2024-07-09 18:30:00	17	1	2.21	3.05	2.95	2.18	3.10	2.94	15	1	10	6	3	12	21	4	22	2	19	1	23	2	3	1	2	1	3	-1	1	-1	-0.03	0.05	-0.01
2152765	2024-07-07 18:00:00	17	3	2.57	3.25	2.37	2.61	3.20	2.37	2	2	2	4	1	5	6	3	7	5	8	4	11	2	3	1	2	1	3	1	-1	0	0.04	-0.05	0.00
2152706	2024-05-11 18:00:00	17	3	2.76	3.10	2.29	2.77	3.15	2.27	2	1	1	1	1	2	3	2	3	0	1	0	3	1	3	1	2	1	2	1	1	-1	0.01	0.05	-0.02
2152710	2024-05-12 15:30:00	17	1	1.74	3.50	3.85	1.74	3.60	3.75	0	1	2	0	2	1	0	3	3	3	0	0	3	3	1	1	1	2	2	0	1	-1	0.00	0.10	-0.10
2152711	2024-05-18 15:30:00	17	0	2.70	3.20	2.29	2.53	3.20	2.42	2	0	1	1	0	1	3	0	2	0	3	1	3	1	3	2	3	1	2	-1	0	1	-0.17	0.00	0.13
2152724	2024-05-28 18:30:00	17	1	2.14	3.20	2.93	2.14	3.30	2.87	0	0	6	0	2	3	0	2	9	9	7	0	9	3	2	1	1	2	3	0	1	-1	0.00	0.10	-0.06
2152727	2024-05-28 18:30:00	17	0	2.13	3.15	3.00	2.25	3.15	2.79	3	1	3	3	1	3	6	2	6	0	4	0	6	1	3	1	2	1	2	1	0	-1	0.12	0.00	-0.21
2152729	2024-06-01 15:30:00	17	3	1.84	3.65	3.30	1.78	3.75	3.45	6	0	3	1	2	6	7	2	9	2	7	0	9	2	3	1	2	1	3	-1	1	1	-0.06	0.10	0.15
2152733	2024-06-02 15:30:00	17	0	2.31	3.10	2.72	2.29	3.15	2.75	1	0	1	1	1	1	2	1	2	0	1	0	2	1	3	1	2	1	2	-1	1	1	-0.02	0.05	0.03
2152735	2024-06-15 17:00:00	17	1	1.73	3.55	4.15	1.73	3.55	4.15	1	0	0	0	1	1	1	1	1	0	0	0	1	1	1	1	1	1	1	0	0	0	0.00	0.00	0.00
2152800	2024-08-18 18:00:00	17	3	2.28	3.45	2.85	2.28	3.45	2.85	1	0	2	0	1	1	1	1	3	2	2	0	3	2	2	1	1	1	3	0	0	0	0.00	0.00	0.00
1952606	2023-07-02 17:00:00	17	0	3.40	3.45	2.03	3.40	3.45	2.01	1	1	2	2	0	1	3	1	3	1	3	1	4	1	3	1	2	1	2	0	0	-1	0.00	0.00	-0.02
2152803	2024-08-24 18:30:00	17	0	2.38	3.20	2.59	2.40	3.20	2.56	2	0	2	2	0	1	4	0	3	0	4	1	4	1	3	2	3	1	2	1	0	-1	0.02	0.00	-0.03
1952601	2023-06-25 15:30:00	17	0	2.88	3.20	2.28	2.88	3.20	2.28	1	0	0	0	0	1	1	0	1	0	1	0	1	1	3	1	2	1	2	0	0	0	0.00	0.00	0.00
2152806	2024-08-31 18:00:00	17	3	2.05	3.35	3.00	2.04	3.35	3.00	2	0	0	0	0	1	2	0	1	0	2	1	2	1	3	2	3	1	2	-1	0	0	-0.01	0.00	0.00
1952602	2023-06-25 18:00:00	17	1	2.25	3.25	2.85	2.25	3.25	2.85	0	1	1	1	0	0	1	1	1	0	0	0	1	1	1	1	1	1	1	0	0	0	0.00	0.00	0.00
2152807	2024-08-31 18:30:00	17	0	2.21	3.10	2.91	2.22	3.05	2.92	1	1	0	1	1	2	2	2	2	0	0	0	2	1	1	1	1	1	1	1	-1	1	0.01	-0.05	0.01
2152808	2024-09-01 17:00:00	17	3	2.83	3.25	2.18	2.86	3.25	2.17	1	1	1	2	1	1	3	2	2	0	1	1	3	1	2	2	3	1	1	1	0	-1	0.03	0.00	-0.01
1952596	2023-06-11 18:00:00	17	1	2.90	3.10	2.41	3.05	3.15	2.28	0	1	2	3	1	1	3	2	3	0	1	0	3	1	3	1	2	1	2	1	1	-1	0.15	0.05	-0.13
1952598	2023-06-24 17:00:00	17	1	2.06	3.55	3.00	2.01	3.55	3.10	2	1	2	2	1	1	4	2	3	1	3	2	5	1	3	2	3	1	2	-1	0	1	-0.05	0.00	0.10
2152811	2024-09-01 18:00:00	17	1	2.39	3.20	2.57	2.36	3.20	2.60	1	0	0	1	0	2	2	0	2	0	2	0	2	1	3	1	2	1	2	-1	0	1	-0.03	0.00	0.03
1952593	2023-06-11 15:30:00	17	0	3.45	3.30	2.04	3.45	3.30	2.04	1	0	1	0	1	0	1	1	1	0	0	0	1	1	1	1	1	1	1	0	0	0	0.00	0.00	0.00
2152814	2024-09-13 18:30:00	17	3	2.16	3.25	2.87	2.16	3.20	2.89	0	1	1	0	1	1	0	2	2	2	0	0	2	3	1	1	1	2	2	0	-1	1	0.00	-0.05	0.02
1952594	2023-06-10 17:00:00	17	3	1.72	3.70	3.75	1.64	3.85	4.05	2	2	4	3	5	3	5	7	7	4	2	2	9	3	1	1	1	2	2	-1	1	1	-0.08	0.15	0.30
1952591	2023-06-10 15:30:00	17	3	1.94	3.40	3.25	2.01	3.35	3.10	1	1	3	3	0	2	4	1	5	1	4	0	5	2	3	1	2	1	3	1	-1	-1	0.07	-0.05	-0.15
2152818	2024-09-15 15:30:00	17	3	1.89	3.40	3.35	1.96	3.40	3.20	4	1	4	6	1	3	10	2	7	0	8	3	10	1	3	2	3	1	2	1	0	-1	0.07	0.00	-0.15
1952590	2023-06-07 18:30:00	17	1	2.52	3.15	2.60	2.52	3.15	2.60	0	0	1	1	0	0	1	0	1	0	1	0	1	1	3	1	2	1	2	0	0	0	0.00	0.00	0.00
2152819	2024-09-21 15:30:00	17	0	2.61	3.30	2.53	2.66	3.35	2.48	2	0	4	4	1	2	6	1	6	1	6	1	7	1	3	1	2	1	2	1	1	-1	0.05	0.05	-0.05
2152821	2024-09-22 15:30:00	17	0	1.98	3.30	3.65	1.99	3.30	3.65	1	0	0	1	0	0	2	0	0	0	2	2	2	1	2	2	3	1	1	1	0	0	0.01	0.00	0.00
1952586	2023-06-07 18:00:00	17	3	1.81	3.45	3.85	1.81	3.45	3.85	1	1	2	2	0	1	3	1	3	0	2	0	3	1	3	1	2	1	2	0	0	0	0.00	0.00	0.00
2152826	2024-09-27 18:30:00	17	3	2.00	3.20	2.98	2.13	3.20	2.97	2	0	2	3	0	3	5	0	5	0	5	0	5	1	3	1	2	1	2	1	0	-1	0.13	0.00	-0.01
2152829	2024-09-28 18:00:00	17	3	1.91	3.45	3.25	1.89	3.50	3.30	3	0	0	0	1	1	3	1	1	0	2	2	3	1	2	2	3	1	1	-1	1	1	-0.02	0.05	0.05
2152830	2024-09-29 15:30:00	17	3	1.99	3.45	3.05	2.00	3.45	3.05	2	6	2	2	6	2	4	12	4	12	4	12	16	2	1	2	1	3	1	1	0	0	0.01	0.00	0.00
2152768	2024-07-10 18:30:00	17	3	1.92	3.35	3.35	1.89	3.40	3.40	5	0	1	2	2	3	7	2	4	1	6	4	8	1	3	2	3	1	2	-1	1	1	-0.03	0.05	0.05
1952638	2023-09-02 15:30:00	17	0	3.20	3.20	2.02	3.05	3.15	2.11	1	2	0	1	0	1	2	2	1	0	0	1	2	1	1	3	2	2	1	-1	-1	1	-0.15	-0.05	0.09
2152772	2024-07-13 18:30:00	17	1	2.76	3.15	2.26	2.90	3.15	2.18	5	2	3	6	2	4	11	4	7	0	7	4	11	1	3	2	3	1	2	1	0	-1	0.14	0.00	-0.08
2152773	2024-07-13 18:30:00	17	3	2.76	3.25	2.23	2.88	3.25	2.16	0	1	2	1	2	1	1	3	3	2	0	0	3	3	1	1	1	2	2	1	0	-1	0.12	0.00	-0.07
2152774	2024-07-14 18:00:00	17	3	1.98	3.40	3.10	1.92	3.45	3.25	8	0	4	4	1	8	12	1	12	0	11	0	12	1	3	1	2	1	2	-1	1	1	-0.06	0.05	0.15
2152775	2024-07-14 18:00:00	17	0	1.97	3.25	3.25	1.83	3.35	3.60	3	0	0	0	1	2	3	1	2	0	2	1	3	1	3	2	3	1	2	-1	1	1	-0.14	0.10	0.35
2152776	2024-07-20 18:00:00	17	3	2.79	3.50	2.11	2.89	3.55	2.03	3	0	1	1	2	0	4	2	1	1	3	4	5	1	2	3	3	2	1	1	1	-1	0.10	0.05	-0.08
2152777	2024-07-20 18:30:00	17	3	2.07	3.30	2.99	2.07	3.35	2.96	0	2	5	0	2	5	0	4	10	10	6	0	10	3	2	1	1	2	3	0	1	-1	0.00	0.05	-0.03
2152778	2024-07-14 18:00:00	17	1	2.17	3.30	2.81	2.04	3.35	3.05	2	0	1	0	1	2	2	1	3	1	2	0	3	2	3	1	2	1	3	-1	1	1	-0.13	0.05	0.24
2152779	2024-07-21 18:00:00	17	0	3.10	3.25	2.04	3.05	3.35	2.03	3	3	1	5	3	0	8	6	1	0	2	7	8	1	2	3	3	2	1	-1	1	-1	-0.05	0.10	-0.01
2152780	2024-07-21 18:00:00	17	0	2.37	3.20	2.61	2.46	3.20	2.49	3	0	7	6	0	3	9	0	10	1	10	0	10	2	3	1	2	1	3	1	0	-1	0.09	0.00	-0.12
2152781	2024-07-21 18:00:00	17	3	2.12	3.25	2.94	2.22	3.20	2.81	0	2	3	2	1	1	2	3	4	4	3	2	6	3	2	1	1	2	3	1	-1	-1	0.10	-0.05	-0.13
2152782	2024-07-21 18:00:00	17	0	2.61	3.15	2.37	2.54	3.30	2.36	11	1	7	5	4	5	16	5	12	1	12	5	17	1	3	2	3	1	2	-1	1	-1	-0.07	0.15	-0.01
2152783	2024-07-26 18:30:00	17	3	2.04	3.50	2.92	2.04	3.50	2.91	0	1	4	0	2	2	0	3	6	6	3	0	6	3	2	1	1	2	3	0	0	-1	0.00	0.00	-0.01
2152784	2024-07-26 18:30:00	17	3	2.90	3.45	2.06	2.86	3.45	2.09	3	0	0	1	0	1	4	0	1	0	4	3	4	1	3	2	3	1	2	-1	0	1	-0.04	0.00	0.03
2152785	2024-07-27 18:30:00	17	1	1.98	3.40	3.15	1.97	3.40	3.15	4	0	0	2	0	1	6	0	1	0	6	5	6	1	3	2	3	1	2	-1	0	0	-0.01	0.00	0.00
2152786	2024-07-27 18:00:00	17	3	2.04	3.40	2.98	2.02	3.35	3.05	1	1	1	0	0	3	1	1	4	3	3	0	4	2	2	1	1	1	3	-1	-1	1	-0.02	-0.05	0.07
2152787	2024-07-27 18:30:00	17	0	2.95	3.30	2.10	2.95	3.30	2.10	1	0	0	0	1	0	1	1	0	0	0	1	1	1	1	3	2	2	1	0	0	0	0.00	0.00	0.00
2152788	2024-08-09 18:30:00	17	0	2.12	3.30	2.90	2.12	3.30	2.89	0	1	4	0	2	2	0	3	6	6	3	0	6	3	2	1	1	2	3	0	0	-1	0.00	0.00	-0.01
2152789	2024-08-10 18:00:00	17	3	1.69	3.65	3.95	1.69	3.65	3.90	2	0	1	1	1	2	3	1	3	0	2	0	3	1	3	1	2	1	2	0	0	-1	0.00	0.00	-0.05
2152790	2024-07-28 18:00:00	17	0	2.13	3.25	2.92	2.13	3.25	2.91	1	0	2	0	1	0	1	1	2	1	1	0	2	2	2	1	1	1	3	0	0	-1	0.00	0.00	-0.01
2152791	2024-08-10 18:30:00	17	0	2.25	3.25	2.70	2.25	3.25	2.70	0	0	1	1	0	0	1	0	1	0	1	0	1	1	3	1	2	1	2	0	0	0	0.00	0.00	0.00
2152792	2024-08-10 18:30:00	17	0	1.89	3.35	3.40	1.90	3.35	3.40	1	0	0	1	0	0	2	0	0	0	2	2	2	1	2	2	3	1	1	1	0	0	0.01	0.00	0.00
2152793	2024-08-09 18:30:00	17	0	2.66	3.30	2.26	2.66	3.30	2.26	1	0	0	0	0	1	1	0	1	0	1	0	1	1	3	1	2	1	2	0	0	0	0.00	0.00	0.00
2152794	2024-08-11 18:00:00	17	0	2.18	3.40	2.73	2.16	3.35	2.77	2	1	1	0	1	1	2	2	2	1	1	1	3	1	1	1	1	1	1	-1	-1	1	-0.02	-0.05	0.04
2152796	2024-08-16 18:30:00	17	3	1.90	3.50	3.70	1.92	3.50	3.65	1	0	1	1	0	1	2	0	2	0	2	0	2	1	3	1	2	1	2	1	0	-1	0.02	0.00	-0.05
2152797	2024-08-17 18:00:00	17	3	2.88	3.40	2.28	2.87	3.45	2.27	1	1	1	1	1	1	2	2	2	0	0	0	2	1	1	1	1	1	1	-1	1	-1	-0.01	0.05	-0.01
1952670	2023-09-03 15:30:00	17	0	1.75	3.50	3.55	1.77	3.50	3.70	1	1	0	1	1	1	2	2	1	1	1	2	3	1	1	3	2	2	1	1	0	1	0.02	0.00	0.15
1952662	2023-08-19 18:00:00	17	3	2.19	3.40	3.00	2.19	3.40	3.00	0	0	1	1	0	0	1	0	1	0	1	0	1	1	3	1	2	1	2	0	0	0	0.00	0.00	0.00
1952659	2023-08-20 18:00:00	17	3	1.80	3.65	4.00	1.80	3.65	4.00	0	0	1	0	1	0	0	1	1	1	0	0	1	3	1	1	1	2	2	0	0	0	0.00	0.00	0.00
2331826	2024-12-01 15:00:00	17	0	3.20	3.25	2.00	3.20	3.25	2.00	0	0	1	1	0	0	1	0	1	0	1	0	1	1	3	1	2	1	2	0	0	0	0.00	0.00	0.00
2331825	2024-12-01 13:00:00	17	3	1.78	3.25	4.00	1.78	3.25	4.00	0	0	0	0	0	0	0	0	0	1	1	1	1	1	1	1	1	1	1	0	0	0	0.00	0.00	0.00
2331824	2024-11-28 18:00:00	17	3	3.20	3.15	2.05	3.20	3.15	2.05	0	0	0	0	0	0	0	0	0	1	1	1	1	1	1	1	1	1	1	0	0	0	0.00	0.00	0.00
1952647	2023-06-06 15:30:00	17	0	4.70	4.10	1.55	4.70	4.10	1.55	1	0	0	0	0	0	1	0	0	0	1	1	1	1	2	2	3	1	1	0	0	0	0.00	0.00	0.00
1952642	2023-10-08 14:00:00	17	0	2.15	3.25	2.87	2.15	3.25	2.87	1	1	0	0	0	1	1	1	1	0	0	0	1	1	1	1	1	1	1	0	0	0	0.00	0.00	0.00
2152835	2024-10-06 14:00:00	17	1	2.88	3.45	2.07	2.88	3.45	2.07	0	0	1	1	0	0	1	0	1	0	1	0	1	1	3	1	2	1	2	0	0	0	0.00	0.00	0.00
1952681	2023-09-24 18:00:00	17	1	2.89	3.15	2.19	2.89	3.15	2.19	0	1	0	1	0	1	1	1	1	0	0	0	1	1	1	1	1	1	1	0	0	0	0.00	0.00	0.00
2152674	2024-04-07 15:30:00	17	0	2.69	3.20	2.29	2.71	3.20	2.28	0	1	1	1	0	1	1	1	2	1	1	0	2	2	2	1	1	1	3	1	0	-1	0.02	0.00	-0.01
2315488	2024-11-23 13:00:00	17	3	1.96	3.40	3.20	1.97	3.45	3.10	3	2	2	2	4	1	5	6	3	3	2	5	8	2	1	3	2	3	1	1	1	-1	0.01	0.05	-0.10
2152678	2024-04-13 15:30:00	17	3	1.68	3.40	4.30	1.68	3.40	4.30	1	1	2	2	0	1	3	1	3	1	3	1	4	1	3	1	2	1	2	0	0	0	0.00	0.00	0.00
2315499	2024-11-24 13:00:00	17	0	2.20	3.30	2.73	2.20	3.30	2.73	1	0	0	0	0	1	1	0	1	0	1	0	1	1	3	1	2	1	2	0	0	0	0.00	0.00	0.00
2152681	2024-05-15 15:30:00	17	3	2.93	3.30	2.11	2.83	3.35	2.13	2	0	4	5	1	1	7	1	5	0	6	2	7	1	3	2	3	1	2	-1	1	1	-0.10	0.05	0.02
2315498	2024-11-10 15:30:00	17	3	1.95	3.60	3.45	1.94	3.55	3.50	2	1	0	1	0	2	3	1	2	1	3	2	4	1	3	2	3	1	2	-1	-1	1	-0.01	-0.05	0.05
2152684	2024-04-20 15:30:00	17	0	2.55	3.15	2.45	2.54	3.15	2.46	1	0	1	1	0	1	2	0	2	0	2	0	2	1	3	1	2	1	2	-1	0	1	-0.01	0.00	0.01
2315501	2024-11-24 13:00:00	17	1	2.30	3.20	2.68	2.37	3.20	2.60	0	0	4	4	0	0	4	0	4	0	4	0	4	1	3	1	2	1	2	1	0	-1	0.07	0.00	-0.08
2315500	2024-11-24 13:00:00	17	3	2.03	3.35	3.00	2.03	3.40	2.99	1	1	2	2	1	1	3	2	3	0	1	0	3	1	3	1	2	1	2	0	1	-1	0.00	0.05	-0.01
2152688	2024-04-27 15:30:00	17	3	2.16	3.15	2.95	2.16	3.15	2.96	0	0	0	0	0	1	0	0	1	2	2	1	2	2	2	1	1	1	3	0	0	1	0.00	0.00	0.01
2315505	2024-10-20 14:00:00	17	3	2.30	3.35	2.87	2.32	3.40	2.83	1	0	2	1	2	0	2	2	2	1	1	1	3	1	1	1	1	1	1	1	1	-1	0.02	0.05	-0.04
2152692	2024-04-30 18:30:00	17	1	2.99	3.05	2.18	2.89	3.15	2.20	10	4	7	6	6	4	16	10	11	0	6	5	16	1	3	2	3	1	2	-1	1	1	-0.10	0.10	0.02
2152693	2024-04-28 15:30:00	17	3	1.65	3.55	4.35	1.67	3.55	4.20	2	0	4	2	1	2	4	1	6	3	6	1	7	2	3	1	2	1	3	1	0	-1	0.02	0.00	-0.15
2152694	2024-04-30 18:30:00	17	0	2.87	3.20	2.18	2.86	3.20	2.18	2	0	1	0	1	0	2	1	1	0	1	1	2	1	2	2	3	1	1	-1	0	0	-0.01	0.00	0.00
2152695	2024-05-01 18:00:00	17	0	3.15	3.35	1.99	3.20	3.35	1.97	0	0	2	2	1	0	2	1	2	0	1	0	2	1	3	1	2	1	2	1	0	-1	0.05	0.00	-0.02
2152697	2024-05-01 18:00:00	17	3	2.85	3.10	2.25	3.10	3.15	2.10	5	1	11	10	3	5	15	4	16	1	12	0	16	2	3	1	2	1	3	1	1	-1	0.25	0.05	-0.15
2152699	2024-05-04 15:30:00	17	3	2.34	3.10	2.72	2.27	3.10	2.80	8	0	6	6	0	8	14	0	14	0	14	0	14	1	3	1	2	1	2	-1	0	1	-0.07	0.00	0.08
2152700	2024-05-04 13:30:00	17	0	2.73	3.35	2.19	2.75	3.35	2.19	1	0	0	2	0	0	3	0	0	0	3	3	3	1	2	2	3	1	1	1	0	0	0.02	0.00	0.00
2152641	2024-03-02 15:30:00	17	1	2.46	2.91	2.70	2.46	2.91	2.70	0	1	0	0	0	0	0	1	0	1	0	1	1	2	1	2	1	3	1	0	0	0	0.00	0.00	0.00
2152645	2024-03-09 13:00:00	17	1	3.40	3.40	1.88	3.30	3.35	1.94	2	2	1	3	2	1	5	4	2	1	2	4	6	1	2	3	3	2	1	-1	-1	1	-0.10	-0.05	0.06
2152646	2024-03-10 15:30:00	17	3	1.95	3.10	3.50	1.96	3.10	3.50	4	0	2	4	0	2	8	0	4	1	9	5	9	1	3	2	3	1	2	1	0	0	0.01	0.00	0.00
2152649	2024-03-09 15:30:00	17	3	2.07	3.20	3.10	2.08	3.15	3.10	2	1	1	3	0	1	5	1	2	0	4	3	5	1	3	2	3	1	2	1	-1	0	0.01	-0.05	0.00
2152651	2024-03-16 15:30:00	17	1	2.07	3.25	3.05	2.03	3.30	3.10	4	0	1	1	1	2	5	1	3	1	5	3	6	1	3	2	3	1	2	-1	1	1	-0.04	0.05	0.05
2152655	2024-03-17 15:30:00	17	1	1.91	3.30	3.45	1.88	3.30	3.50	2	0	0	1	0	1	3	0	1	0	3	2	3	1	3	2	3	1	2	-1	0	1	-0.03	0.00	0.05
2152660	2024-03-30 15:30:00	17	0	2.22	3.20	2.78	2.31	3.20	2.66	3	0	3	4	0	1	7	0	4	0	7	3	7	1	3	2	3	1	2	1	0	-1	0.09	0.00	-0.12
2315477	2024-10-26 13:00:00	17	3	2.20	3.35	2.74	2.20	3.30	2.76	0	1	4	0	1	5	0	2	9	9	7	0	9	3	2	1	1	2	3	0	-1	1	0.00	-0.05	0.02
2152663	2024-03-31 15:30:00	17	0	2.19	2.93	3.10	2.19	2.97	3.05	0	1	1	0	1	1	0	2	2	2	0	0	2	3	1	1	1	2	2	0	1	-1	0.00	0.04	-0.05
2152664	2024-04-02 18:30:00	17	1	1.72	3.60	3.85	1.70	3.65	3.95	2	1	1	2	1	2	4	2	3	0	2	1	4	1	3	2	3	1	2	-1	1	1	-0.02	0.05	0.10
2315482	2024-11-02 15:30:00	17	1	2.16	3.20	2.90	2.17	3.20	2.90	5	2	4	4	2	7	9	4	11	3	8	1	12	2	3	1	2	1	3	1	0	0	0.01	0.00	0.00
2152667	2024-04-03 18:30:00	17	3	2.76	3.10	2.29	2.89	3.10	2.22	0	0	4	5	0	0	5	0	4	0	5	1	5	1	3	2	3	1	2	1	0	-1	0.13	0.00	-0.07
2315480	2024-10-27 13:00:00	17	0	2.45	3.25	2.47	2.46	3.25	2.46	1	0	1	1	0	1	2	0	2	0	2	0	2	1	3	1	2	1	2	1	0	-1	0.01	0.00	-0.01
2315487	2024-11-23 13:00:00	17	0	2.20	3.05	2.98	2.23	3.05	2.93	0	0	3	3	0	0	3	0	3	0	3	0	3	1	3	1	2	1	2	1	0	-1	0.03	0.00	-0.05
2315486	2024-11-23 13:00:00	17	3	1.97	3.30	3.25	2.01	3.25	3.20	1	1	1	4	0	0	5	1	1	0	4	4	5	1	2	2	3	1	1	1	-1	-1	0.04	-0.05	-0.05
2152671	2024-04-06 15:30:00	17	0	2.11	3.25	2.95	2.17	3.25	2.85	0	0	1	1	0	1	1	0	2	1	2	0	2	2	3	1	2	1	3	1	0	-1	0.06	0.00	-0.10
2030303	2023-07-22 20:15:00	18	0	5.60	3.90	1.55	5.50	3.85	1.56	1	2	0	0	0	2	1	2	2	1	0	0	2	3	1	1	1	2	2	-1	-1	1	-0.10	-0.05	0.01
2030495	2023-11-11 19:00:00	18	3	2.03	3.40	3.45	2.03	3.40	3.45	1	0	0	0	0	1	1	0	1	0	1	0	1	1	3	1	2	1	2	0	0	0	0.00	0.00	0.00
2030431	2023-12-03 19:00:00	18	3	1.90	3.60	3.60	1.87	3.65	3.70	4	2	2	3	2	3	7	4	5	0	3	2	7	1	3	2	3	1	2	-1	1	1	-0.03	0.05	0.10
2229731	2024-07-26 23:00:00	18	0	2.36	3.45	2.72	2.36	3.45	2.74	0	1	2	0	1	1	0	2	3	3	1	0	3	3	2	1	1	2	3	0	0	1	0.00	0.00	0.02
2030300	2023-07-22 00:00:00	18	0	2.14	3.60	2.98	2.14	3.60	2.98	0	0	1	1	0	0	1	0	1	0	1	0	1	1	3	1	2	1	2	0	0	0	0.00	0.00	0.00
2030301	2023-07-24 01:00:00	18	3	1.69	3.65	4.60	1.77	3.60	4.20	1	1	4	4	0	1	5	1	5	0	4	0	5	1	3	1	2	1	2	1	-1	-1	0.08	-0.05	-0.40
2030493	2023-11-05 21:30:00	18	3	1.53	3.90	5.80	1.53	3.90	5.80	0	1	0	0	0	0	0	1	0	1	0	1	1	2	1	2	1	3	1	0	0	0	0.00	0.00	0.00
2030490	2023-10-22 21:30:00	18	3	1.47	4.15	6.40	1.47	4.15	6.40	1	0	0	0	1	1	1	1	1	0	0	0	1	1	1	1	1	1	1	0	0	0	0.00	0.00	0.00
2030362	2023-11-25 20:15:00	18	3	1.32	4.95	8.30	1.32	4.85	8.90	1	2	1	1	0	2	2	2	3	2	2	1	4	2	2	1	1	1	3	0	-1	1	0.00	-0.10	0.60
2030299	2023-07-23 01:00:00	18	0	2.19	3.45	3.00	2.19	3.45	3.00	0	1	1	1	0	0	1	1	1	0	0	0	1	1	1	1	1	1	1	0	0	0	0.00	0.00	0.00
2229738	2024-08-03 20:00:00	18	0	3.35	3.55	1.85	3.35	3.55	1.85	0	0	1	0	0	0	0	0	1	1	1	0	1	2	2	1	1	1	3	0	0	0	0.00	0.00	0.00
2030412	2023-10-28 21:30:00	18	3	2.35	3.55	2.67	2.35	3.55	2.67	1	0	0	0	0	1	1	0	1	0	1	0	1	1	3	1	2	1	2	0	0	0	0.00	0.00	0.00
2229751	2024-08-19 22:30:00	18	0	2.83	3.20	2.40	2.83	3.20	2.40	1	0	0	0	0	1	1	0	1	0	1	0	1	1	3	1	2	1	2	0	0	0	0.00	0.00	0.00
2030344	2023-09-03 18:00:00	18	3	2.32	3.45	2.77	2.27	3.45	2.84	3	3	2	3	2	4	6	5	6	0	1	0	6	1	3	1	2	1	2	-1	0	1	-0.05	0.00	0.07
2229749	2024-08-09 23:30:00	18	3	2.59	3.40	2.51	2.59	3.40	2.51	1	0	2	2	0	1	3	0	3	0	3	0	3	1	3	1	2	1	2	0	0	0	0.00	0.00	0.00
2030340	2023-08-28 01:00:00	18	0	2.36	3.55	2.66	2.42	3.55	2.60	0	0	2	2	0	0	2	0	2	0	2	0	2	1	3	1	2	1	2	1	0	-1	0.06	0.00	-0.06
2030404	2023-10-09 00:00:00	18	1	2.44	3.55	2.57	2.44	3.55	2.57	0	1	1	1	0	0	1	1	1	0	0	0	1	1	1	1	1	1	1	0	0	0	0.00	0.00	0.00
2030335	2023-08-21 00:30:00	18	0	2.50	3.45	2.57	2.54	3.45	2.52	1	2	2	2	1	2	3	3	4	2	2	1	5	2	2	1	1	1	3	1	0	-1	0.04	0.00	-0.05
1845119	2023-06-03 22:00:00	18	3	1.41	4.35	6.00	1.43	4.50	6.30	0	1	2	1	1	2	1	2	4	3	2	0	4	3	2	1	1	2	3	1	1	1	0.02	0.15	0.30
2030394	2023-09-24 21:30:00	18	0	1.41	4.60	6.60	1.41	4.60	6.60	0	0	1	1	0	0	1	0	1	0	1	0	1	1	3	1	2	1	2	0	0	0	0.00	0.00	0.00
2030329	2023-08-21 01:00:00	18	3	2.01	3.60	3.25	2.02	3.65	3.20	3	1	2	2	2	4	5	3	6	1	3	0	6	2	3	1	2	1	3	1	1	-1	0.01	0.05	-0.05
2030324	2023-08-13 01:00:00	18	3	2.20	3.15	3.25	2.20	3.10	3.30	1	3	4	1	3	4	2	6	8	6	2	0	8	3	2	1	1	2	3	0	-1	1	0.00	-0.05	0.05
2030323	2023-08-13 20:00:00	18	3	1.61	3.95	4.85	1.61	4.00	4.80	0	0	1	0	1	0	0	1	1	2	1	1	2	3	1	1	1	2	2	0	1	-1	0.00	0.05	-0.05
2030321	2023-08-07 00:00:00	18	0	1.48	4.45	5.50	1.49	4.45	5.40	1	1	2	2	0	0	3	1	2	0	2	1	3	1	3	2	3	1	2	1	0	-1	0.01	0.00	-0.10
2030315	2023-08-06 01:00:00	18	3	1.99	3.75	3.25	2.00	3.75	3.20	3	2	4	3	3	2	6	5	6	2	3	2	8	1	3	1	2	1	2	1	0	-1	0.01	0.00	-0.05
2030312	2023-07-30 20:00:00	18	1	2.21	3.55	2.89	2.21	3.60	2.87	0	0	2	1	1	0	1	1	2	1	1	0	2	2	2	1	1	1	3	0	1	-1	0.00	0.05	-0.02
2030440	2024-03-03 21:30:00	18	3	2.20	3.50	2.93	2.28	3.55	2.79	1	1	2	1	1	1	2	2	3	3	3	2	5	2	2	1	1	1	3	1	1	-1	0.08	0.05	-0.14
2030310	2023-07-31 01:00:00	18	3	1.72	3.85	4.20	1.72	3.85	4.20	0	0	1	1	0	0	1	0	1	0	1	0	1	1	3	1	2	1	2	0	0	0	0.00	0.00	0.00
2030311	2023-07-29 20:00:00	18	1	2.35	3.55	2.67	2.36	3.55	2.66	1	0	2	1	0	0	2	0	2	0	2	0	2	1	3	1	2	1	2	1	0	-1	0.01	0.00	-0.01
2030309	2023-07-30 01:00:00	18	1	4.45	3.70	1.71	4.30	3.65	1.74	3	1	0	0	0	2	3	1	2	0	2	1	3	1	3	2	3	1	2	-1	-1	1	-0.15	-0.05	0.03
2030437	2023-12-10 19:00:00	18	1	3.05	3.25	2.25	2.98	3.20	2.31	3	2	2	6	0	3	9	2	5	0	7	4	9	1	3	2	3	1	2	-1	-1	1	-0.07	-0.05	0.06
2030501	2024-03-08 19:00:00	18	0	2.61	3.35	2.50	2.67	3.35	2.46	2	0	5	6	0	3	8	0	8	0	8	0	8	1	3	1	2	1	2	1	0	-1	0.06	0.00	-0.04
2030306	2023-07-22 18:00:00	18	3	3.60	3.20	2.04	3.60	3.20	2.04	1	1	0	0	0	1	1	1	1	0	0	0	1	1	1	1	1	1	1	0	0	0	0.00	0.00	0.00
2030304	2023-07-24 01:00:00	18	3	1.75	3.70	4.20	1.75	3.60	4.30	0	1	1	1	0	1	1	1	2	1	1	0	2	2	2	1	1	1	3	0	-1	1	0.00	-0.10	0.10
2030305	2023-07-23 22:30:00	18	3	1.53	4.20	5.30	1.53	4.25	5.30	0	1	0	0	1	0	0	2	0	2	0	2	2	2	1	2	1	3	1	0	1	0	0.00	0.05	0.00
2030497	2023-12-09 19:00:00	18	3	1.93	3.75	3.40	1.95	3.75	3.35	2	1	2	4	0	0	6	1	2	0	5	4	6	1	3	2	3	1	2	1	0	-1	0.02	0.00	-0.05
2229725	2024-07-23 01:00:00	18	0	2.97	3.00	2.43	2.83	2.99	2.55	2	1	2	1	1	2	3	2	4	1	2	0	4	2	3	1	2	1	3	-1	-1	1	-0.14	-0.01	0.12
2019358	2023-06-03 02:45:00	19	3	2.79	3.55	2.28	2.64	3.45	2.44	8	3	3	6	2	8	14	5	11	2	11	5	16	1	3	2	3	1	2	-1	-1	1	-0.15	-0.10	0.16
2019359	2023-06-07 02:45:00	19	0	1.88	3.55	3.75	1.91	3.55	3.65	9	2	8	7	3	11	16	5	19	5	16	2	21	2	3	1	2	1	3	1	0	-1	0.03	0.00	-0.10
2038557	2024-02-04 20:30:00	19	3	2.46	3.60	2.53	2.55	3.65	2.60	2	1	2	4	1	4	6	2	6	0	4	0	6	1	3	1	2	1	2	1	1	1	0.09	0.05	0.07
2038556	2024-01-21 20:30:00	19	0	2.25	3.65	2.75	2.21	3.65	3.10	1	2	0	0	1	3	1	3	3	3	1	1	4	3	1	1	1	2	2	-1	0	1	-0.04	0.00	0.35
2214949	2024-05-25 02:30:00	19	1	2.66	3.20	2.32	2.63	3.20	2.58	9	0	3	4	0	10	13	0	13	0	13	0	13	1	3	1	2	1	2	-1	0	1	-0.03	0.00	0.26
2038554	2023-12-09 20:00:00	19	0	1.63	4.35	4.30	1.61	4.55	4.80	1	0	0	0	1	1	1	1	1	1	1	1	2	1	1	1	1	1	1	-1	1	1	-0.02	0.20	0.50
2038545	2023-09-16 00:30:00	19	3	1.69	4.30	4.45	1.76	4.20	4.10	0	3	3	2	2	2	2	5	5	3	0	0	5	3	1	1	1	2	2	1	-1	-1	0.07	-0.10	-0.35
2038541	2023-08-05 00:30:00	19	0	1.58	4.20	5.60	1.59	4.15	5.60	0	1	0	2	1	1	2	2	1	0	0	1	2	1	1	3	2	2	1	1	-1	0	0.01	-0.05	0.00
2252343	2024-08-03 02:30:00	19	0	2.20	3.60	2.88	2.21	3.75	3.00	4	1	7	5	3	5	9	4	12	6	11	3	15	2	3	1	2	1	3	1	1	1	0.01	0.15	0.12
2038537	2024-04-14 19:30:00	19	0	1.42	4.45	6.50	1.40	4.55	6.80	3	0	1	0	3	5	3	3	6	4	4	1	7	2	2	1	1	1	3	-1	1	1	-0.02	0.10	0.30
2252346	2024-08-03 19:00:00	19	3	1.61	4.05	4.70	1.61	4.05	4.70	1	0	0	0	1	1	1	1	1	0	0	0	1	1	1	1	1	1	1	0	0	0	0.00	0.00	0.00
2038534	2024-03-16 01:30:00	19	0	3.40	3.60	1.98	3.45	3.70	2.04	7	3	5	7	2	6	14	5	11	6	15	9	20	1	3	2	3	1	2	1	1	1	0.05	0.10	0.06
2252347	2024-08-03 19:00:00	19	0	2.04	3.70	3.15	2.04	3.70	3.15	1	0	0	0	0	1	1	0	1	0	1	0	1	1	3	1	2	1	2	0	0	0	0.00	0.00	0.00
2038533	2024-03-10 20:30:00	19	3	1.78	3.80	3.90	1.81	3.85	4.20	0	1	2	2	1	1	2	2	3	2	2	1	4	2	2	1	1	1	3	1	1	1	0.03	0.05	0.30
2252344	2024-08-04 19:30:00	19	0	2.82	3.55	2.25	2.89	3.65	2.33	0	0	2	2	1	2	2	1	4	2	3	0	4	2	3	1	2	1	3	1	1	1	0.07	0.10	0.08
2252345	2024-08-04 19:30:00	19	3	1.84	3.75	3.70	1.84	3.80	4.10	1	0	0	0	1	1	1	1	1	1	1	1	2	1	1	1	1	1	1	0	1	1	0.00	0.05	0.40
2038531	2024-02-25 20:30:00	19	3	1.59	4.35	4.60	1.61	4.60	4.85	0	0	1	1	1	2	1	1	3	2	2	0	3	2	2	1	1	1	3	1	1	1	0.02	0.25	0.25
2252350	2024-08-04 02:30:00	19	3	1.77	3.60	4.20	1.80	3.75	4.40	4	3	6	4	4	6	8	7	12	5	6	1	13	2	3	1	2	1	3	1	1	1	0.03	0.15	0.20
2038530	2024-03-10 20:30:00	19	0	1.81	3.80	3.75	1.86	3.85	3.95	0	1	1	1	1	1	1	2	2	2	1	1	3	3	1	1	1	2	2	1	1	1	0.05	0.05	0.20
2252351	2024-08-04 19:30:00	19	0	2.79	3.45	2.31	2.91	3.50	2.38	2	1	0	1	1	2	3	2	2	0	1	1	3	1	2	2	3	1	1	1	1	1	0.12	0.05	0.07
2038529	2024-03-03 20:30:00	19	0	1.39	5.00	6.40	1.38	5.30	7.20	3	1	2	3	2	6	6	3	8	2	5	0	8	2	3	1	2	1	3	-1	1	1	-0.01	0.30	0.80
2252348	2024-08-03 19:00:00	19	1	2.00	3.55	3.35	2.00	3.55	3.35	4	1	3	4	1	4	8	2	7	2	8	3	10	1	3	2	3	1	2	0	0	0	0.00	0.00	0.00
2038528	2024-02-24 20:00:00	19	3	3.45	3.75	1.90	3.50	3.80	1.89	3	0	5	3	1	4	6	1	9	3	8	0	9	2	3	1	2	1	3	1	1	-1	0.05	0.05	-0.01
2252349	2024-08-03 19:00:00	19	3	1.98	3.55	3.40	1.89	3.65	3.65	6	1	3	3	2	4	9	3	7	0	6	2	9	1	3	2	3	1	2	-1	1	1	-0.09	0.10	0.25
2252546	2024-12-21 01:30:00	19	0	2.17	3.65	2.90	2.19	3.75	3.05	2	5	6	3	6	6	5	11	12	13	7	6	18	3	2	1	1	2	3	1	1	1	0.02	0.10	0.15
2252547	2024-12-21 20:00:00	19	3	1.59	4.25	4.70	1.59	4.40	5.20	3	3	3	3	4	6	6	7	9	8	7	5	14	3	2	1	1	2	3	0	1	1	0.00	0.15	0.50
2252544	2024-12-14 20:00:00	19	1	2.74	3.55	2.31	2.95	3.60	2.31	3	2	0	5	2	0	8	4	0	3	7	11	11	1	2	3	3	2	1	1	1	0	0.21	0.05	0.00
2252545	2024-12-14 20:00:00	19	1	2.54	3.60	2.46	2.62	3.70	2.52	5	2	8	8	4	7	13	6	15	5	12	3	18	2	3	1	2	1	3	1	1	1	0.08	0.10	0.06
2252550	2024-12-22 20:30:00	19	0	3.60	3.80	1.86	4.10	3.85	1.83	1	1	3	3	3	1	4	4	4	3	3	3	7	1	1	1	1	1	1	1	1	-1	0.50	0.05	-0.03
2252551	2024-12-21 01:30:00	19	0	2.14	3.60	2.97	2.21	3.70	3.05	3	3	4	3	5	5	6	8	9	8	6	5	14	3	2	1	1	2	3	1	1	1	0.07	0.10	0.08
2252548	2024-12-14 20:00:00	19	1	3.60	3.80	1.85	3.80	3.95	1.87	2	0	1	2	2	2	4	2	3	1	3	2	5	1	3	2	3	1	2	1	1	1	0.20	0.15	0.02
2038584	2023-08-27 19:30:00	19	3	1.75	4.05	3.80	1.75	4.05	3.80	0	0	1	0	0	0	0	0	1	1	1	0	1	2	2	1	1	1	3	0	0	0	0.00	0.00	0.00
2252549	2024-12-22 20:30:00	19	1	2.16	3.70	2.90	2.13	3.65	3.25	2	3	2	1	3	5	3	6	7	9	6	5	12	3	2	1	1	2	3	-1	-1	1	-0.03	-0.05	0.35
2252554	2024-12-21 20:00:00	19	1	2.26	3.25	3.05	2.26	3.20	3.40	0	1	1	1	0	1	1	1	2	1	1	0	2	2	2	1	1	1	3	0	-1	1	0.00	-0.05	0.35
2038582	2023-08-06 19:30:00	19	3	1.74	3.80	3.85	1.75	3.75	3.85	1	2	1	1	2	2	2	4	3	4	2	3	6	3	1	2	1	3	2	1	-1	0	0.01	-0.05	0.00
2252555	2025-01-18 20:00:00	19	1	2.94	3.60	2.17	3.20	3.70	2.14	1	2	2	5	3	1	6	5	3	0	1	3	6	1	2	3	3	2	1	1	1	-1	0.26	0.10	-0.03
2038581	2023-08-20 02:30:00	19	3	1.78	4.15	3.60	1.86	4.05	3.75	1	2	4	2	2	5	3	4	9	7	6	1	10	3	2	1	1	2	3	1	-1	1	0.08	-0.10	0.15
2252552	2024-12-22 03:30:00	19	3	1.75	3.95	3.90	1.72	4.10	4.45	6	4	5	5	6	8	11	10	13	4	5	2	15	2	3	1	2	1	3	-1	1	1	-0.03	0.15	0.55
2252553	2024-12-21 20:00:00	19	0	1.99	3.70	3.25	2.00	3.70	3.55	4	3	2	4	3	4	8	6	6	5	7	7	13	1	2	2	3	1	1	1	0	1	0.01	0.00	0.30
2038578	2024-05-19 21:30:00	19	0	2.66	3.95	2.21	2.73	4.15	2.26	1	2	1	2	3	2	3	5	3	3	1	3	6	2	1	2	1	3	1	1	1	1	0.07	0.20	0.05
2252556	2024-12-22 20:30:00	19	3	4.00	3.80	1.76	4.40	3.95	1.75	0	0	3	3	3	1	3	3	4	2	2	1	5	2	2	1	1	1	3	1	1	-1	0.40	0.15	-0.01
2252562	2025-01-19 20:30:00	19	0	2.28	3.65	2.71	2.28	3.75	2.90	0	0	3	0	2	1	0	2	4	4	2	0	4	3	2	1	1	2	3	0	1	1	0.00	0.10	0.19
2038573	2024-05-05 19:30:00	19	3	2.12	3.65	2.98	2.14	3.80	3.15	2	0	2	1	1	3	3	1	5	2	4	0	5	2	3	1	2	1	3	1	1	1	0.02	0.15	0.17
2252566	2025-01-25 20:00:00	19	3	1.72	4.00	4.00	1.72	4.30	4.25	0	0	1	0	1	1	0	1	2	2	1	0	2	3	2	1	1	2	3	0	1	1	0.00	0.30	0.25
2038568	2024-04-13 19:00:00	19	3	1.45	4.60	5.80	1.45	4.60	5.80	2	2	2	1	3	3	3	5	5	4	2	2	7	3	1	1	1	2	2	0	0	0	0.00	0.00	0.00
2038566	2024-04-06 00:30:00	19	0	2.16	3.75	2.85	2.17	3.85	3.05	1	0	2	1	2	2	2	2	4	2	2	0	4	2	2	1	1	1	3	1	1	1	0.01	0.10	0.20
2252568	2025-01-26 20:30:00	19	1	1.66	3.90	5.20	1.66	3.90	5.20	0	0	0	0	1	1	0	1	1	1	0	0	1	3	1	1	1	2	2	0	0	0	0.00	0.00	0.00
2038562	2024-03-09 20:00:00	19	1	2.16	3.60	2.94	2.16	3.60	2.94	0	1	1	1	0	0	1	1	1	0	0	0	1	1	1	1	1	1	1	0	0	0	0.00	0.00	0.00
2038619	2023-10-07 19:00:00	19	1	4.10	4.20	1.67	4.10	4.20	1.67	1	0	0	0	1	0	1	1	0	0	0	1	1	1	1	3	2	2	1	0	0	0	0.00	0.00	0.00
2252390	2024-09-21 19:00:00	19	1	2.80	3.65	2.23	2.75	3.65	2.26	4	0	0	1	0	2	5	0	2	0	5	3	5	1	3	2	3	1	2	-1	0	1	-0.05	0.00	0.03
2038614	2023-09-23 19:00:00	19	3	2.29	3.55	2.76	2.29	3.55	2.77	1	1	1	0	1	2	1	2	3	2	1	0	3	3	2	1	1	2	3	0	0	1	0.00	0.00	0.01
2038613	2023-09-16 00:30:00	19	1	2.29	3.50	2.79	2.44	3.65	2.72	7	4	9	10	4	8	17	8	17	0	9	0	17	1	3	1	2	1	2	1	1	-1	0.15	0.15	-0.07
2038611	2023-09-03 19:30:00	19	3	1.46	4.50	5.80	1.46	4.50	5.80	0	1	1	1	0	0	1	1	1	0	0	0	1	1	1	1	1	1	1	0	0	0	0.00	0.00	0.00
2252398	2024-09-28 00:30:00	19	0	2.81	3.65	2.23	3.10	3.70	2.20	4	0	4	6	1	3	10	1	7	0	9	3	10	1	3	2	3	1	2	1	1	-1	0.29	0.05	-0.03
2038610	2023-09-03 19:30:00	19	0	2.01	3.75	3.15	2.01	3.75	3.15	1	0	0	0	0	1	1	0	1	0	1	0	1	1	3	1	2	1	2	0	0	0	0.00	0.00	0.00
2252399	2024-09-29 19:30:00	19	1	1.58	4.25	4.70	1.54	4.55	5.50	4	1	2	4	3	4	8	4	6	4	8	6	12	1	3	2	3	1	2	-1	1	1	-0.04	0.30	0.80
2038609	2023-09-02 00:30:00	19	3	2.06	3.75	3.05	2.17	3.80	3.05	0	2	4	4	2	2	4	4	6	2	2	0	6	2	2	1	1	1	3	1	1	0	0.11	0.05	0.00
2252396	2024-09-21 00:30:00	19	0	1.78	3.85	3.85	1.83	4.00	3.95	3	5	8	6	5	6	9	10	14	6	5	1	15	3	2	1	1	2	3	1	1	1	0.05	0.15	0.10
2038608	2023-08-27 02:30:00	19	0	3.35	4.05	1.99	3.25	4.10	2.02	5	3	4	6	3	3	11	6	7	0	5	4	11	1	3	2	3	1	2	-1	1	1	-0.10	0.05	0.03
2038604	2023-08-06 19:30:00	19	1	2.38	3.50	2.53	2.32	3.50	2.62	1	0	1	0	1	2	1	1	3	2	2	0	3	2	2	1	1	1	3	-1	0	1	-0.06	0.00	0.09
2038603	2023-08-06 19:30:00	19	1	2.58	3.75	2.25	2.56	3.75	2.26	2	0	0	0	1	1	2	1	1	0	1	1	2	1	2	2	3	1	1	-1	0	1	-0.02	0.00	0.01
2038600	2023-11-25 01:30:00	19	1	2.14	3.60	2.99	2.20	3.70	3.05	0	2	3	1	2	3	1	4	6	5	2	0	6	3	2	1	1	2	3	1	1	1	0.06	0.10	0.06
2038599	2023-11-25 01:30:00	19	3	1.30	5.90	9.00	1.30	5.90	9.10	3	2	3	4	3	6	7	5	9	2	4	0	9	2	3	1	2	1	3	0	0	1	0.00	0.00	0.10
2038597	2023-11-05 20:30:00	19	1	2.82	3.70	2.35	2.82	3.70	2.35	0	0	0	1	1	0	1	1	0	0	0	1	1	1	1	3	2	2	1	0	0	0	0.00	0.00	0.00
2038593	2023-10-22 19:30:00	19	3	2.62	3.65	2.36	2.62	3.65	2.36	1	0	0	0	0	1	1	0	1	0	1	0	1	1	3	1	2	1	2	0	0	0	0.00	0.00	0.00
2252354	2024-08-10 19:00:00	19	1	3.05	3.65	2.08	3.20	3.65	2.03	0	2	3	2	2	0	2	4	3	4	2	3	6	3	1	2	1	3	2	1	0	-1	0.15	0.00	-0.05
2252355	2024-08-10 00:30:00	19	1	2.11	3.85	2.90	2.14	3.80	3.10	5	3	3	3	3	3	8	6	6	2	4	4	10	1	2	2	3	1	1	1	-1	1	0.03	-0.05	0.20
2252352	2024-08-11 19:30:00	19	0	2.42	3.40	2.69	2.43	3.40	2.66	2	1	2	2	1	1	4	2	3	0	2	1	4	1	3	2	3	1	2	1	0	-1	0.01	0.00	-0.03
2252353	2024-08-10 19:00:00	19	1	1.85	4.00	3.45	1.92	3.95	3.25	3	3	4	5	2	2	8	5	6	0	3	2	8	1	3	2	3	1	2	1	-1	-1	0.07	-0.05	-0.20
2214981	2024-05-29 02:30:00	19	0	1.89	3.40	3.35	1.94	3.55	3.55	8	5	7	11	6	8	19	11	15	4	12	8	23	1	3	2	3	1	2	1	1	1	0.05	0.15	0.20
2252358	2024-08-11 02:30:00	19	1	1.86	4.15	3.30	1.88	4.10	3.65	8	4	5	5	3	5	13	7	10	2	8	5	15	1	3	2	3	1	2	1	-1	1	0.02	-0.05	0.35
2252359	2024-08-10 00:30:00	19	3	2.38	3.35	2.77	2.45	3.45	2.85	2	0	2	3	2	4	5	2	6	1	4	0	6	2	3	1	2	1	3	1	1	1	0.07	0.10	0.08
2252356	2024-08-11 19:30:00	19	3	1.82	3.85	3.70	1.80	3.90	3.75	4	0	2	2	1	4	6	1	6	0	5	0	6	1	3	1	2	1	2	-1	1	1	-0.02	0.05	0.05
2038648	2024-02-04 03:30:00	19	0	2.95	3.80	2.23	2.88	3.85	2.25	6	2	1	4	4	1	10	6	2	0	4	8	10	1	2	3	3	2	1	-1	1	1	-0.07	0.05	0.02
2252357	2024-08-11 19:30:00	19	1	2.87	3.75	2.16	3.05	3.80	2.04	1	0	3	2	2	0	3	2	3	1	2	1	4	1	3	1	2	1	2	1	1	-1	0.18	0.05	-0.12
2252363	2024-08-24 00:30:00	19	3	2.51	3.45	2.54	2.41	3.65	2.77	6	0	7	8	1	7	14	1	14	0	13	0	14	1	3	1	2	1	2	-1	1	1	-0.10	0.20	0.23
2038645	2024-01-28 20:30:00	19	3	2.07	3.65	3.10	2.07	3.70	3.35	1	1	0	2	2	2	3	3	2	3	3	4	6	1	1	3	2	2	1	0	1	1	0.00	0.05	0.25
2038644	2024-01-28 03:30:00	19	0	2.63	3.45	2.44	3.30	3.55	2.14	7	4	5	11	4	2	18	8	7	0	10	11	18	1	2	3	3	2	1	1	1	-1	0.67	0.10	-0.30
2252617	2025-02-09 20:30:00	19	3	1.76	3.90	3.95	1.80	4.05	4.05	0	2	5	5	1	2	5	3	7	3	5	1	8	2	3	1	2	1	3	1	1	1	0.04	0.15	0.10
2038642	2024-01-21 03:30:00	19	0	2.53	3.75	2.38	2.56	3.85	2.51	5	0	3	3	1	4	8	1	7	0	7	1	8	1	3	2	3	1	2	1	1	1	0.03	0.10	0.13
2252367	2024-08-25 19:30:00	19	1	2.44	3.50	2.60	2.45	3.50	2.58	1	0	2	1	0	1	2	0	3	1	3	0	3	2	3	1	2	1	3	1	0	-1	0.01	0.00	-0.02
2038641	2024-01-21 20:30:00	19	1	2.44	3.55	2.57	2.55	3.65	2.60	3	1	5	6	2	3	9	3	8	0	6	1	9	1	3	2	3	1	2	1	1	1	0.11	0.10	0.03
2252364	2024-08-24 19:00:00	19	3	1.51	4.15	5.70	1.51	4.15	5.70	1	0	0	0	1	1	1	1	1	0	0	0	1	1	1	1	1	1	1	0	0	0	0.00	0.00	0.00
2252365	2024-08-10 19:00:00	19	3	2.72	3.75	2.25	2.73	3.70	2.25	1	1	0	1	1	0	2	2	0	0	0	2	2	1	1	3	2	2	1	1	-1	0	0.01	-0.05	0.00
2252371	2024-08-31 00:30:00	19	3	2.21	3.50	2.92	2.31	3.50	3.00	0	1	4	3	1	3	3	2	7	4	5	0	7	2	3	1	2	1	3	1	0	1	0.10	0.00	0.08
2038636	2023-12-17 20:30:00	19	3	2.78	3.35	2.36	2.85	3.45	2.45	1	0	1	2	1	2	3	1	3	0	2	0	3	1	3	1	2	1	2	1	1	1	0.07	0.10	0.09
2252374	2024-09-01 02:30:00	19	0	2.28	3.75	2.90	2.35	3.75	2.80	1	0	5	3	1	3	4	1	8	4	7	0	8	2	3	1	2	1	3	1	0	-1	0.07	0.00	-0.10
2038632	2023-12-10 20:30:00	19	0	1.98	3.80	3.20	1.93	3.90	3.65	6	2	1	3	3	6	9	5	7	4	8	6	13	1	3	2	3	1	2	-1	1	1	-0.05	0.10	0.45
2038631	2023-12-02 01:30:00	19	1	2.06	3.70	3.10	1.87	3.90	3.90	19	4	11	13	7	17	32	11	28	1	22	5	33	1	3	2	3	1	2	-1	1	1	-0.19	0.20	0.80
2252378	2024-09-01 19:30:00	19	0	2.82	3.70	2.19	2.96	3.90	2.19	1	1	0	1	1	1	2	2	1	0	0	1	2	1	1	3	2	2	1	1	1	0	0.14	0.20	0.00
2038627	2023-11-11 20:00:00	19	3	3.25	3.75	1.98	3.25	3.75	1.98	1	0	2	2	0	1	3	0	3	0	3	0	3	1	3	1	2	1	2	0	0	0	0.00	0.00	0.00
2252383	2024-09-15 19:30:00	19	0	2.44	3.60	2.56	2.45	3.65	2.72	5	0	2	3	1	6	8	1	8	1	8	1	9	1	3	1	2	1	2	1	1	1	0.01	0.05	0.16
2252380	2024-09-15 02:30:00	19	0	1.45	4.55	5.90	1.42	5.10	6.70	8	7	13	8	15	11	16	22	24	18	12	10	34	3	2	1	1	2	3	-1	1	1	-0.03	0.55	0.80
2038686	2023-10-29 20:30:00	19	0	2.09	3.75	2.99	2.09	3.75	2.98	0	0	2	1	0	0	1	0	2	1	2	0	2	2	3	1	2	1	3	0	0	-1	0.00	0.00	-0.01
2038683	2023-10-21 00:30:00	19	3	2.12	3.70	2.95	2.21	3.80	2.98	0	3	7	3	4	5	3	7	12	10	6	1	13	3	2	1	1	2	3	1	1	1	0.09	0.10	0.03
2252457	2024-10-26 00:30:00	19	0	1.75	4.15	3.75	1.73	4.35	4.15	5	2	2	3	6	5	8	8	7	5	5	6	13	1	1	3	2	2	1	-1	1	1	-0.02	0.20	0.40
2252464	2024-11-02 20:00:00	19	3	2.03	3.75	3.10	2.00	3.75	3.50	3	2	2	1	2	5	4	4	7	3	3	0	7	2	2	1	1	1	3	-1	0	1	-0.03	0.00	0.40
2038666	2023-08-20 19:30:00	19	0	2.31	3.75	2.63	2.31	3.75	2.63	0	0	1	0	0	2	0	0	3	3	3	0	3	2	2	1	1	1	3	0	0	0	0.00	0.00	0.00
2038665	2023-08-06 02:30:00	19	3	1.65	4.05	5.10	1.71	3.95	4.75	0	3	3	3	2	2	3	5	5	4	2	2	7	3	1	1	1	2	2	1	-1	-1	0.06	-0.10	-0.35
2038664	2024-05-11 19:00:00	19	3	2.39	3.85	2.49	2.45	3.85	2.43	2	0	3	3	0	2	5	0	5	0	5	0	5	1	3	1	2	1	2	1	0	-1	0.06	0.00	-0.06
2038661	2024-04-21 19:30:00	19	3	1.99	3.60	3.30	1.96	3.65	3.35	3	1	2	3	2	2	6	3	4	1	4	3	7	1	3	2	3	1	2	-1	1	1	-0.03	0.05	0.05
2252473	2024-11-10 03:30:00	19	1	2.25	3.60	2.80	2.28	3.55	3.00	4	4	6	7	3	6	11	7	12	3	7	2	14	2	3	1	2	1	3	1	-1	1	0.03	-0.05	0.20
2038659	2024-03-17 20:30:00	19	3	2.26	3.55	2.81	2.26	3.60	3.00	0	0	1	0	1	4	0	1	5	5	4	0	5	3	2	1	1	2	3	0	1	1	0.00	0.05	0.19
2038658	2024-03-10 20:30:00	19	3	1.64	3.95	4.70	1.67	4.00	4.95	3	0	0	1	2	4	4	2	4	0	2	0	4	1	3	1	2	1	2	1	1	1	0.03	0.05	0.25
2038657	2024-03-02 01:30:00	19	1	2.45	3.60	2.53	2.52	3.80	2.57	7	1	5	6	3	6	13	4	11	1	10	3	14	1	3	2	3	1	2	1	1	1	0.07	0.20	0.04
2038656	2024-02-24 20:00:00	19	1	2.37	3.50	2.67	2.35	3.50	2.70	4	0	2	2	0	3	6	0	5	0	6	1	6	1	3	2	3	1	2	-1	0	1	-0.02	0.00	0.03
2038708	2024-04-06 19:00:00	19	3	1.66	4.10	4.25	1.66	4.10	4.25	0	1	1	0	0	1	0	1	2	3	2	1	3	3	2	1	1	2	3	0	0	0	0.00	0.00	0.00
2038707	2024-04-07 19:30:00	19	3	1.68	3.70	4.65	1.68	3.70	4.65	0	1	0	0	0	1	0	1	1	1	0	0	1	3	1	1	1	2	2	0	0	0	0.00	0.00	0.00
2038706	2024-03-30 20:00:00	19	0	2.72	3.55	2.33	2.68	3.55	2.36	3	1	0	1	2	1	4	3	1	0	1	3	4	1	2	3	3	2	1	-1	0	1	-0.04	0.00	0.03
2038703	2024-03-17 20:30:00	19	3	1.46	4.55	5.80	1.48	4.75	5.90	3	1	4	5	2	4	8	3	8	1	6	1	9	1	3	1	2	1	2	1	1	1	0.02	0.20	0.10
2038697	2024-02-25 20:30:00	19	3	1.76	3.90	3.95	1.76	4.00	4.35	1	0	0	0	2	3	1	2	3	2	1	0	3	3	2	1	1	2	3	0	1	1	0.00	0.10	0.40
2252436	2024-10-06 19:30:00	19	0	2.32	3.50	2.73	2.31	3.50	2.75	2	0	0	0	0	2	2	0	2	0	2	0	2	1	3	1	2	1	2	-1	0	1	-0.01	0.00	0.02
2038696	2024-02-25 20:30:00	19	3	1.41	4.50	6.80	1.43	4.60	7.10	3	3	2	4	3	4	7	6	6	1	2	2	8	1	2	2	3	1	1	1	1	1	0.02	0.10	0.30
2038694	2024-02-18 20:30:00	19	3	1.35	4.85	7.80	1.35	5.10	8.70	2	3	3	2	5	5	4	8	8	7	3	3	11	3	1	1	1	2	2	0	1	1	0.00	0.25	0.90
2252447	2024-10-20 19:30:00	19	3	1.64	4.15	4.30	1.64	4.20	4.25	0	1	2	1	1	0	1	2	2	1	0	0	2	3	1	1	1	2	2	0	1	-1	0.00	0.05	-0.05
2038688	2023-10-28 19:00:00	19	3	1.62	4.10	4.55	1.62	4.15	4.55	0	1	0	0	1	0	0	2	0	2	0	2	2	2	1	2	1	3	1	0	1	0	0.00	0.05	0.00
2038750	2024-02-18 20:30:00	19	1	2.46	3.60	2.53	2.53	3.65	2.61	4	0	4	5	1	6	9	1	10	1	9	0	10	2	3	1	2	1	3	1	1	1	0.07	0.05	0.08
2038746	2024-02-03 01:30:00	19	1	2.23	3.85	2.92	2.33	3.85	2.77	0	0	4	3	1	1	3	1	5	2	4	0	5	2	3	1	2	1	3	1	0	-1	0.10	0.00	-0.15
2038745	2024-02-03 01:30:00	19	1	1.71	4.20	4.40	1.68	4.25	4.55	2	1	1	1	3	3	3	4	4	2	1	1	5	3	1	1	1	2	2	-1	1	1	-0.03	0.05	0.15
2038488	2023-08-05 00:30:00	19	1	1.66	4.10	4.90	1.69	4.10	4.70	0	0	1	1	1	1	1	1	2	1	1	0	2	2	2	1	1	1	3	1	0	-1	0.03	0.00	-0.20
2038744	2024-02-04 20:30:00	19	3	1.61	3.95	4.90	1.59	4.20	5.50	3	0	0	0	1	3	3	1	3	0	2	0	3	1	3	1	2	1	2	-1	1	1	-0.02	0.25	0.60
2252522	2024-11-30 20:00:00	19	0	2.38	3.55	2.64	2.41	3.70	2.74	4	1	0	2	2	4	6	3	4	0	3	2	6	1	3	2	3	1	2	1	1	1	0.03	0.15	0.10
2252523	2024-11-30 20:00:00	19	1	1.81	3.70	3.90	1.73	4.00	4.50	2	1	0	0	3	3	2	4	3	3	1	2	5	3	1	2	1	3	2	-1	1	1	-0.08	0.30	0.60
2038485	2023-07-29 19:00:00	19	0	2.80	3.65	2.24	2.84	3.65	2.21	0	0	1	2	0	1	2	0	2	0	2	0	2	1	3	1	2	1	2	1	0	-1	0.04	0.00	-0.03
2038741	2024-01-20 20:00:00	19	3	1.47	4.35	5.80	1.50	4.50	6.20	3	2	4	5	2	4	8	4	8	4	8	4	12	1	3	1	2	1	2	1	1	1	0.03	0.15	0.40
2038484	2023-07-29 19:00:00	19	0	2.88	3.40	2.28	2.88	3.40	2.28	0	0	0	1	0	0	1	0	0	0	1	1	1	1	2	2	3	1	1	0	0	0	0.00	0.00	0.00
2038740	2024-01-20 20:00:00	19	3	1.95	3.75	3.70	1.95	3.75	3.70	0	0	0	0	1	1	0	1	1	1	0	0	1	3	1	1	1	2	2	0	0	0	0.00	0.00	0.00
2038483	2023-07-29 19:00:00	19	1	2.13	3.70	2.93	2.13	3.70	2.93	1	0	0	0	1	1	1	1	1	0	0	0	1	1	1	1	1	1	1	0	0	0	0.00	0.00	0.00
2038739	2024-01-21 20:30:00	19	3	1.66	4.15	4.20	1.65	4.30	4.75	2	0	0	1	2	2	3	2	2	1	2	2	4	1	2	2	3	1	1	-1	1	1	-0.01	0.15	0.55
2252526	2024-11-30 01:30:00	19	0	2.20	3.65	2.84	2.23	3.60	3.05	4	3	2	4	2	2	8	5	4	4	7	8	12	1	2	3	3	2	1	1	-1	1	0.03	-0.05	0.21
2252527	2024-12-01 20:30:00	19	1	2.55	3.50	2.48	2.63	3.60	2.55	3	2	4	7	3	3	10	5	7	0	5	3	10	1	3	2	3	1	2	1	1	1	0.08	0.10	0.07
2252524	2024-12-01 20:30:00	19	0	2.41	3.65	2.56	2.48	3.75	2.63	2	0	1	1	2	2	3	2	3	1	2	1	4	1	3	1	2	1	2	1	1	1	0.07	0.10	0.07
2038480	2023-07-30 02:30:00	19	3	2.36	3.55	2.68	2.33	3.60	2.90	2	0	3	1	2	3	3	2	6	3	4	0	6	2	3	1	2	1	3	-1	1	1	-0.03	0.05	0.22
2252525	2024-11-30 01:30:00	19	0	2.33	3.75	2.61	2.36	3.80	2.75	9	1	12	14	1	9	23	2	21	0	21	2	23	1	3	2	3	1	2	1	1	1	0.03	0.05	0.14
2038735	2023-12-09 01:30:00	19	1	2.07	3.50	3.20	2.16	3.65	3.20	2	2	5	2	3	5	4	5	10	9	8	3	13	3	2	1	1	2	3	1	1	0	0.09	0.15	0.00
2252530	2024-12-07 01:30:00	19	3	2.31	3.50	2.77	2.35	3.45	3.00	1	9	8	1	7	11	2	16	19	19	5	2	21	3	2	1	1	2	3	1	-1	1	0.04	-0.05	0.23
2038478	2023-07-29 02:30:00	19	3	2.28	3.65	2.97	2.35	3.65	2.86	0	1	4	3	0	2	3	1	6	3	5	0	6	2	3	1	2	1	3	1	0	-1	0.07	0.00	-0.11
2252531	2024-12-07 20:00:00	19	3	2.71	3.70	2.28	2.77	3.80	2.36	1	0	0	1	1	3	2	1	3	1	2	0	3	2	3	1	2	1	3	1	1	1	0.06	0.10	0.08
2252528	2024-12-01 20:30:00	19	1	2.32	3.40	2.83	2.36	3.45	2.97	3	0	3	1	2	4	4	2	7	3	5	0	7	2	3	1	2	1	3	1	1	1	0.04	0.05	0.14
2038732	2023-12-02 20:00:00	19	3	1.82	3.95	4.05	1.82	3.95	4.05	0	0	0	0	0	1	0	0	1	1	1	0	1	2	2	1	1	1	3	0	0	0	0.00	0.00	0.00
2252529	2024-12-08 20:30:00	19	3	1.75	3.75	4.15	1.82	3.80	4.20	2	2	4	4	2	4	6	4	8	3	5	1	9	2	3	1	2	1	3	1	1	1	0.07	0.05	0.05
2252534	2024-12-07 20:00:00	19	3	2.20	3.60	2.89	2.20	3.60	3.15	0	2	3	0	3	3	0	5	6	6	1	0	6	3	2	1	1	2	3	0	0	1	0.00	0.00	0.26
2038730	2023-11-26 20:30:00	19	0	2.21	3.60	2.86	2.21	3.60	2.86	0	0	2	0	0	3	0	0	5	5	5	0	5	2	2	1	1	1	3	0	0	0	0.00	0.00	0.00
2252535	2024-12-07 01:30:00	19	0	1.83	3.70	3.80	1.74	4.05	4.35	5	3	7	2	7	9	7	10	16	13	10	4	20	3	2	1	1	2	3	-1	1	1	-0.09	0.35	0.55
2252532	2024-12-08 20:30:00	19	1	1.97	3.75	3.25	1.94	3.95	3.55	6	3	2	2	5	5	8	8	7	3	3	4	11	1	1	3	2	2	1	-1	1	1	-0.03	0.20	0.30
2038728	2023-11-12 20:30:00	19	3	2.88	3.45	2.26	2.97	3.70	2.26	0	0	0	2	1	0	2	1	0	0	1	2	2	1	2	3	3	2	1	1	1	0	0.09	0.25	0.00
2252533	2024-12-07 20:00:00	19	3	1.58	3.85	5.30	1.57	4.05	6.00	1	0	1	0	2	2	1	2	3	2	1	0	3	3	2	1	1	2	3	-1	1	1	-0.01	0.20	0.70
2038727	2024-05-19 21:30:00	19	3	1.91	3.80	3.40	1.92	3.95	3.65	1	1	2	3	2	1	4	3	3	2	3	3	6	1	2	2	3	1	1	1	1	1	0.01	0.15	0.25
2252538	2024-12-15 20:30:00	19	0	2.70	3.50	2.36	2.90	3.55	2.36	2	0	0	2	1	0	4	1	0	0	3	4	4	1	2	3	3	2	1	1	1	0	0.20	0.05	0.00
2252539	2024-12-15 20:30:00	19	3	1.65	4.00	4.45	1.65	4.10	5.00	0	0	1	0	1	1	0	1	2	2	1	0	2	3	2	1	1	2	3	0	1	1	0.00	0.10	0.55
2038725	2024-05-19 21:30:00	19	3	2.19	3.80	2.77	2.19	3.95	2.93	0	1	3	0	2	2	0	3	5	5	2	0	5	3	2	1	1	2	3	0	1	1	0.00	0.15	0.16
2252536	2024-12-08 03:30:00	19	0	2.57	3.40	2.51	2.64	3.40	2.64	7	2	7	9	2	8	16	4	15	0	12	1	16	1	3	2	3	1	2	1	0	1	0.07	0.00	0.13
2038724	2024-05-19 21:30:00	19	3	1.86	4.05	3.40	1.86	4.15	3.70	1	2	2	1	4	3	2	6	5	5	1	2	7	3	1	2	1	3	2	0	1	1	0.00	0.10	0.30
2252537	2024-12-08 20:30:00	19	0	5.60	4.35	1.48	6.00	4.65	1.49	3	0	2	3	3	2	6	3	4	2	5	4	8	1	3	2	3	1	2	1	1	1	0.40	0.30	0.01
2252542	2024-12-15 20:30:00	19	3	2.65	3.60	2.35	2.92	3.55	2.35	2	1	0	3	1	0	5	2	0	0	3	5	5	1	2	3	3	2	1	1	-1	0	0.27	-0.05	0.00
2252543	2024-12-14 01:30:00	19	3	1.41	4.45	6.60	1.45	4.60	6.90	4	5	8	7	6	6	11	11	14	7	7	4	18	2	2	1	1	1	3	1	1	1	0.04	0.15	0.30
2252540	2024-12-15 03:30:00	19	3	1.89	3.75	3.50	1.85	3.75	4.10	9	6	9	8	4	14	17	10	23	9	16	3	26	2	3	1	2	1	3	-1	0	1	-0.04	0.00	0.60
2252541	2024-12-14 01:30:00	19	0	1.66	4.10	4.90	1.66	4.00	5.10	1	5	5	1	4	7	2	9	12	10	3	0	12	3	2	1	1	2	3	0	-1	1	0.00	-0.10	0.20
2038783	2024-05-19 21:30:00	19	0	2.78	3.90	2.16	3.10	3.80	2.16	1	1	0	1	1	0	2	2	0	0	0	2	2	1	1	3	2	2	1	1	-1	0	0.32	-0.10	0.00
2252482	2024-11-24 03:30:00	19	1	1.64	4.25	4.30	1.64	4.20	4.90	3	3	3	3	3	4	6	6	7	3	3	2	9	2	2	1	1	1	3	0	-1	1	0.00	-0.05	0.60
2038781	2024-05-12 19:30:00	19	0	2.04	3.75	3.10	2.02	3.80	3.10	4	0	2	1	1	3	5	1	5	1	5	1	6	1	3	1	2	1	2	-1	1	0	-0.02	0.05	0.00
2252486	2024-11-23 01:30:00	19	3	1.93	3.75	3.35	1.96	3.75	3.65	5	2	5	6	3	4	11	5	9	3	9	5	14	1	3	2	3	1	2	1	0	1	0.03	0.00	0.30
2252487	2024-11-23 01:30:00	19	0	3.75	4.05	1.77	4.30	3.90	1.78	6	7	4	9	4	4	15	11	8	2	6	9	17	1	2	3	3	2	1	1	-1	1	0.55	-0.15	0.01
2252485	2024-11-24 20:30:00	19	3	2.16	3.60	2.96	2.16	3.65	3.20	1	1	1	0	2	4	1	3	5	4	2	0	5	3	2	1	1	2	3	0	1	1	0.00	0.05	0.24
2038518	2024-01-20 20:00:00	19	1	2.38	3.65	2.81	2.38	3.65	2.81	0	0	0	0	1	1	0	1	1	1	0	0	1	3	1	1	1	2	2	0	0	0	0.00	0.00	0.00
2038774	2024-04-27 19:00:00	19	0	1.79	3.90	3.80	1.79	3.90	3.75	0	0	1	0	0	1	0	0	2	2	2	0	2	2	2	1	1	1	3	0	0	-1	0.00	0.00	-0.05
2038516	2023-12-16 20:00:00	19	1	1.40	4.65	6.60	1.42	5.00	6.90	3	0	1	2	3	3	5	3	4	1	3	2	6	1	3	2	3	1	2	1	1	1	0.02	0.35	0.30
2038772	2024-04-20 19:00:00	19	1	1.81	3.55	4.05	1.80	3.60	4.10	3	1	2	2	1	2	5	2	4	0	3	1	5	1	3	2	3	1	2	-1	1	1	-0.01	0.05	0.05
2252489	2024-11-30 20:00:00	19	1	1.68	3.85	4.40	1.67	4.00	4.95	1	1	0	0	2	2	1	3	2	3	1	2	4	3	1	2	1	3	2	-1	1	1	-0.01	0.15	0.55
2038512	2023-12-03 20:30:00	19	3	2.06	3.70	3.10	2.06	3.80	3.30	0	0	1	1	1	1	1	1	2	1	1	0	2	2	2	1	1	1	3	0	1	1	0.00	0.10	0.20
2038510	2023-11-25 20:00:00	19	3	2.36	3.60	2.65	2.36	3.60	2.65	1	0	1	1	0	1	2	0	2	1	3	1	3	1	3	1	2	1	2	0	0	0	0.00	0.00	0.00
2038509	2023-11-11 01:30:00	19	0	2.05	3.55	3.20	2.12	3.90	3.10	5	1	5	4	3	3	9	4	8	2	7	3	11	1	3	2	3	1	2	1	1	-1	0.07	0.35	-0.10
2038508	2023-11-11 20:00:00	19	3	2.25	3.40	2.91	2.25	3.45	2.90	0	1	1	0	1	0	0	2	1	2	0	1	2	3	1	2	1	3	2	0	1	-1	0.00	0.05	-0.01
2038502	2023-10-21 00:30:00	19	3	1.79	3.85	3.85	1.82	3.90	4.10	0	2	2	1	2	2	1	4	4	4	1	1	5	3	1	1	1	2	2	1	1	1	0.03	0.05	0.25
2038756	2024-03-09 20:00:00	19	3	2.14	3.65	2.97	2.11	3.70	2.99	1	0	5	0	2	2	1	2	7	6	5	0	7	3	2	1	1	2	3	-1	1	1	-0.03	0.05	0.02
2306407	2024-10-27 14:00:00	20	3	1.65	3.60	4.15	1.69	3.60	3.95	1	0	1	1	0	0	2	0	1	0	2	1	2	1	3	2	3	1	2	1	0	-1	0.04	0.00	-0.20
2095956	2023-10-08 14:30:00	20	3	1.81	3.45	3.85	1.76	3.50	4.05	1	1	1	1	1	1	2	2	2	0	0	0	2	1	1	1	1	1	1	-1	1	1	-0.05	0.05	0.20
2019408	2023-06-14 18:00:00	20	3	1.21	5.50	9.70	1.23	5.50	7.90	8	3	8	5	8	9	13	11	17	5	7	1	18	2	3	1	2	1	3	1	0	-1	0.02	0.00	-1.80
2019409	2023-06-21 18:00:00	20	1	1.57	3.55	5.00	1.57	3.55	5.00	0	0	0	0	1	0	0	1	0	1	0	1	1	2	1	2	1	3	1	0	0	0	0.00	0.00	0.00
2197947	2024-06-12 18:00:00	20	3	2.62	3.25	2.33	2.62	3.20	2.33	2	4	2	4	1	3	6	5	5	2	3	3	8	1	2	2	3	1	1	0	-1	0	0.00	-0.05	0.00
2240057	2024-08-21 18:00:00	20	3	2.03	3.20	3.15	2.03	3.20	3.15	3	0	1	2	0	2	5	0	3	2	7	4	7	1	3	2	3	1	2	0	0	0	0.00	0.00	0.00
2197949	2024-06-12 18:00:00	20	3	2.02	3.05	3.35	2.02	3.05	3.35	0	0	0	0	0	0	0	0	0	1	1	1	1	1	1	1	1	1	1	0	0	0	0.00	0.00	0.00
2197948	2024-06-12 18:00:00	20	1	3.80	3.10	1.87	3.75	3.10	1.89	1	0	0	0	0	1	1	0	1	1	2	1	2	1	3	1	2	1	2	-1	0	1	-0.05	0.00	0.02
2197951	2024-06-12 18:00:00	20	3	2.00	3.10	3.30	2.00	3.10	3.30	0	0	0	0	0	0	0	0	0	1	1	1	1	1	1	1	1	1	1	0	0	0	0.00	0.00	0.00
2240061	2024-08-21 18:00:00	20	0	3.05	3.20	2.06	2.89	3.20	2.15	4	0	3	3	0	4	7	0	7	1	8	1	8	1	3	1	2	1	2	-1	0	1	-0.16	0.00	0.09
2197953	2024-06-12 18:00:00	20	0	2.40	3.05	2.67	2.40	3.05	2.67	0	0	0	0	0	0	0	0	0	1	1	1	1	1	1	1	1	1	1	0	0	0	0.00	0.00	0.00
2197952	2024-06-12 18:00:00	20	0	1.52	3.60	5.40	1.52	3.60	5.40	2	0	1	1	0	1	3	0	2	1	4	2	4	1	3	2	3	1	2	0	0	0	0.00	0.00	0.00
2287555	2024-09-18 18:00:00	20	0	2.75	3.25	2.23	2.90	3.30	2.12	4	0	2	2	1	1	6	1	3	1	6	4	7	1	3	2	3	1	2	1	1	-1	0.15	0.05	-0.11
2287552	2024-09-11 17:30:00	20	0	1.68	3.55	4.10	1.68	3.55	4.15	0	0	0	0	0	1	0	0	1	2	2	1	2	2	2	1	1	1	3	0	0	1	0.00	0.00	0.05
2197954	2024-06-12 18:00:00	20	0	2.05	3.25	3.05	1.99	3.25	3.15	1	1	1	1	1	1	2	2	2	1	1	1	3	1	1	1	1	1	1	-1	0	1	-0.06	0.00	0.10
2287553	2024-09-25 18:00:00	20	3	1.96	3.30	3.25	2.05	3.25	3.05	3	3	4	4	3	3	7	6	7	0	1	0	7	1	3	1	2	1	2	1	-1	-1	0.09	-0.05	-0.20
2116039	2023-12-09 13:00:00	20	1	1.78	3.35	3.85	1.89	3.30	3.50	3	3	6	5	2	4	8	5	10	3	6	1	11	2	3	1	2	1	3	1	-1	-1	0.11	-0.05	-0.35
2228549	2024-07-10 17:30:00	20	0	4.10	3.70	1.66	4.25	3.60	1.65	3	3	3	4	2	2	7	5	5	1	3	3	8	1	2	2	3	1	1	1	-1	-1	0.15	-0.10	-0.01
2061106	2023-08-02 18:00:00	20	3	2.58	3.15	2.40	2.60	3.10	2.41	0	1	1	2	0	1	2	1	2	0	1	0	2	1	3	1	2	1	2	1	-1	1	0.02	-0.05	0.01
2228561	2024-07-10 18:00:00	20	3	4.85	3.85	1.53	5.10	3.85	1.51	1	1	2	3	1	0	4	2	2	1	3	3	5	1	2	2	3	1	1	1	0	-1	0.25	0.00	-0.02
2228566	2024-07-10 18:00:00	20	1	4.25	3.95	1.58	4.30	3.95	1.58	4	3	5	5	3	4	9	6	9	1	4	1	10	1	3	1	2	1	2	1	0	0	0.05	0.00	0.00
2228565	2024-07-10 18:00:00	20	3	2.52	3.20	2.44	2.36	3.20	2.60	4	0	2	2	0	4	6	0	6	1	7	1	7	1	3	1	2	1	2	-1	0	1	-0.16	0.00	0.16
2322201	2024-11-23 13:00:00	20	0	3.10	3.05	2.13	3.10	3.05	2.13	1	0	0	0	1	0	1	1	0	0	0	1	1	1	1	3	2	2	1	0	0	0	0.00	0.00	0.00
2035735	2024-01-14 02:00:00	21	3	2.60	3.05	2.74	2.70	2.97	2.68	3	4	4	6	2	6	9	6	10	5	8	4	14	2	3	1	2	1	3	1	-1	-1	0.10	-0.08	-0.06
2035734	2024-01-14 02:00:00	21	3	1.86	3.40	4.00	1.89	3.40	3.90	0	1	2	2	0	0	2	1	2	0	1	0	2	1	3	1	2	1	2	1	0	-1	0.03	0.00	-0.10
2035986	2024-04-14 01:00:00	21	0	2.02	3.40	3.45	1.99	3.40	3.55	4	1	1	1	2	3	5	3	4	0	2	1	5	1	3	2	3	1	2	-1	0	1	-0.03	0.00	0.10
2035729	2023-12-16 22:00:00	21	3	1.62	3.60	5.40	1.62	3.60	5.50	3	2	2	2	2	4	5	4	6	1	2	0	6	2	3	1	2	1	3	0	0	1	0.00	0.00	0.10
2035984	2024-04-13 21:00:00	21	3	3.60	3.05	2.12	3.55	3.05	2.13	3	1	3	3	1	3	6	2	6	0	4	0	6	1	3	1	2	1	2	-1	0	1	-0.05	0.00	0.01
2035727	2023-12-17 02:00:00	21	0	3.70	3.45	1.92	3.85	3.50	1.87	1	1	3	3	2	1	4	3	4	1	2	1	5	1	3	1	2	1	2	1	1	-1	0.15	0.05	-0.05
2035983	2024-04-06 21:00:00	21	3	1.41	4.35	7.20	1.41	4.55	6.80	3	0	5	2	4	5	5	4	10	5	6	0	10	2	3	1	2	1	3	0	1	-1	0.00	0.20	-0.40
2035979	2024-04-07 01:00:00	21	3	2.02	3.20	3.65	2.06	3.20	3.55	2	1	3	3	1	2	5	2	5	0	3	0	5	1	3	1	2	1	2	1	0	-1	0.04	0.00	-0.10
2035722	2023-12-03 02:00:00	21	1	2.43	2.90	3.10	2.57	2.83	2.96	1	6	4	7	1	1	8	7	5	1	2	4	9	1	2	3	3	2	1	1	-1	-1	0.14	-0.07	-0.14
2035975	2024-04-09 02:45:00	21	3	1.42	4.20	7.30	1.42	4.15	7.40	5	4	7	6	3	7	11	7	14	5	9	2	16	2	3	1	2	1	3	0	-1	1	0.00	-0.05	0.10
2035717	2023-11-12 02:00:00	21	3	1.99	3.35	3.55	1.99	3.35	3.55	2	0	1	1	1	2	3	1	3	0	2	0	3	1	3	1	2	1	2	0	0	0	0.00	0.00	0.00
2035973	2024-03-30 22:00:00	21	0	4.85	3.55	1.69	5.30	3.60	1.64	1	1	2	3	2	2	4	3	4	1	2	1	5	1	3	1	2	1	2	1	1	-1	0.45	0.05	-0.05
2035716	2023-11-12 02:00:00	21	3	1.83	3.45	4.15	1.86	3.40	4.05	0	1	2	2	1	0	2	2	2	0	0	0	2	1	1	1	1	1	1	1	-1	-1	0.03	-0.05	-0.10
2035715	2023-11-04 22:00:00	21	0	1.92	3.40	3.80	1.85	3.45	4.05	4	1	1	1	3	4	5	4	5	0	1	0	5	1	3	1	2	1	2	-1	1	1	-0.07	0.05	0.25
2262332	2024-11-02 03:00:00	21	3	2.30	3.35	2.91	2.35	3.30	2.86	2	1	2	2	0	5	4	1	7	3	6	0	7	2	3	1	2	1	3	1	-1	-1	0.05	-0.05	-0.05
2036027	2024-05-04 21:00:00	21	3	1.81	3.65	3.95	1.80	3.70	3.90	4	1	6	4	2	6	8	3	12	5	10	1	13	2	3	1	2	1	3	-1	1	-1	-0.01	0.05	-0.05
2036024	2024-05-04 02:00:00	21	3	1.81	3.65	3.95	1.81	3.65	3.95	0	1	1	1	0	0	1	1	1	0	0	0	1	1	1	1	1	1	1	0	0	0	0.00	0.00	0.00
2035766	2023-09-17 01:00:00	21	0	2.01	3.25	3.65	1.96	3.30	3.75	1	0	1	1	1	1	2	1	2	0	1	0	2	1	3	1	2	1	2	-1	1	1	-0.05	0.05	0.10
2035761	2023-09-03 01:00:00	21	1	2.31	3.30	2.91	2.32	3.30	2.90	0	0	2	1	1	0	1	1	2	1	1	0	2	2	2	1	1	1	3	1	0	-1	0.01	0.00	-0.01
2262285	2024-10-01 02:45:00	21	3	2.07	3.20	3.30	1.98	3.35	3.65	6	2	3	6	3	7	12	5	10	1	8	3	13	1	3	2	3	1	2	-1	1	1	-0.09	0.15	0.35
2036011	2024-04-24 02:45:00	21	3	2.41	3.25	2.80	2.37	3.35	2.79	5	1	5	4	3	4	9	4	9	1	6	1	10	1	3	1	2	1	2	-1	1	-1	-0.04	0.10	-0.01
2035748	2023-08-20 01:00:00	21	3	2.06	3.30	3.45	2.17	3.20	3.25	1	4	4	4	2	3	5	6	7	3	2	1	8	3	2	1	1	2	3	1	-1	-1	0.11	-0.10	-0.20
2262302	2024-10-19 02:00:00	21	1	2.78	3.35	2.36	2.57	3.35	2.57	13	1	6	7	0	14	20	1	20	0	19	0	20	1	3	1	2	1	2	-1	0	1	-0.21	0.00	0.21
2262303	2024-10-19 02:00:00	21	3	3.10	3.20	2.25	3.05	3.15	2.29	3	1	1	1	0	3	4	1	4	0	3	0	4	1	3	1	2	1	2	-1	-1	1	-0.05	-0.05	0.04
2036001	2024-04-20 21:00:00	21	3	2.84	3.60	2.23	2.82	3.60	2.23	2	0	0	0	1	0	2	1	0	0	1	2	2	1	2	3	3	2	1	-1	0	0	-0.02	0.00	0.00
2262368	2025-01-04 03:00:00	21	0	2.24	3.10	3.20	2.66	2.97	2.72	5	5	10	10	2	7	15	7	17	4	12	2	19	2	3	1	2	1	3	1	-1	-1	0.42	-0.13	-0.48
2230113	2024-08-27 02:45:00	21	3	2.32	3.05	3.15	2.47	2.99	2.94	0	2	2	2	1	1	2	3	3	2	1	1	4	3	1	1	1	2	2	1	-1	-1	0.15	-0.06	-0.21
2262374	2025-01-11 03:00:00	21	1	2.42	3.25	2.78	2.47	3.25	2.73	1	3	5	4	2	2	5	5	7	3	3	1	8	2	2	1	1	1	3	1	0	-1	0.05	0.00	-0.05
2262375	2025-01-11 03:00:00	21	0	2.46	3.10	2.83	2.45	3.15	2.82	2	1	1	0	1	1	2	2	2	0	0	0	2	1	1	1	1	1	1	-1	1	-1	-0.01	0.05	-0.01
2262378	2025-01-11 03:00:00	21	3	2.23	3.40	2.98	2.42	3.45	2.65	4	5	9	8	7	7	12	12	16	8	8	4	20	2	2	1	1	1	3	1	1	-1	0.19	0.05	-0.33
2262376	2025-01-11 03:00:00	21	1	1.97	3.40	3.60	1.97	3.40	3.60	0	0	1	1	1	0	1	1	1	0	0	0	1	1	1	1	1	1	1	0	0	0	0.00	0.00	0.00
2035794	2023-10-28 21:00:00	21	1	1.76	3.60	4.25	1.71	3.70	4.45	1	0	1	1	1	1	2	1	2	0	1	0	2	1	3	1	2	1	2	-1	1	1	-0.05	0.10	0.20
2036050	2024-05-18 02:45:00	21	0	1.90	3.45	3.50	1.86	3.55	3.85	11	3	7	6	5	11	17	8	18	2	11	1	19	2	3	1	2	1	3	-1	1	1	-0.04	0.10	0.35
2036049	2024-05-18 02:45:00	21	0	2.34	3.15	2.81	2.25	3.40	2.92	12	2	11	5	7	8	17	9	19	6	14	4	23	2	3	1	2	1	3	-1	1	1	-0.09	0.25	0.11
2262381	2025-01-19 03:00:00	21	0	2.89	3.10	2.43	2.45	3.10	2.85	11	0	3	4	0	12	15	0	15	0	15	0	15	1	3	1	2	1	2	-1	0	1	-0.44	0.00	0.42
2036047	2024-05-18 02:45:00	21	1	3.20	3.45	2.00	4.05	3.70	1.78	2	1	14	12	6	2	14	7	16	3	10	1	17	2	3	1	2	1	3	1	1	-1	0.85	0.25	-0.22
2262386	2025-01-18 21:00:00	21	3	2.40	2.96	3.05	2.40	2.96	3.05	0	1	0	1	0	0	1	1	0	0	0	1	1	1	1	3	2	2	1	0	0	0	0.00	0.00	0.00
2262387	2025-01-25 03:00:00	21	3	1.67	3.65	4.85	1.64	3.70	5.00	5	3	4	3	5	6	8	8	10	2	2	0	10	2	2	1	1	1	3	-1	1	1	-0.03	0.05	0.15
2036042	2024-05-11 02:45:00	21	1	1.72	3.85	4.20	1.77	3.85	3.90	2	6	12	3	9	8	5	15	20	16	6	1	21	3	2	1	1	2	3	1	0	-1	0.05	0.00	-0.30
2035782	2023-10-07 21:00:00	21	0	1.91	3.30	4.00	1.83	3.30	4.35	3	0	0	0	1	3	3	1	3	0	2	0	3	1	3	1	2	1	2	-1	0	1	-0.08	0.00	0.35
2036035	2024-05-11 02:45:00	21	1	3.60	3.35	1.98	3.50	3.50	1.97	16	7	10	11	12	13	27	19	23	10	18	14	37	1	3	2	3	1	2	-1	1	-1	-0.10	0.15	-0.01
2035833	2023-09-03 01:00:00	21	1	1.58	4.00	5.10	1.58	3.95	5.10	0	1	0	0	1	0	0	2	0	2	0	2	2	2	1	2	1	3	1	0	-1	0	0.00	-0.05	0.00
2262341	2024-11-09 21:00:00	21	3	1.85	3.65	3.75	1.86	3.70	3.70	2	1	2	2	2	2	4	3	4	1	2	1	5	1	3	1	2	1	2	1	1	-1	0.01	0.05	-0.05
2035829	2023-08-13 01:00:00	21	0	1.71	3.65	4.50	1.71	3.65	4.50	0	0	1	0	0	0	0	0	1	1	1	0	1	2	2	1	1	1	3	0	0	0	0.00	0.00	0.00
2262345	2024-11-23 03:00:00	21	1	3.15	3.20	2.21	3.10	3.30	2.19	7	4	3	5	5	3	12	9	6	7	10	13	19	1	2	3	3	2	1	-1	1	-1	-0.05	0.10	-0.02
2035827	2023-12-07 02:00:00	21	0	2.81	3.10	2.50	2.53	3.10	2.75	13	3	11	12	3	14	25	6	25	1	20	1	26	1	3	1	2	1	2	-1	0	1	-0.28	0.00	0.25
2262350	2024-11-23 03:00:00	21	3	2.08	3.45	3.25	2.12	3.35	3.20	2	2	2	3	1	1	5	3	3	1	3	3	6	1	2	2	3	1	1	1	-1	-1	0.04	-0.10	-0.05
2230095	2024-08-17 20:30:00	21	0	2.40	3.20	2.85	2.40	3.20	2.85	0	0	1	0	0	0	0	0	1	1	1	0	1	2	2	1	1	1	3	0	0	0	0.00	0.00	0.00
2262348	2024-11-23 21:00:00	21	1	1.62	3.85	4.90	1.62	3.85	4.90	1	0	0	0	1	1	1	1	1	0	0	0	1	1	1	1	1	1	1	0	0	0	0.00	0.00	0.00
2262349	2024-11-26 03:45:00	21	3	2.07	3.20	3.50	1.92	3.25	3.95	15	3	2	7	4	8	22	7	10	3	18	15	25	1	3	2	3	1	2	-1	1	1	-0.15	0.05	0.45
2262355	2024-12-07 21:00:00	21	0	2.41	3.05	2.94	2.41	3.05	2.94	1	0	0	0	0	1	1	0	1	0	1	0	1	1	3	1	2	1	2	0	0	0	0.00	0.00	0.00
2035821	2023-12-03 02:00:00	21	1	2.25	3.05	3.25	2.29	3.05	3.20	0	0	2	1	1	0	1	1	2	1	1	0	2	2	2	1	1	1	3	1	0	-1	0.04	0.00	-0.05
2262352	2024-11-23 03:00:00	21	1	2.20	3.25	3.15	2.25	3.20	3.10	0	3	4	2	2	2	2	5	6	4	1	0	6	3	2	1	1	2	3	1	-1	-1	0.05	-0.05	-0.05
2262358	2024-12-07 03:00:00	21	3	2.34	3.15	3.00	2.42	3.10	2.89	1	2	3	2	1	3	3	3	6	3	3	0	6	2	2	1	1	1	3	1	-1	-1	0.08	-0.05	-0.11
2035817	2023-11-26 02:00:00	21	0	3.35	3.35	2.07	3.25	3.35	2.12	2	1	2	2	2	2	4	3	4	1	2	1	5	1	3	1	2	1	2	-1	0	1	-0.10	0.00	0.05
2230101	2024-08-20 02:45:00	21	1	2.01	3.30	3.55	2.08	3.30	3.40	7	0	4	6	0	3	13	0	7	0	13	6	13	1	3	2	3	1	2	1	0	-1	0.07	0.00	-0.15
2262357	2024-12-10 03:45:00	21	3	1.75	3.55	4.40	1.87	3.40	4.00	13	11	17	13	8	14	26	19	31	7	14	2	33	2	3	1	2	1	3	1	-1	-1	0.12	-0.15	-0.40
2262362	2024-12-14 21:00:00	21	3	2.05	3.40	3.35	2.00	3.40	3.50	7	0	1	2	1	4	9	1	5	0	8	4	9	1	3	2	3	1	2	-1	0	1	-0.05	0.00	0.15
2262363	2024-12-14 03:00:00	21	1	2.43	3.30	2.73	2.44	3.25	2.74	8	3	6	5	4	7	13	7	13	2	8	2	15	1	3	1	2	1	2	1	-1	1	0.01	-0.05	0.01
2262361	2024-12-07 03:00:00	21	3	1.46	4.20	6.60	1.42	4.35	7.10	13	9	11	10	12	17	23	21	28	12	14	7	35	2	3	1	2	1	3	-1	1	1	-0.04	0.15	0.50
2262366	2025-01-05 03:00:00	21	3	4.00	3.45	1.85	4.10	3.50	1.82	7	2	6	7	3	6	14	5	12	0	9	2	14	1	3	2	3	1	2	1	1	-1	0.10	0.05	-0.03
2262364	2024-12-14 03:00:00	21	3	1.75	3.45	4.60	1.68	3.50	5.00	5	5	4	1	7	9	6	12	13	7	1	0	13	3	2	1	1	2	3	-1	1	1	-0.07	0.05	0.40
2262365	2024-12-14 03:00:00	21	3	2.40	3.10	2.94	2.61	2.88	2.86	6	13	8	8	6	8	14	19	16	9	4	7	23	3	1	2	1	3	2	1	-1	-1	0.21	-0.22	-0.08
2035870	2024-01-24 03:45:00	21	0	2.34	3.05	3.05	2.51	3.05	2.84	2	3	7	8	2	2	10	5	9	2	7	3	12	1	3	2	3	1	2	1	0	-1	0.17	0.00	-0.21
2035865	2024-01-14 02:00:00	21	0	2.58	3.05	2.74	2.61	3.05	2.72	0	0	2	2	0	1	2	0	3	1	3	0	3	2	3	1	2	1	3	1	0	-1	0.03	0.00	-0.02
2035862	2024-01-16 03:45:00	21	3	1.71	3.85	4.25	1.79	3.80	3.90	0	2	4	4	1	1	4	3	5	3	4	2	7	2	3	1	2	1	3	1	-1	-1	0.08	-0.05	-0.35
2035853	2023-12-17 02:00:00	21	1	1.85	3.45	4.00	1.83	3.45	4.10	2	1	2	1	2	2	3	3	4	1	1	0	4	2	2	1	1	1	3	-1	0	1	-0.02	0.00	0.10
2035900	2024-02-04 02:00:00	21	1	3.75	3.55	1.81	3.90	3.65	1.82	1	2	2	3	1	1	4	3	3	2	3	3	6	1	2	2	3	1	1	1	1	1	0.15	0.10	0.01
2262407	2025-02-08 03:00:00	21	3	1.75	3.55	4.40	1.75	3.55	4.40	3	4	4	3	5	3	6	9	7	3	0	2	9	3	1	2	1	3	2	0	0	0	0.00	0.00	0.00
2035897	2024-02-04 02:00:00	21	3	2.06	3.25	3.25	2.13	3.20	3.35	4	2	5	6	1	3	10	3	8	1	8	3	11	1	3	2	3	1	2	1	-1	1	0.07	-0.05	0.10
2035894	2024-02-06 03:45:00	21	3	2.40	2.73	3.15	2.38	2.80	3.30	2	9	3	1	7	4	3	16	7	13	0	9	16	3	1	2	1	3	2	-1	1	1	-0.02	0.07	0.15
2262409	2025-02-11 03:45:00	21	0	2.98	3.20	2.33	2.88	3.15	2.40	6	1	4	5	0	5	11	1	9	0	10	2	11	1	3	2	3	1	2	-1	-1	1	-0.10	-0.05	0.07
2035876	2024-01-28 02:00:00	21	1	1.95	3.40	3.65	1.97	3.40	3.60	3	2	3	2	2	2	5	4	5	2	3	2	7	1	3	1	2	1	2	1	0	-1	0.02	0.00	-0.05
2035874	2024-01-24 03:45:00	21	1	2.04	3.25	3.55	2.04	3.25	3.55	6	1	3	7	1	4	13	2	7	0	11	6	13	1	3	2	3	1	2	0	0	0	0.00	0.00	0.00
2035873	2024-01-24 03:45:00	21	1	3.05	3.55	2.13	2.83	3.45	2.28	4	2	0	1	1	4	5	3	4	1	3	2	6	1	3	2	3	1	2	-1	-1	1	-0.22	-0.10	0.15
2035678	2023-08-20 01:00:00	21	3	2.47	3.15	2.80	2.49	3.15	2.79	2	2	5	4	1	2	6	3	7	1	4	0	7	2	3	1	2	1	3	1	0	-1	0.02	0.00	-0.01
1879007	2023-06-03 02:45:00	21	0	3.10	3.35	2.19	3.10	3.45	2.12	4	1	3	3	3	3	7	4	6	1	4	2	8	1	3	2	3	1	2	0	1	-1	0.00	0.10	-0.07
2035931	2024-02-24 22:00:00	21	3	1.61	3.85	5.20	1.58	3.90	5.40	2	0	1	1	2	3	3	2	4	1	2	0	4	2	3	1	2	1	3	-1	1	1	-0.03	0.05	0.20
2035674	2023-08-13 01:00:00	21	3	1.80	3.45	4.30	1.74	3.50	4.50	2	0	1	0	2	2	2	2	3	1	1	0	3	2	2	1	1	1	3	-1	1	1	-0.06	0.05	0.20
2035930	2024-02-25 02:00:00	21	0	1.91	3.45	3.75	1.90	3.50	3.75	1	2	2	1	2	2	2	4	4	3	1	1	5	3	1	1	1	2	2	-1	1	0	-0.01	0.05	0.00
2035673	2023-08-13 01:00:00	21	1	1.74	3.45	4.70	1.74	3.45	4.65	0	0	1	0	0	1	0	0	2	2	2	0	2	2	2	1	1	1	3	0	0	-1	0.00	0.00	-0.05
1879003	2023-06-03 02:45:00	21	3	2.20	3.20	3.20	2.21	3.10	3.25	0	2	2	1	1	2	1	3	4	4	2	1	5	3	2	1	1	2	3	1	-1	1	0.01	-0.10	0.05
2035672	2023-08-06 01:00:00	21	0	3.55	3.30	2.03	3.30	3.30	2.12	1	1	1	1	2	1	2	3	2	1	0	1	3	2	1	2	1	3	1	-1	0	1	-0.25	0.00	0.09
2262250	2024-08-31 20:30:00	21	3	3.65	3.15	2.04	3.65	3.15	2.04	2	2	2	3	2	1	5	4	3	2	3	4	7	1	2	3	3	2	1	0	0	0	0.00	0.00	0.00
2262251	2024-08-31 02:00:00	21	0	2.55	3.20	2.68	2.55	3.15	2.68	6	1	3	3	1	6	9	2	9	0	7	0	9	1	3	1	2	1	2	0	-1	0	0.00	-0.05	0.00
1878998	2023-06-03 02:45:00	21	3	1.43	4.30	6.90	1.39	4.45	7.30	7	4	8	6	7	9	13	11	17	5	7	1	18	2	3	1	2	1	3	-1	1	1	-0.04	0.15	0.40
2035669	2023-08-08 02:45:00	21	3	3.75	3.50	1.90	3.55	3.40	1.97	3	2	0	0	0	3	3	2	3	1	2	1	4	1	3	1	2	1	2	-1	-1	1	-0.20	-0.10	0.07
1878999	2023-06-03 02:45:00	21	0	2.76	3.35	2.37	2.86	3.40	2.29	3	2	7	2	3	4	5	5	11	7	7	1	12	2	2	1	1	1	3	1	1	-1	0.10	0.05	-0.08
2035668	2023-08-06 01:00:00	21	0	2.75	3.25	2.45	3.40	3.35	2.05	4	0	8	6	3	3	10	3	11	1	8	0	11	2	3	1	2	1	3	1	1	-1	0.65	0.10	-0.40
2035921	2024-01-28 02:00:00	21	0	2.25	3.15	3.15	2.25	3.15	3.15	0	0	1	1	0	0	1	0	1	0	1	0	1	1	3	1	2	1	2	0	0	0	0.00	0.00	0.00
2035664	2023-08-06 01:00:00	21	3	2.45	3.25	2.73	2.45	3.25	2.73	1	1	0	0	0	1	1	1	1	0	0	0	1	1	1	1	1	1	1	0	0	0	0.00	0.00	0.00
2035920	2024-02-25 02:00:00	21	1	1.54	4.00	5.40	1.52	4.10	5.70	1	2	1	2	2	1	3	4	2	2	1	3	5	2	1	3	2	3	1	-1	1	1	-0.02	0.10	0.30
2262258	2024-09-14 02:00:00	21	3	2.22	3.20	3.15	2.25	3.25	3.05	9	1	6	7	2	7	16	3	13	0	13	3	16	1	3	2	3	1	2	1	1	-1	0.03	0.05	-0.10
2262256	2024-09-17 02:45:00	21	3	2.74	3.30	2.44	2.55	3.30	2.60	16	3	11	12	4	13	28	7	24	0	21	4	28	1	3	2	3	1	2	-1	0	1	-0.19	0.00	0.16
2262262	2024-09-14 02:00:00	21	1	2.35	2.87	3.25	2.49	2.84	3.05	2	3	5	5	4	2	7	7	7	1	1	1	8	1	1	1	1	1	1	1	-1	-1	0.14	-0.03	-0.20
2035910	2024-02-20 03:45:00	21	1	2.84	3.15	2.44	2.88	3.10	2.42	4	2	7	7	1	6	11	3	13	4	12	2	15	2	3	1	2	1	3	1	-1	-1	0.04	-0.05	-0.02
2262267	2024-09-21 20:30:00	21	1	2.37	3.30	2.52	2.46	3.40	2.64	2	0	2	2	1	3	4	1	5	1	4	0	5	2	3	1	2	1	3	1	1	1	0.09	0.10	0.12
2262470	2024-12-17 03:45:00	21	3	2.12	3.35	3.25	2.25	3.30	2.99	4	3	5	5	2	3	9	5	8	1	5	2	10	1	3	2	3	1	2	1	-1	-1	0.13	-0.05	-0.26
2262471	2024-12-14 21:00:00	21	3	2.60	3.20	2.62	2.60	3.20	2.63	3	0	3	3	0	3	6	0	6	0	6	0	6	1	3	1	2	1	2	0	0	1	0.00	0.00	0.01
2262469	2024-12-15 03:00:00	21	1	3.15	3.20	2.21	3.15	3.20	2.23	1	2	1	1	1	2	2	3	3	2	1	1	4	3	1	1	1	2	2	0	0	1	0.00	0.00	0.02
2262473	2024-12-14 03:00:00	21	0	2.28	3.10	3.10	2.28	3.15	3.10	9	3	7	7	3	9	16	6	16	3	13	3	19	1	3	1	2	1	2	0	1	0	0.00	0.05	0.00
2262478	2025-01-04 21:00:00	21	1	2.12	3.35	3.25	2.16	3.35	3.15	0	0	2	3	0	0	3	0	2	0	3	1	3	1	3	2	3	1	2	1	0	-1	0.04	0.00	-0.10
2262477	2025-01-04 21:00:00	21	1	1.72	3.50	4.70	1.74	3.45	4.60	0	1	2	2	0	0	2	1	2	0	1	0	2	1	3	1	2	1	2	1	-1	-1	0.02	-0.05	-0.10
2035692	2023-09-24 01:00:00	21	3	2.07	3.10	3.65	2.05	3.10	3.70	1	1	1	1	0	1	2	1	2	0	1	0	2	1	3	1	2	1	2	-1	0	1	-0.02	0.00	0.05
2035691	2023-09-17 01:00:00	21	3	2.58	3.25	2.61	2.67	3.15	2.59	1	2	2	2	1	1	3	3	3	0	0	0	3	1	1	1	1	1	1	1	-1	-1	0.09	-0.10	-0.02
2262485	2025-01-04 03:00:00	21	0	1.68	3.95	4.35	1.70	3.95	4.20	4	3	5	3	4	4	7	7	9	3	3	1	10	2	2	1	1	1	3	1	0	-1	0.02	0.00	-0.15
2035686	2023-09-03 01:00:00	21	3	1.99	3.30	3.65	2.07	3.25	3.45	1	1	3	3	0	1	4	1	4	0	3	0	4	1	3	1	2	1	2	1	-1	-1	0.08	-0.05	-0.20
2035942	2024-03-03 02:00:00	21	1	2.58	3.40	2.53	2.58	3.35	2.53	6	3	7	9	2	7	15	5	14	1	11	2	16	1	3	2	3	1	2	0	-1	0	0.00	-0.05	0.00
2035684	2023-08-27 01:00:00	21	3	2.29	3.25	2.98	2.29	3.25	2.98	2	2	2	2	2	3	4	4	5	2	2	1	6	2	2	1	1	1	3	0	0	0	0.00	0.00	0.00
2035940	2024-03-02 22:00:00	21	1	2.47	3.20	2.75	2.51	3.20	2.70	1	0	2	2	0	1	3	0	3	0	3	0	3	1	3	1	2	1	2	1	0	-1	0.04	0.00	-0.05
2282969	2024-08-24 02:00:00	21	0	2.99	3.20	2.31	2.97	3.20	2.31	4	2	4	2	2	6	6	4	10	4	6	0	10	2	3	1	2	1	3	-1	0	0	-0.02	0.00	0.00
2035938	2024-03-03 02:00:00	21	1	1.80	3.45	4.25	1.82	3.50	4.10	1	3	4	1	3	5	2	6	9	7	3	0	9	3	2	1	1	2	3	1	1	-1	0.02	0.05	-0.15
2035681	2023-08-27 01:00:00	21	3	2.05	3.45	3.35	2.08	3.40	3.30	2	2	4	3	2	5	5	4	9	6	7	2	11	2	3	1	2	1	3	1	-1	-1	0.03	-0.05	-0.05
2219675	2024-08-10 22:00:00	22	1	1.59	4.00	4.50	1.60	4.35	5.10	4	3	8	7	4	5	11	7	13	3	7	1	14	2	3	1	2	1	3	1	1	1	0.01	0.35	0.60
2021475	2023-08-06 23:00:00	22	1	4.10	3.85	1.73	3.85	3.80	1.79	4	3	1	2	1	4	6	4	5	2	4	3	8	1	3	2	3	1	2	-1	-1	1	-0.25	-0.05	0.06
2027544	2024-01-20 23:00:00	23	3	2.49	3.05	2.87	2.43	3.05	2.96	4	0	1	1	1	3	5	1	4	0	4	1	5	1	3	2	3	1	2	-1	0	1	-0.06	0.00	0.09
2027540	2024-01-20 23:00:00	23	3	2.77	3.20	2.47	2.76	3.15	2.49	13	1	13	13	0	15	26	1	28	2	27	0	28	2	3	1	2	1	3	-1	-1	1	-0.01	-0.05	0.02
2027538	2024-01-20 23:00:00	23	1	1.31	4.90	8.30	1.33	4.75	8.50	5	10	14	8	6	11	13	16	25	12	9	0	25	3	2	1	1	2	3	1	-1	1	0.02	-0.15	0.20
2027535	2024-01-23 04:00:00	23	1	1.85	3.50	3.90	1.80	3.55	4.15	13	4	6	6	4	13	19	8	19	3	14	3	22	1	3	1	2	1	2	-1	1	1	-0.05	0.05	0.25
2027532	2024-01-20 23:00:00	23	1	2.42	3.10	2.89	2.42	3.15	2.88	0	1	1	0	1	1	0	2	2	2	0	0	2	3	1	1	1	2	2	0	1	-1	0.00	0.05	-0.01
2027533	2024-01-21 20:00:00	23	3	1.29	5.20	8.60	1.29	5.30	8.50	3	1	6	2	2	6	5	3	12	7	9	0	12	2	3	1	2	1	3	0	1	-1	0.00	0.10	-0.10
2027528	2024-01-13 23:00:00	23	3	1.74	3.80	4.10	1.74	3.80	4.10	0	0	2	0	0	1	0	0	3	3	3	0	3	2	2	1	1	1	3	0	0	0	0.00	0.00	0.00
2027529	2024-01-20 23:00:00	23	1	1.87	3.70	3.65	1.80	3.75	3.90	2	1	1	1	1	2	3	2	3	0	1	0	3	1	3	1	2	1	2	-1	1	1	-0.07	0.05	0.25
2027526	2023-08-05 22:00:00	23	3	1.82	3.55	4.00	1.82	3.55	4.00	1	0	0	0	1	1	1	1	1	0	0	0	1	1	1	1	1	1	1	0	0	0	0.00	0.00	0.00
2027524	2024-01-13 23:00:00	23	3	1.39	4.50	7.40	1.37	4.60	7.80	2	1	2	2	2	2	4	3	4	0	1	0	4	1	3	1	2	1	2	-1	1	1	-0.02	0.10	0.40
2027580	2024-02-03 04:00:00	23	0	4.25	3.65	1.69	4.30	3.65	1.75	7	3	0	5	2	3	12	5	3	2	9	11	14	1	2	3	3	2	1	1	0	1	0.05	0.00	0.06
2027581	2024-02-03 23:00:00	23	3	2.37	3.25	2.85	2.37	3.25	2.86	0	0	0	1	1	2	1	1	2	1	1	0	2	2	2	1	1	1	3	0	0	1	0.00	0.00	0.01
2027575	2024-01-27 23:00:00	23	3	2.08	3.35	3.30	2.01	3.40	3.50	9	2	2	6	3	4	15	5	6	0	10	9	15	1	3	2	3	1	2	-1	1	1	-0.07	0.05	0.20
2027573	2024-02-21 03:45:00	23	0	1.52	4.20	5.50	1.50	4.25	5.60	4	1	2	1	3	4	5	4	6	3	4	2	8	2	3	1	2	1	3	-1	1	1	-0.02	0.05	0.10
2027570	2024-01-28 21:30:00	23	1	2.09	3.20	3.45	2.02	3.25	3.60	4	1	1	1	1	2	5	2	3	0	3	2	5	1	3	2	3	1	2	-1	1	1	-0.07	0.05	0.15
2027571	2024-02-01 03:45:00	23	1	2.67	3.25	2.51	2.58	3.10	2.72	27	7	23	22	5	32	49	12	55	7	44	1	56	2	3	1	2	1	3	-1	-1	1	-0.09	-0.15	0.21
2027568	2024-02-21 03:45:00	23	0	3.20	3.55	2.05	3.15	3.55	2.07	5	2	8	7	2	5	12	4	13	3	11	2	15	2	3	1	2	1	3	-1	0	1	-0.05	0.00	0.02
2027566	2024-01-27 23:00:00	23	1	2.17	3.05	3.40	2.17	3.05	3.45	0	1	1	0	0	2	0	1	3	4	3	1	4	3	2	1	1	2	3	0	0	1	0.00	0.00	0.05
2027560	2024-02-21 03:45:00	23	3	1.21	5.80	11.00	1.21	5.80	12.00	8	6	2	7	6	3	15	12	5	1	4	11	16	1	2	3	3	2	1	0	0	1	0.00	0.00	1.00
2027556	2024-02-21 03:45:00	23	1	2.62	3.40	2.49	2.62	3.35	2.51	5	4	7	8	3	9	13	7	16	4	10	1	17	2	3	1	2	1	3	0	-1	1	0.00	-0.05	0.02
2027552	2024-01-20 20:30:00	23	0	4.40	3.80	1.70	4.75	3.90	1.63	1	0	2	3	2	0	4	2	2	0	2	2	4	1	2	2	3	1	1	1	1	-1	0.35	0.10	-0.07
2027594	2024-02-03 23:00:00	23	0	3.65	3.50	1.85	3.95	3.60	1.82	2	0	3	4	1	2	6	1	5	0	5	1	6	1	3	2	3	1	2	1	1	-1	0.30	0.10	-0.03
2027590	2024-02-03 23:00:00	23	3	3.25	3.30	2.04	3.50	3.40	2.00	2	0	4	5	1	1	7	1	5	1	7	3	8	1	3	2	3	1	2	1	1	-1	0.25	0.10	-0.04
2027588	2024-02-03 23:00:00	23	3	2.35	3.45	2.61	2.38	3.55	2.65	1	0	2	3	1	2	4	1	4	0	3	0	4	1	3	1	2	1	2	1	1	1	0.03	0.10	0.04
2027584	2024-02-03 23:00:00	23	3	2.05	3.20	3.35	2.03	3.30	3.50	1	0	0	1	1	1	2	1	1	1	2	2	3	1	2	2	3	1	1	-1	1	1	-0.02	0.10	0.15
2027134	2023-08-12 22:00:00	23	1	1.83	3.70	3.80	1.83	3.70	3.80	0	0	0	0	1	1	0	1	1	1	0	0	1	3	1	1	1	2	2	0	0	0	0.00	0.00	0.00
2027127	2023-08-12 22:00:00	23	0	4.10	3.95	1.71	4.10	3.95	1.71	0	0	0	1	1	0	1	1	0	0	0	1	1	1	1	3	2	2	1	0	0	0	0.00	0.00	0.00
2027124	2023-08-07 00:00:00	23	0	2.38	3.35	2.77	2.41	3.30	2.74	2	1	1	1	0	2	3	1	3	1	3	1	4	1	3	1	2	1	2	1	-1	-1	0.03	-0.05	-0.03
2027125	2023-08-12 22:00:00	23	3	2.92	3.60	2.17	2.95	3.55	2.17	0	1	0	2	1	0	2	2	0	0	0	2	2	1	1	3	2	2	1	1	-1	0	0.03	-0.05	0.00
2027123	2023-08-06 21:30:00	23	1	1.42	4.50	6.40	1.42	4.50	6.40	0	1	1	1	0	0	1	1	1	0	0	0	1	1	1	1	1	1	1	0	0	0	0.00	0.00	0.00
2027119	2024-01-14 20:00:00	23	0	2.90	3.20	2.38	2.90	3.20	2.38	0	0	0	1	0	0	1	0	0	0	1	1	1	1	2	2	3	1	1	0	0	0	0.00	0.00	0.00
2027117	2023-08-05 22:00:00	23	3	1.73	3.70	4.30	1.73	3.65	4.35	0	1	1	1	1	1	1	2	2	1	0	0	2	3	1	1	1	2	2	0	-1	1	0.00	-0.05	0.05
2027113	2023-08-05 03:00:00	23	0	2.91	3.30	2.31	2.84	3.30	2.36	3	0	0	0	0	2	3	0	2	0	3	1	3	1	3	2	3	1	2	-1	0	1	-0.07	0.00	0.05
2232995	2024-08-10 03:00:00	23	0	2.88	3.25	2.36	2.88	3.25	2.36	2	1	0	1	1	1	3	2	1	0	1	2	3	1	2	3	3	2	1	0	0	0	0.00	0.00	0.00
2027164	2023-09-02 22:00:00	23	1	1.46	4.35	5.20	1.46	4.65	5.60	1	1	1	2	2	2	3	3	3	0	0	0	3	1	1	1	1	1	1	0	1	1	0.00	0.30	0.40
2027165	2023-09-02 22:00:00	23	0	1.55	4.15	5.20	1.55	4.15	5.20	0	0	0	0	0	1	0	0	1	1	1	0	1	2	2	1	1	1	3	0	0	0	0.00	0.00	0.00
2027162	2023-09-02 22:00:00	23	1	2.13	3.35	3.05	2.13	3.40	3.15	0	0	0	0	2	1	0	2	1	2	0	1	2	3	1	2	1	3	2	0	1	1	0.00	0.05	0.10
2232998	2024-08-10 19:30:00	23	1	1.36	4.75	7.60	1.36	4.75	7.60	0	0	0	0	0	1	0	0	1	1	1	0	1	2	2	1	1	1	3	0	0	0	0.00	0.00	0.00
2232996	2024-08-10 03:00:00	23	3	2.28	3.30	2.97	2.31	3.25	2.95	1	2	2	1	1	3	2	3	5	3	2	0	5	3	2	1	1	2	3	1	-1	-1	0.03	-0.05	-0.02
2027158	2023-08-26 22:00:00	23	3	1.35	4.90	7.70	1.34	4.90	7.90	2	0	1	2	1	3	4	1	4	0	3	0	4	1	3	1	2	1	2	-1	0	1	-0.01	0.00	0.20
2027159	2023-08-27 19:00:00	23	0	2.06	3.45	3.05	2.06	3.45	3.05	0	0	1	1	0	0	1	0	1	0	1	0	1	1	3	1	2	1	2	0	0	0	0.00	0.00	0.00
2233003	2024-08-10 19:30:00	23	0	2.45	3.10	2.85	2.43	3.10	2.89	3	0	0	0	0	3	3	0	3	0	3	0	3	1	3	1	2	1	2	-1	0	1	-0.02	0.00	0.04
2027157	2023-08-26 22:00:00	23	0	5.20	3.90	1.60	5.20	3.90	1.60	0	0	0	1	1	0	1	1	0	0	0	1	1	1	1	3	2	2	1	0	0	0	0.00	0.00	0.00
2027154	2023-08-26 22:00:00	23	0	2.33	3.25	2.76	2.33	3.25	2.91	0	1	1	1	0	1	1	1	2	1	1	0	2	2	2	1	1	1	3	0	0	1	0.00	0.00	0.15
2233006	2024-08-13 03:00:00	23	0	2.28	3.30	2.96	2.44	3.30	2.73	2	3	10	3	3	8	5	6	18	13	12	0	18	3	2	1	1	2	3	1	0	-1	0.16	0.00	-0.23
2233004	2024-08-10 19:30:00	23	3	1.87	3.70	3.60	1.88	3.70	3.60	2	1	1	1	1	1	3	2	2	0	1	1	3	1	2	2	3	1	1	1	0	0	0.01	0.00	0.00
2233005	2024-08-11 23:00:00	23	3	1.87	3.50	3.85	1.83	3.55	3.95	3	0	0	0	1	3	3	1	3	0	2	0	3	1	3	1	2	1	2	-1	1	1	-0.04	0.05	0.10
2233008	2024-08-17 03:00:00	23	3	1.65	4.00	4.45	1.68	3.95	4.30	1	1	2	1	1	2	2	2	4	2	2	0	4	2	2	1	1	1	3	1	-1	-1	0.03	-0.05	-0.15
2027147	2023-08-19 22:00:00	23	3	2.19	3.30	2.94	2.19	3.35	3.10	0	0	1	0	1	2	0	1	3	3	2	0	3	3	2	1	1	2	3	0	1	1	0.00	0.05	0.16
2233015	2024-08-17 22:00:00	23	3	2.49	3.30	2.68	2.46	3.30	2.71	2	0	0	0	0	2	2	0	2	0	2	0	2	1	3	1	2	1	2	-1	0	1	-0.03	0.00	0.03
2027142	2023-08-20 19:00:00	23	3	2.08	3.30	3.20	2.08	3.30	3.20	0	0	0	1	0	0	1	0	0	0	1	1	1	1	2	2	3	1	1	0	0	0	0.00	0.00	0.00
2027140	2023-08-19 22:00:00	23	3	1.47	4.20	6.20	1.47	4.20	6.20	0	1	1	1	2	2	1	3	3	2	0	0	3	3	1	1	1	2	2	0	0	0	0.00	0.00	0.00
2233016	2024-08-17 19:30:00	23	1	3.05	3.45	2.16	3.10	3.40	2.16	1	1	0	1	1	0	2	2	0	0	0	2	2	1	1	3	2	2	1	1	-1	0	0.05	-0.05	0.00
2233017	2024-08-17 22:00:00	23	3	1.44	4.35	6.60	1.38	4.55	7.50	2	0	1	1	4	3	3	4	4	1	0	0	4	3	1	1	1	2	2	-1	1	1	-0.06	0.20	0.90
2027199	2023-09-23 22:00:00	23	3	1.68	3.80	4.15	1.68	3.80	4.15	1	0	0	0	1	1	1	1	1	0	0	0	1	1	1	1	1	1	1	0	0	0	0.00	0.00	0.00
2027708	2024-03-02 23:00:00	23	3	1.95	3.60	3.45	1.94	3.60	3.50	1	0	1	1	0	1	2	0	2	0	2	0	2	1	3	1	2	1	2	-1	0	1	-0.01	0.00	0.05
2027184	2023-09-16 22:00:00	23	3	2.01	3.30	3.35	2.02	3.35	3.45	1	0	2	1	2	2	2	2	4	2	2	0	4	2	2	1	1	1	3	1	1	1	0.01	0.05	0.10
2027178	2023-09-17 19:00:00	23	0	2.71	3.30	2.33	2.71	3.30	2.33	1	0	0	0	0	1	1	0	1	0	1	0	1	1	3	1	2	1	2	0	0	0	0.00	0.00	0.00
2027172	2023-09-02 22:00:00	23	0	1.71	3.75	4.00	1.71	3.85	4.25	0	1	2	0	2	2	0	3	4	4	1	0	4	3	2	1	1	2	3	0	1	1	0.00	0.10	0.25
2027684	2024-02-24 04:00:00	23	3	2.06	3.55	3.20	2.16	3.50	3.00	8	3	9	14	2	6	22	5	15	6	23	13	28	1	3	2	3	1	2	1	-1	-1	0.10	-0.05	-0.20
2027680	2024-02-24 20:30:00	23	1	2.38	3.20	2.87	2.35	3.20	2.94	2	0	1	1	0	3	3	0	4	1	4	0	4	2	3	1	2	1	3	-1	0	1	-0.03	0.00	0.07
2233058	2024-09-21 19:30:00	23	3	2.17	3.40	3.10	2.17	3.40	3.10	0	0	0	0	0	1	0	0	1	1	1	0	1	2	2	1	1	1	3	0	0	0	0.00	0.00	0.00
2233059	2024-09-22 19:00:00	23	1	2.55	3.25	2.63	2.73	3.25	2.46	3	0	2	2	0	0	5	0	2	0	5	3	5	1	3	2	3	1	2	1	0	-1	0.18	0.00	-0.17
2027732	2024-03-06 03:45:00	23	0	3.90	3.70	1.81	3.80	3.65	1.84	5	4	6	7	4	3	12	8	9	3	7	6	15	1	3	2	3	1	2	-1	-1	1	-0.10	-0.05	0.03
2233080	2024-09-28 22:00:00	23	3	2.85	3.25	2.36	2.90	3.30	2.32	6	0	4	4	1	5	10	1	9	0	9	1	10	1	3	2	3	1	2	1	1	-1	0.05	0.05	-0.04
2027200	2023-09-23 22:00:00	23	3	1.74	3.75	3.90	1.74	3.85	4.10	0	0	1	0	2	2	0	2	3	4	2	1	4	3	2	1	1	2	3	0	1	1	0.00	0.10	0.20
2233025	2024-08-24 03:00:00	23	0	3.90	3.65	1.82	3.75	3.60	1.87	12	4	6	11	3	8	23	7	14	5	21	14	28	1	3	2	3	1	2	-1	-1	1	-0.15	-0.05	0.05
2233029	2024-08-25 22:00:00	23	1	2.01	3.45	3.45	2.01	3.45	3.45	1	0	0	0	0	1	1	0	1	0	1	0	1	1	3	1	2	1	2	0	0	0	0.00	0.00	0.00
2027254	2023-10-21 22:00:00	23	0	4.10	3.80	1.75	4.10	3.80	1.75	0	0	0	1	1	0	1	1	0	0	0	1	1	1	1	3	2	2	1	0	0	0	0.00	0.00	0.00
2214088	2024-05-26 22:00:00	23	0	2.29	3.35	2.90	2.29	3.40	3.15	0	2	3	0	3	5	0	5	8	8	3	0	8	3	2	1	1	2	3	0	1	1	0.00	0.05	0.25
2233033	2024-08-31 19:30:00	23	1	1.88	3.70	3.60	2.00	3.60	3.30	1	2	7	9	0	1	10	2	8	0	8	2	10	1	3	2	3	1	2	1	-1	-1	0.12	-0.10	-0.30
2027250	2023-10-21 22:00:00	23	0	2.73	3.35	2.31	2.91	3.55	2.19	1	0	2	3	2	0	4	2	2	0	2	2	4	1	2	2	3	1	1	1	1	-1	0.18	0.20	-0.12
2027251	2023-10-21 19:30:00	23	1	2.33	3.10	2.88	2.33	3.10	2.85	0	0	1	0	0	1	0	0	2	2	2	0	2	2	2	1	1	1	3	0	0	-1	0.00	0.00	-0.03
2027763	2024-03-10 20:00:00	23	0	2.70	3.15	2.43	2.84	3.15	2.33	2	0	6	6	0	2	8	0	8	0	8	0	8	1	3	1	2	1	2	1	0	-1	0.14	0.00	-0.10
2233036	2024-08-31 03:00:00	23	0	1.79	3.60	4.15	1.88	3.65	3.65	9	8	16	10	10	12	19	18	28	22	23	13	41	2	3	1	2	1	3	1	1	-1	0.09	0.05	-0.50
2027761	2024-03-09 20:30:00	23	3	3.90	3.55	1.79	4.15	3.65	1.77	1	2	1	3	4	0	4	6	1	2	0	5	6	2	1	3	2	3	1	1	1	-1	0.25	0.10	-0.02
2027759	2024-03-10 20:30:00	23	3	2.35	3.20	2.77	2.35	3.25	2.88	0	0	0	0	1	2	0	1	2	2	1	0	2	3	2	1	1	2	3	0	1	1	0.00	0.05	0.11
2027244	2023-10-07 19:30:00	23	0	2.33	3.40	2.65	2.33	3.45	2.64	0	0	2	0	1	0	0	1	2	2	1	0	2	3	2	1	1	2	3	0	1	-1	0.00	0.05	-0.01
2233040	2024-09-01 22:00:00	23	3	1.87	3.60	3.75	1.89	3.70	4.00	1	0	4	4	1	2	5	1	6	1	5	0	6	2	3	1	2	1	3	1	1	1	0.02	0.10	0.25
2027755	2024-04-17 03:00:00	23	3	1.33	4.95	8.30	1.34	4.90	8.00	3	6	8	6	4	7	9	10	15	8	7	2	17	3	2	1	1	2	3	1	-1	-1	0.01	-0.05	-0.30
2233044	2024-09-14 19:30:00	23	0	1.70	3.80	4.40	1.70	3.80	4.35	2	3	6	2	4	5	4	7	11	9	6	2	13	3	2	1	1	2	3	0	0	-1	0.00	0.00	-0.05
2027238	2023-10-07 22:00:00	23	3	1.47	4.25	6.10	1.48	4.25	6.00	1	0	1	1	1	1	2	1	2	0	1	0	2	1	3	1	2	1	2	1	0	-1	0.01	0.00	-0.10
2233050	2024-09-15 22:00:00	23	0	3.70	3.60	1.88	3.70	3.60	1.88	3	2	3	3	2	2	6	4	5	2	4	3	8	1	3	2	3	1	2	0	0	0	0.00	0.00	0.00
2027747	2023-11-25 23:00:00	23	0	2.20	3.45	2.99	2.20	3.45	2.99	0	0	0	0	0	1	0	0	1	1	1	0	1	2	2	1	1	1	3	0	0	0	0.00	0.00	0.00
2027805	2024-03-30 01:30:00	23	0	3.35	3.75	1.94	3.35	3.70	1.96	3	3	6	4	3	3	7	6	9	5	6	3	12	2	3	1	2	1	3	0	-1	1	0.00	-0.05	0.02
2027801	2024-03-16 20:30:00	23	3	2.08	3.30	3.35	2.09	3.30	3.35	2	0	2	2	0	1	4	0	3	1	5	2	5	1	3	2	3	1	2	1	0	0	0.01	0.00	0.00
2027284	2023-11-04 04:00:00	23	0	2.07	3.60	3.10	2.08	3.60	3.10	19	7	12	12	7	11	31	14	23	9	26	17	40	1	3	2	3	1	2	1	0	0	0.01	0.00	0.00
2027797	2024-03-16 23:00:00	23	0	2.41	3.35	2.74	2.44	3.30	2.71	6	1	6	7	0	7	13	1	13	0	12	0	13	1	3	1	2	1	2	1	-1	-1	0.03	-0.05	-0.03
2027276	2023-10-29 21:00:00	23	3	1.85	3.30	3.85	1.86	3.30	3.85	2	1	3	2	1	2	4	2	5	1	3	0	5	2	3	1	2	1	3	1	0	0	0.01	0.00	0.00
2233136	2024-10-26 19:30:00	23	3	2.38	3.40	2.74	2.36	3.40	2.75	4	1	6	2	2	5	6	3	11	7	10	2	13	2	3	1	2	1	3	-1	0	1	-0.02	0.00	0.01
2027789	2024-04-24 03:00:00	23	3	2.07	3.60	3.15	2.11	3.70	2.98	30	8	19	19	10	19	49	18	38	7	38	18	56	1	3	2	3	1	2	1	1	-1	0.04	0.10	-0.17
2027275	2023-10-28 22:00:00	23	0	7.90	4.50	1.33	7.50	4.85	1.35	2	1	2	2	4	2	4	5	4	1	0	1	5	2	1	2	1	3	1	-1	1	1	-0.40	0.35	0.02
2027787	2024-03-17 23:00:00	23	3	1.33	4.80	8.60	1.30	5.00	9.10	3	2	4	2	5	5	5	7	9	4	2	0	9	3	2	1	1	2	3	-1	1	1	-0.03	0.20	0.50
2027781	2024-03-16 23:00:00	23	0	2.36	3.40	2.76	2.36	3.35	2.78	0	1	1	0	0	2	0	1	3	3	2	0	3	3	2	1	1	2	3	0	-1	1	0.00	-0.05	0.02
2210049	2024-05-12 21:15:00	23	1	2.73	3.20	2.48	2.73	3.20	2.48	0	0	1	1	0	0	1	0	1	0	1	0	1	1	3	1	2	1	2	0	0	0	0.00	0.00	0.00
2027837	2024-04-01 19:30:00	23	3	1.65	3.95	4.50	1.65	3.95	4.50	0	0	1	0	0	0	0	0	1	1	1	0	1	2	2	1	1	1	3	0	0	0	0.00	0.00	0.00
2210057	2024-05-18 03:00:00	23	3	1.79	3.65	4.05	1.77	3.65	4.15	8	7	10	6	8	13	14	15	23	13	12	4	27	3	2	1	1	2	3	-1	0	1	-0.02	0.00	0.10
2210056	2024-05-17 03:00:00	23	3	1.58	3.90	5.10	1.61	3.95	4.85	2	1	7	5	2	3	7	3	10	6	10	3	13	2	3	1	2	1	3	1	1	-1	0.03	0.05	-0.25
2027314	2023-11-30 03:45:00	23	1	5.30	3.95	1.55	5.30	4.00	1.55	0	0	0	0	1	0	0	1	0	2	1	2	2	2	1	2	1	3	1	0	1	0	0.00	0.05	0.00
2233102	2024-10-06 22:00:00	23	1	1.77	3.55	3.95	1.77	3.65	4.15	0	0	1	0	2	1	0	2	2	2	0	0	2	3	1	1	1	2	2	0	1	1	0.00	0.10	0.20
2233103	2024-10-20 22:00:00	23	0	2.80	3.45	2.30	2.77	3.50	2.30	3	3	2	4	2	1	7	5	3	0	2	4	7	1	2	3	3	2	1	-1	1	0	-0.03	0.05	0.00
2027303	2023-11-11 20:30:00	23	3	1.70	3.75	4.10	1.70	3.85	4.35	0	0	1	0	2	1	0	2	2	2	0	0	2	3	1	1	1	2	2	0	1	1	0.00	0.10	0.25
2027810	2024-03-29 23:00:00	23	0	2.90	3.40	2.26	2.90	3.40	2.26	0	0	1	1	0	0	1	0	1	0	1	0	1	1	3	1	2	1	2	0	0	0	0.00	0.00	0.00
2233186	2024-11-27 03:45:00	23	3	2.20	3.25	3.15	2.28	3.10	3.10	3	5	5	4	3	7	7	8	12	6	5	1	13	3	2	1	1	2	3	1	-1	-1	0.08	-0.15	-0.05
2233184	2024-11-24 23:00:00	23	0	3.90	3.35	1.83	4.30	3.35	1.83	3	2	1	3	1	4	6	3	5	1	4	2	7	1	3	2	3	1	2	1	0	0	0.40	0.00	0.00
2233190	2024-11-27 03:45:00	23	3	1.42	4.35	7.00	1.45	4.15	6.80	13	11	12	10	10	22	23	21	34	13	15	2	36	2	3	1	2	1	3	1	-1	-1	0.03	-0.20	-0.20
2233188	2024-11-28 03:45:00	23	3	1.39	4.35	7.70	1.42	4.35	6.80	3	8	12	6	6	10	9	14	22	15	10	2	24	3	2	1	1	2	3	1	0	-1	0.03	0.00	-0.90
2027865	2024-04-06 19:30:00	23	3	2.60	3.50	2.32	2.60	3.55	2.31	0	1	1	0	1	1	0	2	2	2	0	0	2	3	1	1	1	2	2	0	1	-1	0.00	0.05	-0.01
2233194	2024-11-27 04:00:00	23	1	2.33	3.15	2.99	2.38	3.10	2.95	0	3	7	1	2	6	1	5	13	12	8	0	13	3	2	1	1	2	3	1	-1	-1	0.05	-0.05	-0.04
2233195	2024-11-28 03:45:00	23	0	1.49	4.25	5.80	1.64	4.05	4.45	1	5	9	8	2	1	9	7	10	1	3	0	10	2	3	1	2	1	3	1	-1	-1	0.15	-0.20	-1.35
2233193	2024-11-27 03:45:00	23	3	2.31	3.35	2.86	2.47	3.25	2.71	0	2	4	2	0	3	2	2	7	6	6	1	8	2	2	1	1	1	3	1	-1	-1	0.16	-0.10	-0.15
2233199	2024-11-28 04:00:00	23	0	2.37	3.20	2.90	2.51	3.05	2.82	8	3	9	10	0	9	18	3	18	2	17	2	20	1	3	1	2	1	2	1	-1	-1	0.14	-0.15	-0.08
2233196	2024-11-28 03:45:00	23	0	1.97	3.40	3.60	1.96	3.40	3.65	8	1	5	7	1	5	15	2	10	0	13	5	15	1	3	2	3	1	2	-1	0	1	-0.01	0.00	0.05
2233202	2024-11-30 21:30:00	23	3	3.90	3.60	1.84	4.05	3.55	1.81	4	2	6	7	2	5	11	4	11	2	9	2	13	1	3	1	2	1	2	1	-1	-1	0.15	-0.05	-0.03
2233200	2024-12-01 23:00:00	23	0	2.42	3.30	2.76	2.42	3.30	2.76	0	0	1	0	1	0	0	1	1	1	0	0	1	3	1	1	1	2	2	0	0	0	0.00	0.00	0.00
2233201	2024-11-30 20:30:00	23	3	1.49	4.30	5.70	1.48	4.25	5.90	2	4	3	2	4	3	4	8	6	7	3	5	11	3	1	2	1	3	2	-1	-1	1	-0.01	-0.05	0.20
2233206	2024-11-30 04:00:00	23	3	2.05	3.25	3.55	2.09	3.15	3.50	7	2	6	9	0	6	16	2	12	2	16	6	18	1	3	2	3	1	2	1	-1	-1	0.04	-0.10	-0.05
2027337	2023-12-09 20:30:00	23	0	4.10	3.85	1.73	4.10	3.85	1.73	0	0	1	1	0	0	1	0	1	0	1	0	1	1	3	1	2	1	2	0	0	0	0.00	0.00	0.00
2233210	2024-12-07 04:00:00	23	1	2.31	3.25	2.95	2.47	3.15	2.79	1	2	6	3	1	3	4	3	9	5	6	0	9	2	3	1	2	1	3	1	-1	-1	0.16	-0.10	-0.16
2027335	2023-12-02 20:30:00	23	0	2.82	3.15	2.34	2.88	3.25	2.36	1	0	3	4	1	2	5	1	5	0	4	0	5	1	3	1	2	1	2	1	1	1	0.06	0.10	0.02
2233208	2024-11-30 20:30:00	23	1	1.90	3.50	3.75	1.85	3.55	3.85	4	0	2	0	1	4	4	1	6	4	7	2	8	2	3	1	2	1	3	-1	1	1	-0.05	0.05	0.10
2233213	2024-12-07 20:30:00	23	3	1.34	4.60	8.80	1.32	4.75	8.90	4	1	4	2	4	4	6	5	8	2	3	0	8	2	3	1	2	1	3	-1	1	1	-0.02	0.15	0.10
2027385	2023-12-19 04:00:00	23	0	5.80	4.05	1.52	5.90	4.10	1.51	1	2	1	1	2	1	2	4	2	3	1	3	5	2	1	2	1	3	1	1	1	-1	0.10	0.05	-0.01
2027897	2024-04-11 02:45:00	23	1	1.45	4.40	6.10	1.45	4.35	6.30	5	5	6	5	4	7	10	9	13	5	6	2	15	2	3	1	2	1	3	0	-1	1	0.00	-0.05	0.20
2233157	2024-11-08 04:00:00	23	1	2.29	3.10	3.10	2.49	3.05	2.87	2	2	1	1	1	4	3	3	5	3	3	1	6	2	2	1	1	1	3	1	-1	-1	0.20	-0.05	-0.23
2027895	2024-04-11 02:45:00	23	1	2.36	3.45	2.72	2.42	3.45	2.67	0	1	2	1	1	2	1	2	4	4	3	1	5	3	2	1	1	2	3	1	0	-1	0.06	0.00	-0.05
2027888	2024-04-10 02:45:00	23	3	1.79	3.95	3.75	1.85	3.95	3.50	5	4	10	6	4	6	11	8	16	7	10	2	18	2	3	1	2	1	3	1	0	-1	0.06	0.00	-0.25
2027886	2024-04-10 02:45:00	23	1	2.86	3.35	2.31	2.84	3.40	2.31	4	2	0	1	2	1	5	4	1	2	3	6	7	1	2	3	3	2	1	-1	1	0	-0.02	0.05	0.00
2027375	2023-12-14 03:45:00	23	1	2.67	3.45	2.41	2.58	3.45	2.48	13	4	6	8	4	9	21	8	15	4	17	10	25	1	3	2	3	1	2	-1	0	1	-0.09	0.00	0.07
2233168	2024-11-10 20:30:00	23	3	1.88	3.45	3.85	1.87	3.45	3.90	3	2	2	3	2	2	6	4	4	3	5	5	9	1	2	2	3	1	1	-1	0	1	-0.01	0.00	0.05
2233174	2024-11-23 20:30:00	23	0	2.61	3.05	2.56	2.67	3.10	2.62	8	1	8	9	2	9	17	3	17	0	14	0	17	1	3	1	2	1	2	1	1	1	0.06	0.05	0.06
2027880	2024-04-10 02:45:00	23	3	4.60	3.75	1.68	4.60	3.70	1.69	4	3	3	6	3	2	10	6	5	1	5	6	11	1	2	3	3	2	1	0	-1	1	0.00	-0.05	0.01
2233183	2024-11-23 23:00:00	23	1	1.92	3.40	3.55	1.89	3.45	3.80	4	2	4	4	3	4	8	5	8	2	5	2	10	1	3	1	2	1	2	-1	1	1	-0.03	0.05	0.25
2233180	2024-11-23 04:00:00	23	1	2.74	3.50	2.23	2.75	3.50	2.31	6	2	0	7	1	2	13	3	2	0	10	11	13	1	2	3	3	2	1	1	0	1	0.01	0.00	0.08
2233181	2025-01-16 03:45:00	23	3	1.76	3.50	4.45	1.80	3.40	4.35	4	6	5	4	5	7	8	11	12	6	3	2	14	3	2	1	1	2	3	1	-1	-1	0.04	-0.10	-0.10
2233250	2024-12-21 23:00:00	23	3	2.28	3.05	3.15	2.28	3.15	3.10	0	1	1	0	2	0	0	3	1	3	0	2	3	3	1	2	1	3	2	0	1	-1	0.00	0.10	-0.05
2027935	2024-04-20 19:30:00	23	3	1.57	4.05	5.20	1.55	4.05	5.30	1	0	0	1	1	1	2	1	1	0	1	1	2	1	2	2	3	1	1	-1	0	1	-0.02	0.00	0.10
2233251	2024-12-21 23:00:00	23	1	5.90	4.45	1.46	5.70	4.50	1.46	2	1	2	2	2	1	4	3	3	2	3	3	6	1	2	2	3	1	1	-1	1	0	-0.20	0.05	0.00
2233248	2024-12-21 23:00:00	23	3	1.15	7.10	13.00	1.14	7.40	15.00	2	2	2	1	3	3	3	5	5	6	4	4	9	3	1	1	1	2	2	-1	1	1	-0.01	0.30	2.00
2233249	2024-12-21 04:00:00	23	3	2.17	3.25	3.25	2.23	3.20	3.15	2	5	5	2	5	6	4	10	11	11	5	4	15	3	2	1	1	2	3	1	-1	-1	0.06	-0.05	-0.10
2027418	2023-12-23 23:00:00	23	3	2.33	3.25	2.91	2.33	3.30	2.89	0	0	2	1	1	2	1	1	4	3	3	0	4	2	2	1	1	1	3	0	1	-1	0.00	0.05	-0.02
2233254	2024-12-21 23:00:00	23	3	2.45	3.05	2.92	2.48	3.05	2.88	2	0	2	2	0	2	4	0	4	0	4	0	4	1	3	1	2	1	2	1	0	-1	0.03	0.00	-0.04
2027931	2024-05-01 03:00:00	23	0	3.80	3.85	1.79	4.00	4.00	1.72	9	7	13	9	8	11	18	15	24	9	12	3	27	2	3	1	2	1	3	1	1	-1	0.20	0.15	-0.07
2233255	2024-12-21 23:00:00	23	3	1.89	3.50	3.80	1.83	3.55	3.95	2	0	2	1	1	2	3	1	4	1	3	0	4	2	3	1	2	1	3	-1	1	1	-0.06	0.05	0.15
2027416	2023-12-23 23:00:00	23	3	1.14	8.00	14.00	1.14	8.00	14.00	1	3	0	0	4	1	1	7	1	6	0	6	7	2	1	2	1	3	1	0	0	0	0.00	0.00	0.00
2233252	2024-12-21 20:30:00	23	3	3.50	3.55	1.96	3.55	3.60	1.93	2	1	5	4	3	1	6	4	6	3	5	3	9	1	3	1	2	1	2	1	1	-1	0.05	0.05	-0.03
2233253	2024-12-21 20:30:00	23	3	1.95	3.40	3.65	1.92	3.50	3.65	10	4	8	7	6	11	17	10	19	10	17	8	27	2	3	1	2	1	3	-1	1	0	-0.03	0.10	0.00
2027414	2023-12-23 20:30:00	23	3	1.79	3.80	3.85	1.82	3.80	3.75	2	2	2	2	2	2	4	4	4	2	2	2	6	1	1	1	1	1	1	1	0	-1	0.03	0.00	-0.10
2233258	2024-12-21 23:00:00	23	0	3.40	3.35	2.05	3.40	3.30	2.07	2	2	1	1	1	3	3	3	4	1	1	0	4	2	2	1	1	1	3	0	-1	1	0.00	-0.05	0.02
2027927	2024-04-21 19:30:00	23	0	2.07	3.45	3.25	2.09	3.40	3.25	0	1	1	2	0	0	2	1	1	0	1	1	2	1	2	2	3	1	1	1	-1	0	0.02	-0.05	0.00
2233259	2024-12-26 23:00:00	23	1	2.68	3.20	2.41	2.94	3.05	2.44	1	2	7	9	1	2	10	3	9	2	9	3	12	1	3	2	3	1	2	1	-1	1	0.26	-0.15	0.03
2027412	2023-12-23 03:45:00	23	3	2.62	3.20	2.60	2.58	3.15	2.66	8	2	9	11	1	7	19	3	16	1	17	4	20	1	3	2	3	1	2	-1	-1	1	-0.04	-0.05	0.06
2233256	2024-12-22 23:00:00	23	3	2.16	3.20	3.25	2.20	3.15	3.25	2	1	1	1	0	3	3	1	4	2	4	1	5	2	3	1	2	1	3	1	-1	0	0.04	-0.05	0.00
2233257	2024-12-21 20:30:00	23	3	2.44	3.30	2.71	2.46	3.30	2.70	3	2	3	2	2	5	5	4	8	3	4	0	8	2	3	1	2	1	3	1	0	-1	0.02	0.00	-0.01
2027410	2023-12-23 23:00:00	23	0	2.28	3.55	2.79	2.31	3.55	2.74	0	0	2	1	0	2	1	0	4	3	4	0	4	2	3	1	2	1	3	1	0	-1	0.03	0.00	-0.05
2233262	2024-12-27 01:30:00	23	3	2.58	3.05	2.61	2.70	2.95	2.70	3	4	5	9	0	6	12	4	11	2	10	3	14	1	3	2	3	1	2	1	-1	1	0.12	-0.10	0.09
2233263	2024-12-26 23:00:00	23	1	1.69	3.85	4.40	1.69	3.90	4.30	0	1	2	0	3	1	0	4	3	4	0	1	4	3	1	2	1	3	2	0	1	-1	0.00	0.05	-0.10
2027920	2024-04-13 22:00:00	23	3	1.39	4.65	6.80	1.41	4.65	6.40	0	0	3	2	0	1	2	0	4	2	4	0	4	2	3	1	2	1	3	1	0	-1	0.02	0.00	-0.40
2233260	2024-12-26 23:00:00	23	3	1.30	5.10	7.30	1.30	5.60	7.90	4	1	5	3	5	6	7	6	11	4	5	0	11	2	3	1	2	1	3	0	1	1	0.00	0.50	0.60
2233261	2024-12-26 23:00:00	23	3	2.25	3.20	2.93	2.19	3.30	3.10	2	1	2	0	1	4	2	2	6	5	5	1	7	2	2	1	1	1	3	-1	1	1	-0.06	0.10	0.17
2233266	2024-12-26 23:00:00	23	0	2.40	3.05	2.83	2.40	2.96	3.05	0	2	6	0	2	6	0	4	12	12	8	0	12	3	2	1	1	2	3	0	-1	1	0.00	-0.09	0.22
2233267	2024-12-27 04:00:00	23	0	6.10	4.15	1.48	6.60	4.10	1.46	2	2	3	5	2	2	7	4	5	0	3	2	7	1	3	2	3	1	2	1	-1	-1	0.50	-0.05	-0.02
2233264	2024-12-26 23:00:00	23	3	2.21	3.25	2.96	2.25	3.20	3.10	3	5	8	2	4	9	5	9	17	12	8	0	17	3	2	1	1	2	3	1	-1	1	0.04	-0.05	0.14
2233265	2024-12-26 23:00:00	23	3	2.26	3.25	2.85	2.26	3.20	3.10	0	1	1	0	0	2	0	1	3	3	2	0	3	3	2	1	1	2	3	0	-1	1	0.00	-0.05	0.25
2233271	2024-12-26 23:00:00	23	3	1.92	3.40	3.55	1.88	3.35	4.00	4	2	0	0	2	5	4	4	5	1	1	0	5	2	2	1	1	1	3	-1	-1	1	-0.04	-0.05	0.45
2233268	2024-12-26 23:00:00	23	3	1.81	3.60	3.70	1.80	3.60	4.05	2	0	0	0	1	3	2	1	3	1	2	0	3	2	3	1	2	1	3	-1	0	1	-0.01	0.00	0.35
2233269	2024-12-26 23:00:00	23	3	2.66	3.10	2.48	2.58	3.20	2.63	4	1	4	5	1	5	9	2	9	0	7	0	9	1	3	1	2	1	2	-1	1	1	-0.08	0.10	0.15
2027910	2024-04-13 19:30:00	23	0	1.33	4.80	8.20	1.31	4.95	8.80	3	0	0	0	4	6	3	4	6	3	2	0	6	3	2	1	1	2	3	-1	1	1	-0.02	0.15	0.60
2233274	2024-12-30 04:00:00	23	1	2.38	3.25	2.84	2.51	3.20	2.71	0	1	4	3	0	2	3	1	6	3	5	0	6	2	3	1	2	1	3	1	-1	-1	0.13	-0.05	-0.13
2233275	2024-12-29 20:30:00	23	1	1.81	3.55	4.05	1.71	3.65	4.55	3	0	1	0	2	3	3	2	4	1	2	0	4	2	3	1	2	1	3	-1	1	1	-0.10	0.10	0.50
2233279	2024-12-29 20:30:00	23	1	2.02	3.25	3.60	2.08	3.20	3.45	3	2	3	4	1	1	7	3	4	0	4	3	7	1	3	2	3	1	2	1	-1	-1	0.06	-0.05	-0.15
2233276	2024-12-30 01:45:00	23	0	5.60	3.90	1.56	5.10	3.75	1.62	4	4	2	3	2	5	7	6	7	4	5	4	11	1	3	1	2	1	2	-1	-1	1	-0.50	-0.15	0.06
2027454	2023-12-26 23:00:00	23	0	1.99	3.25	3.70	1.98	3.30	3.70	2	1	1	1	1	2	3	2	3	2	3	2	5	1	3	1	2	1	2	-1	1	0	-0.01	0.05	0.00
2233218	2024-12-07 20:30:00	23	1	1.91	3.30	4.00	2.03	3.25	3.60	1	1	5	5	1	2	6	2	7	3	7	2	9	2	3	1	2	1	3	1	-1	-1	0.12	-0.05	-0.40
2233219	2024-12-07 20:30:00	23	3	1.78	3.60	4.15	1.77	3.60	4.25	3	4	4	3	4	6	6	8	10	6	4	2	12	3	2	1	1	2	3	-1	0	1	-0.01	0.00	0.10
2027452	2023-12-26 23:00:00	23	3	1.44	4.50	6.10	1.45	4.45	5.90	2	1	1	1	0	1	3	1	2	0	2	1	3	1	3	2	3	1	2	1	-1	-1	0.01	-0.05	-0.20
2027964	2024-04-30 03:00:00	23	0	4.60	3.95	1.64	4.50	4.00	1.64	11	6	13	14	8	8	25	14	21	0	11	4	25	1	3	2	3	1	2	-1	1	0	-0.10	0.05	0.00
2233216	2024-12-07 23:00:00	23	3	3.05	3.40	2.19	3.05	3.40	2.19	0	0	0	0	1	0	0	1	0	1	0	1	1	2	1	2	1	3	1	0	0	0	0.00	0.00	0.00
2027965	2024-04-27 03:00:00	23	3	5.80	4.20	1.50	5.70	4.10	1.52	14	13	9	11	9	14	25	22	23	6	9	8	31	1	3	2	3	1	2	-1	-1	1	-0.10	-0.10	0.02
2233222	2025-01-15 03:45:00	23	1	2.40	3.20	2.86	2.28	3.20	3.05	3	3	10	2	3	8	5	6	18	13	12	0	18	3	2	1	1	2	3	-1	0	1	-0.12	0.00	0.19
2233223	2024-12-11 03:45:00	23	1	1.66	3.50	5.20	1.73	3.30	5.00	2	6	5	4	2	6	6	8	11	6	4	1	12	3	2	1	1	2	3	1	-1	-1	0.07	-0.20	-0.20
2027448	2023-12-26 20:30:00	23	3	5.20	4.05	1.57	5.20	4.05	1.57	0	0	0	0	1	0	0	1	0	1	0	1	1	2	1	2	1	3	1	0	0	0	0.00	0.00	0.00
2233220	2024-12-08 23:00:00	23	1	2.37	3.25	2.86	2.39	3.20	2.85	5	1	5	6	0	6	11	1	11	1	11	1	12	1	3	1	2	1	2	1	-1	-1	0.02	-0.05	-0.01
2233226	2024-12-12 03:45:00	23	0	2.86	3.05	2.49	2.96	3.00	2.43	11	3	18	21	2	9	32	5	27	0	27	5	32	1	3	2	3	1	2	1	-1	-1	0.10	-0.05	-0.06
2233227	2024-12-11 03:45:00	23	1	2.68	3.50	2.38	2.93	3.40	2.26	14	10	5	17	9	3	31	19	8	4	16	27	35	1	2	3	3	2	1	1	-1	-1	0.25	-0.10	-0.12
2027444	2023-12-27 03:45:00	23	1	2.91	3.55	2.20	2.88	3.50	2.23	16	8	1	12	7	2	28	15	3	0	13	25	28	1	2	3	3	2	1	-1	-1	1	-0.03	-0.05	0.03
2233224	2024-12-11 04:00:00	23	3	1.91	3.55	3.60	1.88	3.50	3.80	14	5	8	9	5	11	23	10	19	4	17	8	27	1	3	2	3	1	2	-1	-1	1	-0.03	-0.05	0.20
2027445	2023-12-26 21:00:00	23	3	2.17	3.10	3.35	2.17	3.10	3.35	0	1	0	0	0	0	0	1	0	1	0	1	1	2	1	2	1	3	1	0	0	0	0.00	0.00	0.00
2027955	2024-04-27 22:00:00	23	0	3.25	3.45	2.07	3.25	3.50	2.06	2	0	1	1	1	1	3	1	2	0	2	1	3	1	3	2	3	1	2	0	1	-1	0.00	0.05	-0.01
2233228	2024-12-11 03:45:00	23	0	2.23	3.35	3.00	2.31	3.15	3.05	1	5	5	2	2	8	3	7	13	11	7	1	14	3	2	1	1	2	3	1	-1	1	0.08	-0.20	0.05
2233229	2024-12-11 03:45:00	23	1	1.98	3.30	3.65	1.98	3.30	3.65	11	2	6	9	1	6	20	3	12	0	17	8	20	1	3	2	3	1	2	0	0	0	0.00	0.00	0.00
2233235	2024-12-14 23:00:00	23	3	2.12	3.35	3.25	2.13	3.30	3.25	1	1	0	1	1	1	2	2	1	1	1	2	3	1	1	3	2	2	1	1	-1	0	0.01	-0.05	0.00
2233232	2024-12-12 03:45:00	23	1	2.29	3.45	2.82	2.26	3.45	2.88	3	1	4	1	1	7	4	2	11	7	9	0	11	2	3	1	2	1	3	-1	0	1	-0.03	0.00	0.06
2233233	2024-12-12 04:00:00	23	3	2.35	3.30	2.83	2.47	3.30	2.70	3	4	10	4	4	7	7	8	17	10	9	0	17	3	2	1	1	2	3	1	0	-1	0.12	0.00	-0.13
2233238	2024-12-14 04:00:00	23	3	1.92	3.35	3.85	2.01	3.30	3.55	11	7	14	15	7	10	26	14	24	8	20	10	34	1	3	2	3	1	2	1	-1	-1	0.09	-0.05	-0.30
2233239	2024-12-14 23:00:00	23	3	1.70	3.55	4.80	1.65	3.65	5.00	2	0	2	1	3	2	3	3	4	1	1	0	4	2	2	1	1	1	3	-1	1	1	-0.05	0.10	0.20
2233236	2024-12-14 20:30:00	23	1	1.93	3.40	3.75	1.86	3.45	3.95	4	1	1	2	3	3	6	4	4	1	3	3	7	1	2	2	3	1	1	-1	1	1	-0.07	0.05	0.20
2027433	2023-12-23 23:00:00	23	3	1.59	4.05	4.90	1.59	4.05	4.90	1	0	0	0	1	1	1	1	1	0	0	0	1	1	1	1	1	1	1	0	0	0	0.00	0.00	0.00
2027945	2024-04-20 22:00:00	23	3	1.83	3.40	4.20	1.83	3.40	4.20	0	3	2	0	2	3	0	5	5	7	2	2	7	3	1	1	1	2	2	0	0	0	0.00	0.00	0.00
2233237	2024-12-14 20:30:00	23	3	1.77	3.70	4.10	1.72	3.75	4.30	4	0	0	0	2	3	4	2	3	0	2	1	4	1	3	2	3	1	2	-1	1	1	-0.05	0.05	0.20
2233242	2024-12-14 20:30:00	23	1	5.10	3.70	1.63	5.20	3.65	1.63	1	1	0	1	1	0	2	2	0	0	0	2	2	1	1	3	2	2	1	1	-1	0	0.10	-0.05	0.00
2233243	2024-12-14 23:00:00	23	3	1.26	5.50	9.90	1.24	5.70	11.00	4	1	1	2	3	4	6	4	5	2	4	3	8	1	3	2	3	1	2	-1	1	1	-0.02	0.20	1.10
2233240	2024-12-15 23:00:00	23	0	2.71	3.20	2.51	2.72	3.20	2.51	2	0	0	1	0	0	3	0	0	0	3	3	3	1	2	2	3	1	1	1	0	0	0.01	0.00	0.00
2233241	2024-12-14 23:00:00	23	0	3.15	3.10	2.26	3.30	3.15	2.19	4	1	2	3	2	4	7	3	6	2	6	3	9	1	3	2	3	1	2	1	1	-1	0.15	0.05	-0.07
2233246	2024-12-14 23:00:00	23	0	2.55	3.15	2.68	2.54	3.20	2.68	3	0	1	1	1	3	4	1	4	0	3	0	4	1	3	1	2	1	2	-1	1	0	-0.01	0.05	0.00
2027427	2023-12-23 23:00:00	23	0	2.04	3.55	3.25	2.06	3.55	3.20	1	1	2	1	1	2	2	2	4	2	2	0	4	2	2	1	1	1	3	1	0	-1	0.02	0.00	-0.05
2027939	2024-04-20 22:00:00	23	1	1.66	3.75	4.65	1.65	3.80	4.70	3	2	1	2	3	3	5	5	4	3	3	4	8	1	1	3	2	2	1	-1	1	1	-0.01	0.05	0.05
2233247	2024-12-21 23:00:00	23	3	1.74	3.50	4.55	1.74	3.55	4.45	0	1	2	1	1	0	1	2	2	1	0	0	2	3	1	1	1	2	2	0	1	-1	0.00	0.05	-0.10
2233244	2024-12-15 22:00:00	23	3	2.74	3.20	2.47	2.70	3.20	2.51	4	0	1	2	0	5	6	0	6	1	7	1	7	1	3	1	2	1	2	-1	0	1	-0.04	0.00	0.04
2233245	2024-12-14 23:00:00	23	1	2.25	3.40	2.92	2.20	3.45	2.99	1	0	1	0	1	1	1	1	2	1	1	0	2	2	2	1	1	1	3	-1	1	1	-0.05	0.05	0.07
2027486	2024-01-01 23:00:00	23	3	1.23	5.70	8.80	1.24	6.10	9.90	1	0	1	1	3	5	2	3	6	5	4	1	7	3	2	1	1	2	3	1	1	1	0.01	0.40	1.10
2233312	2025-01-18 20:30:00	23	0	2.19	3.05	3.35	2.17	3.05	3.40	1	0	1	1	0	1	2	0	2	0	2	0	2	1	3	1	2	1	2	-1	0	1	-0.02	0.00	0.05
2027480	2023-12-30 04:15:00	23	3	3.00	3.35	2.23	2.98	3.25	2.28	7	4	0	7	3	1	14	7	1	0	7	13	14	1	2	3	3	2	1	-1	-1	1	-0.02	-0.10	0.05
2233322	2025-01-22 03:45:00	23	3	1.96	3.50	3.50	2.06	3.40	3.30	5	4	11	9	2	8	14	6	19	10	18	5	24	2	3	1	2	1	3	1	-1	-1	0.10	-0.10	-0.20
2027991	2024-05-04 19:30:00	23	3	2.07	3.50	3.20	2.07	3.50	3.20	0	0	1	0	1	0	0	1	1	1	0	0	1	3	1	1	1	2	2	0	0	0	0.00	0.00	0.00
2027476	2023-12-30 02:00:00	23	3	1.31	5.40	8.00	1.32	5.40	7.30	2	1	5	3	1	4	5	2	9	5	8	1	10	2	3	1	2	1	3	1	0	-1	0.01	0.00	-0.70
2027477	2023-12-30 03:45:00	23	1	2.14	3.30	3.20	2.19	3.30	3.10	0	0	3	1	0	0	1	0	3	2	3	0	3	2	3	1	2	1	3	1	0	-1	0.05	0.00	-0.10
2027474	2023-12-30 03:45:00	23	1	5.50	3.90	1.56	5.70	3.90	1.55	2	1	2	4	1	1	6	2	3	0	4	3	6	1	3	2	3	1	2	1	0	-1	0.20	0.00	-0.01
2233326	2025-01-22 03:45:00	23	0	2.71	3.25	2.47	2.77	3.20	2.47	6	3	12	14	2	9	20	5	21	3	18	2	23	2	3	1	2	1	3	1	-1	0	0.06	-0.05	0.00
2027985	2024-05-04 19:30:00	23	3	1.69	4.05	4.10	1.69	4.05	4.15	0	0	1	0	0	1	0	0	2	2	2	0	2	2	2	1	1	1	3	0	0	1	0.00	0.00	0.05
2027470	2023-12-30 03:45:00	23	3	2.40	3.30	2.76	2.42	3.30	2.75	2	1	5	6	0	4	8	1	9	2	9	1	10	2	3	1	2	1	3	1	0	-1	0.02	0.00	-0.01
2233330	2025-01-23 03:45:00	23	1	2.39	3.15	2.91	2.38	3.10	2.96	3	3	5	4	2	4	7	5	9	4	6	2	11	2	3	1	2	1	3	-1	-1	1	-0.01	-0.05	0.05
2027983	2024-05-04 19:30:00	23	0	1.54	4.30	5.20	1.56	4.25	5.00	6	7	8	7	7	7	13	14	15	5	4	3	18	3	2	1	1	2	3	1	-1	-1	0.02	-0.05	-0.20
2233328	2025-01-23 03:45:00	23	3	1.34	4.75	8.70	1.37	4.50	8.20	2	9	10	4	6	10	6	15	20	15	6	1	21	3	2	1	1	2	3	1	-1	-1	0.03	-0.25	-0.50
2233334	2025-01-25 23:00:00	23	3	1.76	3.70	4.10	1.75	3.75	4.15	2	1	2	1	2	2	3	3	4	1	1	0	4	2	2	1	1	1	3	-1	1	1	-0.01	0.05	0.05
2027464	2023-12-30 03:45:00	23	0	3.65	3.55	1.91	3.85	3.50	1.87	9	6	17	14	5	15	23	11	32	11	23	2	34	2	3	1	2	1	3	1	-1	-1	0.20	-0.05	-0.04
2027465	2023-12-30 03:45:00	23	3	1.89	4.05	3.30	1.88	4.10	3.30	11	6	8	8	7	9	19	13	17	7	13	9	26	1	3	2	3	1	2	-1	1	0	-0.01	0.05	0.00
2027460	2023-12-30 03:45:00	23	0	4.70	3.80	1.65	5.10	3.85	1.61	2	2	3	5	3	1	7	5	4	0	2	3	7	1	2	3	3	2	1	1	1	-1	0.40	0.05	-0.04
2027461	2023-12-30 03:45:00	23	1	1.78	3.75	3.95	1.74	3.80	4.10	2	1	1	1	1	2	3	2	3	0	1	0	3	1	3	1	2	1	2	-1	1	1	-0.04	0.05	0.15
2233337	2025-01-25 04:00:00	23	0	1.78	3.55	4.25	1.77	3.50	4.35	7	6	6	5	4	9	12	10	15	6	8	3	18	2	3	1	2	1	3	-1	-1	1	-0.01	-0.05	0.10
2027456	2023-12-26 23:00:00	23	3	2.00	3.50	3.40	2.04	3.45	3.35	2	2	2	4	2	2	6	4	4	0	2	2	6	1	2	2	3	1	1	1	-1	-1	0.04	-0.05	-0.05
2233282	2025-01-01 23:00:00	23	1	1.50	3.95	6.20	1.49	4.00	6.30	3	2	2	2	4	4	5	6	6	1	0	0	6	3	1	1	1	2	2	-1	1	1	-0.01	0.05	0.10
2233283	2024-12-29 23:00:00	23	3	2.16	3.35	3.10	2.19	3.35	3.10	1	0	1	1	1	2	2	1	3	1	2	0	3	2	3	1	2	1	3	1	0	0	0.03	0.00	0.00
2233281	2024-12-29 23:00:00	23	0	1.95	3.50	3.55	1.88	3.60	3.70	7	1	2	2	3	5	9	4	7	1	6	3	10	1	3	2	3	1	2	-1	1	1	-0.07	0.10	0.15
2233286	2025-01-01 21:00:00	23	0	1.72	3.50	4.70	1.72	3.50	4.75	0	1	1	0	1	1	0	2	2	3	1	1	3	3	1	1	1	2	2	0	0	1	0.00	0.00	0.05
2233284	2025-01-01 23:00:00	23	1	1.35	4.70	8.10	1.35	4.75	8.10	2	2	3	2	4	2	4	6	5	2	0	1	6	3	1	2	1	3	2	0	1	0	0.00	0.05	0.00
2233285	2025-01-01 23:00:00	23	0	2.43	3.30	2.73	2.50	3.35	2.63	4	1	7	6	2	4	10	3	11	2	9	1	12	2	3	1	2	1	3	1	1	-1	0.07	0.05	-0.10
2233290	2025-01-02 04:00:00	23	3	2.33	3.15	2.98	2.11	3.25	3.35	12	4	7	7	5	12	19	9	19	2	12	2	21	1	3	1	2	1	2	-1	1	1	-0.22	0.10	0.37
2233291	2025-01-01 23:00:00	23	3	1.84	3.30	4.30	1.88	3.25	4.15	1	2	3	3	1	1	4	3	4	1	2	1	5	1	3	1	2	1	2	1	-1	-1	0.04	-0.05	-0.15
2027508	2024-01-13 23:00:00	23	0	4.60	3.80	1.67	4.60	3.80	1.67	2	1	0	1	2	0	3	3	0	0	0	3	3	1	1	3	2	2	1	0	0	0	0.00	0.00	0.00
2027509	2024-01-13 20:30:00	23	3	3.30	3.50	2.03	3.25	3.50	2.06	3	1	3	2	1	3	5	2	6	2	5	1	7	2	3	1	2	1	3	-1	0	1	-0.05	0.00	0.03
2233289	2025-01-01 20:30:00	23	3	2.52	3.30	2.65	2.50	3.30	2.66	4	0	2	2	0	4	6	0	6	0	6	0	6	1	3	1	2	1	2	-1	0	1	-0.02	0.00	0.01
2233294	2025-01-01 23:00:00	23	3	2.77	3.40	2.36	2.72	3.35	2.42	5	2	0	4	2	1	9	4	1	0	5	8	9	1	2	3	3	2	1	-1	-1	1	-0.05	-0.05	0.06
2233295	2025-01-04 20:30:00	23	0	3.25	3.05	2.23	3.35	3.00	2.23	1	3	1	2	1	2	3	4	3	3	2	3	6	2	1	2	1	3	1	1	-1	0	0.10	-0.05	0.00
2027504	2024-01-01 23:00:00	23	3	3.10	3.20	2.23	3.20	3.20	2.19	0	0	1	2	0	0	2	0	1	0	2	1	2	1	3	2	3	1	2	1	0	-1	0.10	0.00	-0.04
2027502	2024-01-01 20:30:00	23	3	1.63	3.75	4.60	1.63	3.80	4.90	0	1	0	0	1	3	0	2	3	3	1	0	3	3	2	1	1	2	3	0	1	1	0.00	0.05	0.30
2233298	2025-01-04 23:00:00	23	3	2.31	3.45	2.81	2.31	3.45	2.81	0	0	1	0	1	0	0	1	1	1	0	0	1	3	1	1	1	2	2	0	0	0	0.00	0.00	0.00
2233296	2025-01-04 23:00:00	23	3	1.95	3.25	3.85	1.95	3.25	3.90	1	0	2	1	0	2	2	0	4	3	5	1	5	2	3	1	2	1	3	0	0	1	0.00	0.00	0.05
2233297	2025-01-04 23:00:00	23	1	5.70	4.00	1.53	6.20	4.05	1.49	4	6	5	7	7	3	11	13	8	6	4	9	17	2	1	3	2	3	1	1	1	-1	0.50	0.05	-0.04
2233300	2025-01-07 04:00:00	23	3	2.53	3.15	2.74	2.56	3.10	2.73	3	2	8	4	2	5	7	4	13	6	9	0	13	2	3	1	2	1	3	1	-1	-1	0.03	-0.05	-0.01
2233301	2025-01-04 23:00:00	23	1	2.13	3.10	3.45	2.20	3.10	3.30	0	2	2	1	1	1	1	3	3	3	1	1	4	3	1	1	1	2	2	1	0	-1	0.07	0.00	-0.15
2027494	2024-01-01 23:00:00	23	1	2.69	3.65	2.21	2.86	3.60	2.21	1	1	0	3	1	0	4	2	0	0	2	4	4	1	2	3	3	2	1	1	-1	0	0.17	-0.05	0.00
2233306	2025-01-18 04:00:00	23	1	2.19	3.05	3.40	2.23	2.93	3.45	2	4	1	3	1	4	5	5	5	4	4	4	9	1	1	1	1	1	1	1	-1	1	0.04	-0.12	0.05
2233307	2025-01-04 20:30:00	23	1	2.48	3.25	2.70	2.43	3.30	2.76	5	1	3	4	2	6	9	3	9	2	8	2	11	1	3	1	2	1	2	-1	1	1	-0.05	0.05	0.06
2233304	2025-01-04 23:00:00	23	0	2.83	3.30	2.37	2.82	3.30	2.37	2	0	2	2	1	1	4	1	3	0	3	1	4	1	3	2	3	1	2	-1	0	0	-0.01	0.00	0.00
2027493	2024-01-01 23:00:00	23	1	3.10	3.55	2.11	3.20	3.55	2.06	0	0	1	2	0	0	2	0	1	0	2	1	2	1	3	2	3	1	2	1	0	-1	0.10	0.00	-0.05
2027490	2024-01-01 23:00:00	23	3	1.17	6.30	12.00	1.19	6.60	12.00	0	1	1	1	3	1	1	4	2	4	1	3	5	3	1	2	1	3	2	1	1	0	0.02	0.30	0.00
2233310	2025-01-19 20:00:00	23	3	1.34	4.65	8.30	1.34	4.60	8.20	2	2	3	3	2	2	5	4	5	1	2	1	6	1	3	1	2	1	2	0	-1	-1	0.00	-0.05	-0.10
2135584	2024-02-23 04:00:00	24	1	1.30	4.80	7.00	1.33	5.50	8.30	7	4	13	5	8	17	12	12	30	19	19	1	31	2	2	1	1	1	3	1	1	1	0.03	0.70	1.30
2135585	2024-02-23 01:45:00	24	1	3.35	3.45	1.88	3.55	3.70	2.01	8	2	7	6	4	8	14	6	15	2	10	1	16	2	3	1	2	1	3	1	1	1	0.20	0.25	0.13
2135586	2024-02-23 01:45:00	24	0	2.50	3.40	2.35	2.77	3.65	2.42	8	2	0	5	3	2	13	5	2	1	9	12	14	1	2	3	3	2	1	1	1	1	0.27	0.25	0.07
2292256	2024-11-29 04:00:00	24	0	1.82	3.55	3.45	1.93	3.70	3.80	5	2	9	9	1	7	14	3	16	2	13	0	16	2	3	1	2	1	3	1	1	1	0.11	0.15	0.35
2135587	2024-02-23 04:00:00	24	3	2.40	3.45	2.43	2.55	3.80	2.53	12	1	14	12	5	11	24	6	25	3	21	2	27	2	3	1	2	1	3	1	1	1	0.15	0.35	0.10
2292257	2024-09-26 03:00:00	24	1	2.35	2.99	2.78	2.42	3.15	3.15	0	4	6	2	7	6	2	11	12	13	4	3	15	3	2	1	1	2	3	1	1	1	0.07	0.16	0.37
2135588	2024-02-23 04:00:00	24	3	1.69	3.70	3.85	1.69	3.95	4.85	3	1	4	2	2	7	5	3	11	6	8	0	11	2	3	1	2	1	3	0	1	1	0.00	0.25	1.00
2292262	2024-12-13 01:45:00	24	1	1.76	3.60	3.65	1.78	3.85	4.40	4	1	5	3	2	7	7	3	12	5	9	0	12	2	3	1	2	1	3	1	1	1	0.02	0.25	0.75
2292269	2024-12-13 01:45:00	24	0	4.40	3.85	1.56	5.50	4.10	1.60	8	9	4	11	6	7	19	15	11	1	5	9	20	1	2	3	3	2	1	1	1	1	1.10	0.25	0.04
2203443	2024-05-23 03:00:00	24	3	3.65	3.45	1.80	4.25	3.80	1.82	13	7	11	17	9	7	30	16	18	5	19	17	35	1	3	2	3	1	2	1	1	1	0.60	0.35	0.02
2093067	2023-12-01 04:00:00	24	0	6.10	5.20	1.32	8.30	5.80	1.33	16	7	12	22	11	10	38	18	22	0	20	16	38	1	3	2	3	1	2	1	1	1	2.20	0.60	0.01
2292279	2024-12-13 04:00:00	24	1	2.89	3.60	2.02	2.78	3.90	2.31	21	6	15	17	7	19	38	13	34	5	30	9	43	1	3	2	3	1	2	-1	1	1	-0.11	0.30	0.29
2093063	2023-10-06 03:00:00	24	0	5.20	4.60	1.40	5.90	4.85	1.42	5	4	5	7	4	6	12	8	11	0	4	1	12	1	3	2	3	1	2	1	1	1	0.70	0.25	0.02
2093062	2023-11-10 01:45:00	24	0	5.20	4.60	1.41	7.00	4.90	1.42	9	6	6	7	6	8	16	12	14	2	6	4	18	1	3	2	3	1	2	1	1	1	1.80	0.30	0.01
2071812	2023-08-18 01:30:00	24	3	2.73	3.15	2.29	2.78	3.45	2.22	2	3	6	5	3	3	7	6	9	2	3	0	9	2	3	1	2	1	3	1	1	-1	0.05	0.30	-0.07
2292281	2024-11-29 04:00:00	24	3	1.87	3.40	3.40	1.93	3.55	4.00	9	4	10	9	4	10	18	8	20	5	15	3	23	2	3	1	2	1	3	1	1	1	0.06	0.15	0.60
2071810	2023-08-18 02:00:00	24	1	1.69	3.70	3.85	1.77	3.60	3.90	1	5	8	4	5	4	5	10	12	8	3	1	13	3	2	1	1	2	3	1	-1	1	0.08	-0.10	0.05
2071809	2023-08-11 03:00:00	24	3	2.19	3.40	2.72	2.21	3.25	2.93	2	4	5	3	2	6	5	6	11	7	6	1	12	3	2	1	1	2	3	1	-1	1	0.02	-0.15	0.21
2071808	2023-08-18 02:00:00	24	1	3.10	3.50	1.95	3.40	3.60	1.89	5	2	4	5	3	5	10	5	9	1	6	2	11	1	3	2	3	1	2	1	1	-1	0.30	0.10	-0.06
2292226	2024-11-08 04:00:00	24	3	2.28	3.40	2.72	2.47	3.35	2.88	0	5	8	3	3	11	3	8	19	16	11	0	19	3	2	1	1	2	3	1	-1	1	0.19	-0.05	0.16
2292227	2025-01-24 01:45:00	24	0	2.59	3.55	2.21	2.61	3.70	2.35	10	3	9	12	4	7	22	7	16	0	15	6	22	1	3	2	3	1	2	1	1	1	0.02	0.15	0.14
2284544	2024-08-23 02:45:00	24	0	3.25	3.50	1.90	3.55	3.60	1.78	5	4	14	12	6	5	17	10	19	4	11	2	21	2	3	1	2	1	3	1	1	-1	0.30	0.10	-0.12
2292224	2024-12-13 01:45:00	24	1	1.41	4.25	5.70	1.53	4.35	6.10	5	6	9	9	5	9	14	11	18	5	8	1	19	2	3	1	2	1	3	1	1	1	0.12	0.10	0.40
2284545	2024-08-30 02:00:00	24	3	1.17	6.30	9.20	1.23	6.10	9.50	3	8	9	8	3	4	11	11	13	7	7	5	18	2	2	1	1	1	3	1	-1	1	0.06	-0.20	0.30
2292225	2024-11-08 04:00:00	24	1	2.54	3.60	2.33	2.54	3.80	2.54	10	2	6	11	4	8	21	6	14	2	17	9	23	1	3	2	3	1	2	0	1	1	0.00	0.20	0.21
2292230	2025-01-24 04:00:00	24	3	2.21	2.90	3.10	2.47	2.97	2.95	4	8	9	8	5	8	12	13	17	10	9	5	22	3	2	1	1	2	3	1	1	-1	0.26	0.07	-0.15
2284548	2024-08-30 03:00:00	24	0	4.40	3.80	1.58	4.65	3.95	1.63	8	5	4	6	6	7	14	11	11	1	4	4	15	1	2	2	3	1	1	1	1	1	0.25	0.15	0.05
2292228	2024-11-29 01:45:00	24	1	1.22	6.00	7.10	1.31	5.40	9.40	16	18	19	19	16	23	35	34	42	19	20	12	54	2	3	1	2	1	3	1	-1	1	0.09	-0.60	2.30
2284549	2024-08-23 01:30:00	24	3	1.13	6.80	12.00	1.15	6.40	11.00	5	8	10	7	7	8	12	15	18	10	7	4	22	3	2	1	1	2	3	1	-1	-1	0.02	-0.40	-1.00
2292232	2024-12-13 01:45:00	24	1	2.69	3.25	2.28	2.97	3.25	2.47	11	7	0	15	5	3	26	12	3	0	14	23	26	1	2	3	3	2	1	1	0	1	0.28	0.00	0.19
2292238	2024-09-27 03:00:00	24	3	1.89	3.60	3.20	1.95	3.75	3.70	11	2	10	11	4	9	22	6	19	5	21	8	27	1	3	2	3	1	2	1	1	1	0.06	0.15	0.50
2292242	2024-09-27 00:45:00	24	0	2.15	3.20	2.91	2.26	3.50	3.10	7	2	7	8	5	6	15	7	13	3	11	5	18	1	3	2	3	1	2	1	1	1	0.11	0.30	0.19
2292246	2025-01-24 01:45:00	24	0	2.79	2.91	2.40	2.55	3.15	2.68	15	3	9	9	4	14	24	7	23	0	17	1	24	1	3	2	3	1	2	-1	1	1	-0.24	0.24	0.28
2292247	2024-11-29 04:00:00	24	3	1.22	5.90	7.20	1.19	7.40	13.00	10	10	10	7	16	18	17	26	28	20	11	9	37	3	2	1	1	2	3	-1	1	1	-0.03	1.50	5.80
2292245	2024-12-13 01:45:00	24	1	2.85	3.55	2.05	3.35	3.70	2.09	5	3	9	11	4	5	16	7	14	3	12	5	19	1	3	2	3	1	2	1	1	1	0.50	0.15	0.04
2292250	2024-09-26 03:00:00	24	1	1.30	4.90	6.80	1.28	6.00	9.90	14	5	20	9	13	25	23	18	45	24	29	2	47	2	3	1	2	1	3	-1	1	1	-0.02	1.10	3.10
2292251	2024-11-29 04:00:00	24	0	2.97	3.50	2.01	3.30	3.75	2.09	8	4	8	9	5	8	17	9	16	3	11	4	20	1	3	2	3	1	2	1	1	1	0.33	0.25	0.08
2292249	2025-01-24 04:00:00	24	3	1.37	4.50	6.20	1.45	4.50	5.90	6	7	12	10	6	10	16	13	22	6	9	0	22	2	3	1	2	1	3	1	0	-1	0.08	0.00	-0.30
2135581	2024-02-23 04:00:00	24	1	2.09	3.25	3.00	2.12	3.50	3.40	19	5	12	14	5	17	33	10	29	4	27	8	37	1	3	2	3	1	2	1	1	1	0.03	0.25	0.40
2135582	2024-02-23 01:45:00	24	3	2.52	3.20	2.42	2.72	3.45	2.55	7	0	12	14	2	8	21	2	20	2	21	3	23	1	3	2	3	1	2	1	1	1	0.20	0.25	0.13
2135583	2024-02-23 01:45:00	24	1	2.31	3.20	2.68	2.47	3.25	2.96	0	6	7	3	4	9	3	10	16	16	9	3	19	3	2	1	1	2	3	1	1	1	0.16	0.05	0.28
2292253	2024-09-26 03:00:00	24	1	2.35	3.50	2.44	2.33	3.90	2.75	2	2	8	3	5	8	5	7	16	11	9	0	16	3	2	1	1	2	3	-1	1	1	-0.02	0.40	0.31
2264162	2024-08-09 02:00:00	24	1	2.10	3.30	2.92	2.12	3.30	2.90	2	2	3	4	2	3	6	4	6	2	4	2	8	1	3	1	2	1	2	1	0	-1	0.02	0.00	-0.02
2174304	2024-03-08 01:45:00	24	1	6.30	4.80	1.33	7.20	4.65	1.38	10	6	5	10	6	7	20	12	12	1	9	9	21	1	2	2	3	1	1	1	-1	1	0.90	-0.15	0.05
2174306	2024-03-15 04:00:00	24	3	1.15	7.70	12.00	1.18	7.50	13.00	1	5	4	4	4	3	5	9	7	9	5	7	14	3	1	2	1	3	2	1	-1	1	0.03	-0.20	1.00
2264161	2024-08-09 02:00:00	24	0	2.16	3.40	2.75	2.07	3.45	2.88	8	3	9	8	4	8	16	7	17	1	10	0	17	2	3	1	2	1	3	-1	1	1	-0.09	0.05	0.13
2264165	2024-08-09 03:30:00	24	1	1.44	4.05	5.50	1.44	4.15	5.40	17	12	15	14	15	20	31	27	35	5	9	1	36	2	3	1	2	1	3	0	1	-1	0.00	0.10	-0.10
2264170	2024-08-16 02:00:00	24	3	2.13	3.40	2.82	2.09	3.40	2.89	2	1	4	2	1	4	4	2	8	4	6	0	8	2	3	1	2	1	3	-1	0	1	-0.04	0.00	0.07
2264176	2024-08-16 02:15:00	24	0	1.78	3.50	3.60	1.75	3.65	3.65	3	2	3	2	5	3	5	7	6	7	5	6	12	3	1	2	1	3	2	-1	1	1	-0.03	0.15	0.05
2264177	2024-08-16 01:00:00	24	3	1.94	3.45	3.15	1.99	3.40	3.10	7	3	12	10	2	8	17	5	20	6	18	3	23	2	3	1	2	1	3	1	-1	-1	0.05	-0.05	-0.05
2264180	2024-08-16 02:30:00	24	0	2.86	3.30	2.14	2.89	3.25	2.14	1	1	4	5	0	4	6	1	8	2	7	0	8	2	3	1	2	1	3	1	-1	0	0.03	-0.05	0.00
2255230	2024-08-02 01:00:00	24	3	1.47	4.05	5.20	1.44	4.20	5.40	16	6	10	9	14	14	25	20	24	2	7	3	27	1	3	2	3	1	2	-1	1	1	-0.03	0.15	0.20
2084222	2023-08-25 01:00:00	24	1	1.80	3.50	3.60	1.69	3.90	3.95	2	2	5	2	7	5	4	9	10	7	2	1	11	3	2	1	1	2	3	-1	1	1	-0.11	0.40	0.35
2292291	2024-12-13 01:45:00	24	3	2.03	3.25	3.15	2.11	3.45	3.50	5	4	9	8	6	6	13	10	15	2	5	0	15	2	3	1	2	1	3	1	1	1	0.08	0.20	0.35
2292296	2024-11-29 04:00:00	24	1	1.70	4.35	4.30	1.68	4.35	4.45	3	2	2	1	4	6	4	6	8	4	2	0	8	3	2	1	1	2	3	-1	0	1	-0.02	0.00	0.15
2292297	2024-10-25 03:00:00	24	3	1.38	4.60	5.90	1.40	5.10	7.20	15	6	9	9	11	17	24	17	26	6	13	4	30	2	3	1	2	1	3	1	1	1	0.02	0.50	1.30
2292302	2024-10-25 03:00:00	24	0	2.57	3.25	2.36	2.77	3.35	2.55	8	1	14	15	1	9	23	2	23	0	21	0	23	1	3	1	2	1	2	1	1	1	0.20	0.10	0.19
2292303	2024-11-29 04:00:00	24	0	2.19	3.30	2.77	2.23	3.35	3.30	3	8	6	4	6	8	7	14	14	13	6	6	20	3	1	1	1	2	2	1	1	1	0.04	0.05	0.53
2174287	2024-03-08 01:45:00	24	0	3.50	3.65	1.79	4.00	4.10	1.71	6	3	4	7	8	2	13	11	6	3	5	10	16	1	2	3	3	2	1	1	1	-1	0.50	0.45	-0.08
2174289	2024-03-15 01:45:00	24	3	2.16	3.80	2.84	2.31	3.70	2.66	0	4	4	2	2	5	2	6	9	11	7	4	13	3	2	1	1	2	3	1	-1	-1	0.15	-0.10	-0.18
2174288	2024-03-15 04:00:00	24	3	1.25	5.80	8.90	1.31	5.80	8.50	6	6	11	9	5	7	15	11	18	4	8	1	19	2	3	1	2	1	3	1	0	-1	0.06	0.00	-0.40
2174291	2024-03-15 04:00:00	24	3	1.71	4.05	4.00	1.73	4.10	4.40	2	2	3	1	4	4	3	6	7	6	3	2	9	3	2	1	1	2	3	1	1	1	0.02	0.05	0.40
2174290	2024-03-08 01:45:00	24	3	2.08	3.55	3.15	2.14	3.50	3.05	5	1	4	4	1	6	9	2	10	1	8	0	10	2	3	1	2	1	3	1	-1	-1	0.06	-0.05	-0.10
2174293	2024-03-08 04:00:00	24	1	1.60	3.95	4.20	1.59	4.25	5.40	6	5	8	7	9	7	13	14	15	5	4	3	18	3	2	1	1	2	3	-1	1	1	-0.01	0.30	1.20
2174292	2024-03-08 04:00:00	24	3	1.95	3.60	3.45	1.82	3.85	4.15	11	3	7	9	8	11	20	11	18	2	11	4	22	1	3	2	3	1	2	-1	1	1	-0.13	0.25	0.70
2174294	2024-03-15 01:45:00	24	0	2.68	3.70	2.29	2.53	3.70	2.40	9	2	4	6	2	5	15	4	9	1	12	7	16	1	3	2	3	1	2	-1	0	1	-0.15	0.00	0.11
2174297	2024-03-15 01:45:00	24	3	1.71	3.90	4.20	1.70	3.90	4.25	5	2	2	1	4	6	6	6	8	4	4	2	10	2	2	1	1	1	3	-1	0	1	-0.01	0.00	0.05
2174296	2024-03-08 04:00:00	24	3	2.46	3.20	2.48	2.63	3.40	2.67	6	3	13	14	2	12	20	5	25	5	20	0	25	2	3	1	2	1	3	1	1	1	0.17	0.20	0.19
1986402	2023-06-01 03:00:00	24	1	2.72	2.77	2.85	2.81	3.00	2.77	20	12	29	21	12	30	41	24	59	20	37	2	61	2	3	1	2	1	3	1	1	-1	0.09	0.23	-0.08
2174301	2024-03-15 04:00:00	24	3	1.93	3.75	3.40	1.97	3.75	3.65	12	5	9	10	5	12	22	10	21	7	19	8	29	1	3	2	3	1	2	1	0	1	0.04	0.00	0.25
2174300	2024-03-07 01:45:00	24	1	2.08	3.55	3.15	2.20	3.50	2.96	1	2	4	3	2	4	4	4	8	4	4	0	8	2	2	1	1	1	3	1	-1	-1	0.12	-0.05	-0.19
2174303	2024-03-15 01:45:00	24	0	3.00	3.65	2.11	3.05	3.55	2.11	5	5	5	4	4	5	9	9	10	8	8	7	17	2	2	1	1	1	3	1	-1	0	0.05	-0.10	0.00
2264156	2024-08-09 01:00:00	24	3	1.91	3.50	3.25	1.91	3.45	3.25	19	11	15	16	10	19	35	21	34	5	19	6	40	1	3	2	3	1	2	0	-1	0	0.00	-0.05	0.00
2174302	2024-03-08 04:00:00	24	3	1.39	4.40	6.10	1.44	4.50	7.60	8	7	14	9	10	19	17	17	33	19	19	3	36	2	2	1	1	1	3	1	1	1	0.05	0.10	1.50
2083998	2023-08-25 02:30:00	24	3	1.47	4.00	5.40	1.46	4.10	6.00	4	8	8	3	9	10	7	17	18	12	2	1	19	3	2	1	1	2	3	-1	1	1	-0.01	0.10	0.60
2292151	2024-12-13 04:00:00	24	0	2.17	3.45	2.71	2.35	3.55	2.91	2	4	6	5	2	7	7	6	13	9	10	3	16	2	3	1	2	1	3	1	1	1	0.18	0.10	0.20
2084233	2023-09-01 00:00:00	24	1	1.59	3.70	4.65	1.62	3.85	4.45	5	4	4	4	7	6	9	11	10	2	0	1	11	3	1	2	1	3	2	1	1	-1	0.03	0.15	-0.20
2292154	2024-09-27 03:00:00	24	1	2.13	3.25	2.92	2.23	3.30	3.35	5	3	10	8	3	7	13	6	17	7	14	3	20	2	3	1	2	1	3	1	1	1	0.10	0.05	0.43
2084230	2023-09-01 02:00:00	24	0	1.26	5.30	7.00	1.26	5.80	7.20	3	2	3	2	4	5	5	6	8	3	2	0	8	3	2	1	1	2	3	0	1	1	0.00	0.50	0.20
2292155	2024-12-13 01:45:00	24	3	1.66	3.60	4.15	1.68	3.95	4.95	2	2	2	1	4	4	3	6	6	4	1	1	7	3	1	1	1	2	2	1	1	1	0.02	0.35	0.80
2084229	2023-09-01 02:45:00	24	0	2.79	3.45	2.12	2.51	3.50	2.40	6	1	1	2	1	5	8	2	6	1	7	3	9	1	3	2	3	1	2	-1	1	1	-0.28	0.05	0.28
2292152	2024-09-27 03:00:00	24	3	1.96	3.50	3.05	1.96	3.75	3.70	11	2	7	8	4	9	19	6	16	6	19	9	25	1	3	2	3	1	2	0	1	1	0.00	0.25	0.65
2292158	2024-11-29 01:45:00	24	1	3.20	3.35	1.97	3.35	3.55	2.14	6	2	6	8	5	7	14	7	13	3	10	4	17	1	3	2	3	1	2	1	1	1	0.15	0.20	0.17
2084226	2023-08-25 02:00:00	24	0	2.60	3.10	2.42	2.64	3.20	2.45	2	1	5	5	1	1	7	2	6	0	5	1	7	1	3	2	3	1	2	1	1	1	0.04	0.10	0.03
2084225	2023-08-25 02:00:00	24	0	3.75	3.70	1.72	3.75	3.75	1.76	7	3	1	5	6	2	12	9	3	2	5	11	14	1	2	3	3	2	1	0	1	1	0.00	0.05	0.04
2092991	2023-12-15 04:00:00	24	3	1.73	3.75	3.90	1.91	3.75	3.85	3	8	11	9	7	10	12	15	21	12	9	3	24	3	2	1	1	2	3	1	0	-1	0.18	0.00	-0.05
2255234	2024-07-26 02:00:00	24	3	1.24	5.10	8.40	1.23	5.20	8.80	4	2	5	2	4	8	6	6	13	7	7	0	13	2	2	1	1	1	3	-1	1	1	-0.01	0.10	0.40
2092990	2023-11-10 04:00:00	24	3	1.63	3.85	4.05	1.59	4.25	5.40	11	10	11	11	11	13	22	21	24	6	7	4	28	2	3	1	2	1	3	-1	1	1	-0.04	0.40	1.35
2255235	2024-08-02 02:00:00	24	0	4.20	3.65	1.64	3.80	3.65	1.72	5	3	0	4	3	2	9	6	2	4	7	11	13	1	2	3	3	2	1	-1	0	1	-0.40	0.00	0.08
2093243	2023-12-01 01:45:00	24	1	2.06	3.45	2.91	2.07	3.65	3.40	4	4	5	2	5	8	6	9	13	10	7	3	16	3	2	1	1	2	3	1	1	1	0.01	0.20	0.49
2203279	2024-05-10 03:00:00	24	3	1.73	3.75	4.30	1.78	3.80	4.45	3	2	8	3	2	7	6	4	15	10	12	1	16	2	3	1	2	1	3	1	1	1	0.05	0.05	0.15
2203278	2024-05-03 03:00:00	24	0	2.83	3.20	2.21	3.25	3.45	2.20	9	4	8	10	6	7	19	10	15	6	15	10	25	1	3	2	3	1	2	1	1	-1	0.42	0.25	-0.01
2203281	2024-05-10 03:00:00	24	1	1.52	4.20	5.60	1.49	4.45	6.40	5	2	2	3	4	4	8	6	6	5	7	7	13	1	2	2	3	1	1	-1	1	1	-0.03	0.25	0.80
2203280	2024-05-03 03:00:00	24	1	2.44	3.30	2.45	2.56	3.45	2.70	11	5	19	16	5	18	27	10	37	11	28	1	38	2	3	1	2	1	3	1	1	1	0.12	0.15	0.25
2284435	2024-08-23 01:00:00	24	1	1.86	3.40	3.45	1.80	3.45	3.65	6	3	5	4	4	6	10	7	11	1	4	0	11	2	3	1	2	1	3	-1	1	1	-0.06	0.05	0.20
2093023	2023-10-27 03:00:00	24	3	1.18	7.10	11.00	1.19	7.60	14.00	3	3	1	3	5	3	6	8	4	3	1	5	9	2	1	3	2	3	1	1	1	1	0.01	0.50	3.00
2292194	2024-11-08 01:45:00	24	1	3.15	3.50	2.01	3.30	3.70	2.09	8	4	8	7	7	7	15	11	15	4	8	4	19	1	3	1	2	1	2	1	1	1	0.15	0.20	0.08
2093022	2023-10-06 03:00:00	24	3	1.20	6.70	10.00	1.20	6.70	9.70	4	7	9	6	9	8	10	16	17	10	4	3	20	3	2	1	1	2	3	0	0	-1	0.00	0.00	-0.30
2093021	2023-12-01 04:00:00	24	3	1.14	7.60	8.90	1.13	9.10	20.00	5	9	7	5	11	10	10	20	17	13	3	6	23	3	1	2	1	3	2	-1	1	1	-0.01	1.50	11.10
2292198	2024-10-25 03:00:00	24	3	1.47	4.10	5.10	1.51	4.65	5.90	3	3	2	3	5	4	6	8	6	2	0	2	8	2	1	2	1	3	1	1	1	1	0.04	0.55	0.80
2187239	2024-04-12 03:00:00	24	3	1.89	3.50	3.25	1.85	3.80	4.05	11	2	7	8	3	11	19	5	18	5	19	6	24	1	3	2	3	1	2	-1	1	1	-0.04	0.30	0.80
2292196	2025-01-24 04:00:00	24	3	2.84	3.10	2.25	2.62	3.40	2.47	7	1	5	6	1	7	13	2	12	0	11	1	13	1	3	2	3	1	2	-1	1	1	-0.22	0.30	0.22
2187238	2024-04-12 03:00:00	24	3	1.38	4.60	5.80	1.38	4.80	8.50	9	10	12	8	9	16	17	19	28	13	11	2	30	3	2	1	1	2	3	0	1	1	0.00	0.20	2.70
2292197	2024-12-13 04:00:00	24	3	2.33	3.40	2.53	2.59	3.45	2.67	4	2	4	6	2	6	10	4	10	1	7	1	11	1	3	1	2	1	2	1	1	1	0.26	0.05	0.14
2187240	2024-04-19 03:00:00	24	3	2.59	3.20	2.38	3.00	3.40	2.36	4	3	4	8	5	2	12	8	6	1	5	7	13	1	2	3	3	2	1	1	1	-1	0.41	0.20	-0.02
2187243	2024-04-19 03:00:00	24	3	2.35	3.35	2.51	2.44	3.60	2.77	3	1	6	4	2	8	7	3	14	8	12	1	15	2	3	1	2	1	3	1	1	1	0.09	0.25	0.26
2292200	2024-12-13 04:00:00	24	3	1.29	5.10	6.90	1.29	5.80	9.70	8	6	16	8	9	15	16	15	31	17	18	2	33	2	3	1	2	1	3	0	1	1	0.00	0.70	2.80
2187242	2024-04-19 03:00:00	24	0	3.95	3.95	1.63	4.90	4.65	1.59	5	4	4	9	8	2	14	12	6	2	4	10	16	1	2	3	3	2	1	1	1	-1	0.95	0.70	-0.04
2292206	2024-12-11 23:30:00	24	0	2.18	3.10	2.94	2.25	3.35	3.25	0	2	4	1	4	2	1	6	6	9	4	4	10	3	1	1	1	2	2	1	1	1	0.07	0.25	0.31
2187244	2024-04-19 03:00:00	24	1	3.20	3.40	1.96	3.90	3.95	1.85	16	5	13	16	8	17	32	13	30	4	23	6	36	1	3	2	3	1	2	1	1	-1	0.70	0.55	-0.11
2093009	2023-10-27 03:00:00	24	3	1.28	5.70	8.50	1.34	5.60	8.10	8	7	15	13	6	9	21	13	24	5	13	2	26	2	3	1	2	1	3	1	-1	-1	0.06	-0.10	-0.40
2093008	2023-12-15 04:00:00	24	3	1.64	4.00	4.15	1.67	4.20	4.70	4	3	12	8	5	9	12	8	21	9	13	0	21	2	3	1	2	1	3	1	1	1	0.03	0.20	0.55
2292205	2024-11-29 04:00:00	24	1	2.97	3.40	2.05	3.35	3.35	2.20	6	3	5	8	3	5	14	6	10	0	8	4	14	1	3	2	3	1	2	1	-1	1	0.38	-0.05	0.15
2093006	2023-10-06 00:45:00	24	1	2.52	3.55	2.26	2.63	3.65	2.36	4	2	0	3	3	2	7	5	2	0	2	5	7	1	2	3	3	2	1	1	1	1	0.11	0.10	0.10
2292208	2024-10-25 03:00:00	24	1	2.84	3.40	2.10	2.77	3.70	2.40	8	2	4	6	4	3	14	6	7	3	11	10	17	1	3	2	3	1	2	-1	1	1	-0.07	0.30	0.30
2093003	2023-11-10 01:45:00	24	0	3.75	3.90	1.68	4.15	4.15	1.76	7	5	5	6	5	7	13	10	12	0	3	1	13	1	3	2	3	1	2	1	1	1	0.40	0.25	0.08
2284534	2024-08-23 01:00:00	24	3	1.36	4.50	6.20	1.40	4.35	5.70	11	10	12	12	10	13	23	20	25	5	8	3	28	2	3	1	2	1	3	1	-1	-1	0.04	-0.15	-0.50
2292214	2024-11-29 04:00:00	24	3	1.82	3.50	3.50	1.90	3.65	4.00	2	6	6	3	5	6	5	11	12	8	2	1	13	3	2	1	1	2	3	1	1	1	0.08	0.15	0.50
2284535	2024-08-30 02:45:00	24	0	3.10	3.35	2.00	3.20	3.45	2.08	3	3	2	2	3	5	5	6	7	7	6	5	12	3	2	1	1	2	3	1	1	1	0.10	0.10	0.08
2284533	2024-08-30 02:00:00	24	3	1.25	5.10	8.20	1.35	4.80	7.40	1	7	10	8	2	5	9	9	15	6	6	0	15	2	2	1	1	1	3	1	-1	-1	0.10	-0.30	-0.80
2284536	2024-08-23 01:00:00	24	0	1.49	4.00	5.10	1.54	3.90	4.70	6	7	13	8	6	11	14	13	24	12	13	2	26	2	3	1	2	1	3	1	-1	-1	0.05	-0.10	-0.40
2092996	2023-10-06 00:45:00	24	0	2.44	3.25	2.47	2.54	3.50	2.49	3	2	2	5	1	5	8	3	7	0	5	1	8	1	3	2	3	1	2	1	1	1	0.10	0.25	0.02
2093252	2023-12-15 04:00:00	24	0	1.75	3.75	3.80	2.02	3.55	3.65	5	5	12	12	3	9	17	8	21	6	15	2	23	2	3	1	2	1	3	1	-1	-1	0.27	-0.20	-0.15
2284537	2024-08-30 01:00:00	24	0	2.10	3.45	2.81	2.26	3.65	2.75	4	3	10	6	5	7	10	8	17	8	10	1	18	2	3	1	2	1	3	1	1	-1	0.16	0.20	-0.06
2284542	2024-08-23 02:30:00	24	1	2.86	3.30	2.13	2.82	3.40	2.12	15	8	8	10	9	7	25	17	15	3	11	13	28	1	2	3	3	2	1	-1	1	-1	-0.04	0.10	-0.01
2092994	2023-10-27 00:45:00	24	3	2.78	3.55	2.29	3.05	3.65	2.25	3	2	4	6	3	2	9	5	6	2	6	5	11	1	3	2	3	1	2	1	1	-1	0.27	0.10	-0.04
2284540	2024-08-23 03:30:00	24	3	1.56	3.85	4.55	1.54	3.90	4.60	8	6	8	5	7	10	13	13	18	6	6	1	19	2	2	1	1	1	3	-1	1	1	-0.02	0.05	0.05
2284541	2024-08-30 03:00:00	24	1	2.62	3.30	2.31	2.60	3.46	2.44	5	1	2	3	2	4	8	3	6	1	6	3	9	1	3	2	3	1	2	-1	1	1	-0.02	0.16	0.13
2071806	2023-08-11 01:00:00	24	3	1.53	3.70	5.20	1.53	3.80	5.50	0	3	1	1	3	3	1	6	4	5	0	2	6	3	1	2	1	3	2	0	1	1	0.00	0.10	0.30
2071804	2023-08-18 02:00:00	24	3	1.40	4.10	6.50	1.43	4.15	6.20	5	5	5	4	4	7	9	9	12	3	3	0	12	2	2	1	1	1	3	1	1	-1	0.03	0.05	-0.30
2227653	2024-07-19 02:15:00	24	1	1.63	3.65	4.30	1.56	3.90	4.50	11	6	9	4	12	14	15	18	23	12	9	4	27	3	2	1	1	2	3	-1	1	1	-0.07	0.25	0.20
2071802	2023-08-18 00:00:00	24	0	2.83	3.05	2.27	2.94	3.25	2.21	4	3	4	7	3	5	11	6	9	0	5	2	11	1	3	2	3	1	2	1	1	-1	0.11	0.20	-0.06
2071801	2023-08-11 00:00:00	24	3	1.40	4.20	6.80	1.44	4.00	6.20	7	8	9	8	6	10	15	14	19	4	5	0	19	2	3	1	2	1	3	1	-1	-1	0.04	-0.20	-0.60
2086649	2023-09-01 01:00:00	24	3	1.93	3.50	3.40	1.95	3.55	3.25	2	1	3	3	2	2	5	3	5	1	3	1	6	1	3	1	2	1	2	1	1	-1	0.02	0.05	-0.15
2227655	2024-07-19 00:00:00	24	0	2.11	3.50	2.77	2.33	3.50	2.47	7	4	7	6	3	9	13	7	16	3	9	0	16	2	3	1	2	1	3	1	0	-1	0.22	0.00	-0.30
2093047	2023-12-15 01:45:00	24	3	1.15	7.10	12.00	1.19	7.30	14.00	6	12	8	10	9	6	16	21	14	8	3	10	24	2	1	3	2	3	1	1	1	1	0.04	0.20	2.00
2292170	2024-09-26 00:45:00	24	3	1.42	4.20	5.70	1.44	4.85	5.60	6	6	6	6	9	7	12	15	13	9	6	8	21	3	1	2	1	3	2	1	1	-1	0.02	0.65	-0.10
2093046	2023-10-06 03:00:00	24	3	1.14	6.60	11.00	1.18	6.70	12.00	4	7	5	6	4	6	10	11	11	4	3	3	14	3	1	1	1	2	2	1	1	1	0.04	0.10	1.00
2093045	2023-10-27 03:00:00	24	3	1.74	3.75	4.20	1.66	3.90	5.20	2	7	9	2	7	10	4	14	19	16	6	1	20	3	2	1	1	2	3	-1	1	1	-0.08	0.15	1.00
2292168	2024-11-29 01:45:00	24	3	1.19	6.10	8.70	1.22	6.60	13.00	5	12	7	7	12	10	12	24	17	18	6	13	30	3	1	2	1	3	2	1	1	1	0.03	0.50	4.30
2292169	2025-01-24 01:45:00	24	3	3.40	3.50	2.13	2.90	3.35	2.28	9	5	7	10	3	7	19	8	14	0	11	5	19	1	3	2	3	1	2	-1	-1	1	-0.50	-0.15	0.15
2227663	2024-07-26 02:30:00	24	3	1.09	8.10	13.00	1.08	8.50	14.00	7	13	9	8	12	8	15	25	17	12	2	10	27	3	1	2	1	3	2	-1	1	1	-0.01	0.40	1.00
2292172	2024-11-29 01:45:00	24	1	2.80	3.45	2.12	3.00	3.75	2.23	11	4	7	11	6	8	22	10	15	1	13	8	23	1	3	2	3	1	2	1	1	1	0.20	0.30	0.11
2227665	2024-07-19 00:00:00	24	0	3.15	3.30	2.02	2.66	3.35	2.25	6	4	6	6	5	5	12	9	11	4	7	5	16	1	3	2	3	1	2	-1	1	1	-0.49	0.05	0.23
2292178	2024-09-26 00:45:00	24	3	3.20	3.65	1.88	3.45	3.75	1.91	6	5	10	10	6	8	16	11	18	5	10	3	21	2	3	1	2	1	3	1	1	1	0.25	0.10	0.03
2227667	2024-07-26 02:30:00	24	1	3.30	3.50	1.89	3.65	3.55	1.78	6	4	10	10	5	8	16	9	18	3	10	1	19	2	3	1	2	1	3	1	1	-1	0.35	0.05	-0.11
2292177	2024-12-13 04:00:00	24	3	1.76	3.70	3.55	1.68	4.20	4.60	7	1	3	1	6	8	8	7	11	5	6	2	13	2	3	1	2	1	3	-1	1	1	-0.08	0.50	1.05
2093035	2023-12-01 04:00:00	24	3	1.78	3.60	3.55	1.83	3.80	4.20	8	5	6	7	6	10	15	11	16	5	9	4	20	2	3	1	2	1	3	1	1	1	0.05	0.20	0.65
2227669	2024-08-02 02:00:00	24	3	1.46	4.20	5.00	1.45	4.15	5.10	7	7	8	8	5	7	15	12	15	0	3	0	15	1	3	1	2	1	2	-1	-1	1	-0.01	-0.05	0.10
2292182	2024-11-29 04:00:00	24	3	2.00	3.65	2.88	2.11	3.75	3.20	2	5	8	5	5	6	7	10	14	14	11	7	21	3	2	1	1	2	3	1	1	1	0.11	0.10	0.32
2227671	2024-08-02 01:15:00	24	3	2.39	3.40	2.44	2.33	3.40	2.53	14	0	15	13	0	14	27	0	29	2	29	0	29	2	3	1	2	1	3	-1	0	1	-0.06	0.00	0.09
2227670	2024-07-26 01:00:00	24	3	1.52	3.95	4.90	1.51	4.05	4.80	4	2	7	4	3	5	8	5	12	4	7	0	12	2	3	1	2	1	3	-1	1	-1	-0.01	0.10	-0.10
2292181	2024-10-23 22:30:00	24	0	1.74	3.60	3.70	1.72	4.10	4.45	2	2	5	4	4	3	6	6	8	3	3	1	9	2	2	1	1	1	3	-1	1	1	-0.02	0.50	0.75
2093030	2023-11-10 01:45:00	24	3	5.60	4.50	1.40	7.10	4.85	1.43	13	7	9	11	9	11	24	16	20	4	12	8	28	1	3	2	3	1	2	1	1	1	1.50	0.35	0.03
2093027	2023-12-15 01:45:00	24	3	2.11	3.50	2.95	2.36	3.65	2.63	1	1	11	9	2	5	10	3	16	7	14	1	17	2	3	1	2	1	3	1	1	-1	0.25	0.15	-0.32
2292190	2024-09-27 03:00:00	24	1	1.31	4.95	6.40	1.33	5.30	9.00	5	4	7	4	7	10	9	11	17	8	6	0	17	3	2	1	1	2	3	1	1	1	0.02	0.35	2.60
2093026	2023-09-22 00:45:00	24	0	6.70	4.95	1.31	8.10	5.50	1.29	7	5	8	9	8	6	16	13	14	0	3	2	16	1	3	2	3	1	2	1	1	-1	1.40	0.55	-0.02
2187231	2024-04-12 03:00:00	24	0	1.30	5.00	6.70	1.35	5.30	8.20	15	10	27	19	11	22	34	21	49	22	35	7	56	2	3	1	2	1	3	1	1	1	0.05	0.30	1.50
2187230	2024-04-12 03:00:00	24	0	1.80	3.50	4.75	1.82	3.55	4.55	11	6	10	6	8	15	17	14	25	12	15	4	29	2	3	1	2	1	3	1	1	-1	0.02	0.05	-0.20
2292189	2025-01-24 04:00:00	24	3	1.49	4.15	5.00	1.48	4.40	5.70	6	5	7	4	8	11	10	13	18	9	6	1	19	3	2	1	1	2	3	-1	1	1	-0.01	0.25	0.70
2226337	2025-01-18 23:00:00	25	0	6.40	4.90	1.38	6.60	5.20	1.42	10	4	7	10	6	7	20	10	14	3	13	9	23	1	3	2	3	1	2	1	1	1	0.20	0.30	0.04
2226336	2024-11-23 23:00:00	25	1	1.58	4.00	5.10	1.61	4.05	5.50	0	3	2	1	2	2	1	5	4	5	1	2	6	3	1	2	1	3	2	1	1	1	0.03	0.05	0.40
2226339	2025-01-19 01:30:00	25	1	1.46	4.10	6.60	1.56	4.10	6.00	0	5	6	3	2	5	3	7	11	11	7	3	14	3	2	1	1	2	3	1	0	-1	0.10	0.00	-0.60
2226338	2024-11-23 23:00:00	25	1	2.33	3.45	2.77	2.33	3.55	2.96	0	0	1	0	1	1	0	1	2	2	1	0	2	3	2	1	1	2	3	0	1	1	0.00	0.10	0.19
2226341	2025-01-21 04:00:00	25	3	1.38	4.95	6.40	1.41	5.10	6.80	12	6	14	13	6	17	25	12	31	11	24	5	36	2	3	1	2	1	3	1	1	1	0.03	0.15	0.40
2226340	2024-11-23 23:00:00	25	0	1.71	3.95	4.15	1.67	4.10	4.80	1	0	1	0	3	2	1	3	3	2	0	0	3	3	1	1	1	2	2	-1	1	1	-0.04	0.15	0.65
2226343	2024-08-18 23:30:00	25	0	3.60	3.85	1.84	3.95	3.85	1.87	8	4	15	13	4	11	21	8	26	7	20	2	28	2	3	1	2	1	3	1	0	1	0.35	0.00	0.03
2226342	2025-01-19 22:00:00	25	3	2.69	3.40	2.42	2.74	3.50	2.51	8	2	5	10	1	6	18	3	11	0	15	7	18	1	3	2	3	1	2	1	1	1	0.05	0.10	0.09
2226345	2025-01-20 00:30:00	25	0	7.10	5.10	1.35	7.30	5.10	1.39	6	2	7	11	5	5	17	7	12	0	10	5	17	1	3	2	3	1	2	1	0	1	0.20	0.00	0.04
2226344	2024-11-25 00:30:00	25	1	4.40	4.25	1.62	4.90	4.25	1.64	13	10	17	19	11	10	32	21	27	2	13	7	34	1	3	2	3	1	2	1	0	1	0.50	0.00	0.02
2226347	2024-11-23 20:30:00	25	0	6.40	4.65	1.42	7.20	5.00	1.41	7	4	7	9	8	6	16	12	13	1	5	4	17	1	3	2	3	1	2	1	1	-1	0.80	0.35	-0.01
2226346	2024-08-20 03:00:00	25	1	4.70	4.20	1.59	5.00	4.45	1.60	11	6	11	14	7	12	25	13	23	2	14	4	27	1	3	2	3	1	2	1	1	1	0.30	0.25	0.01
2226349	2024-11-24 01:30:00	25	0	1.46	4.85	5.40	1.46	5.10	5.90	5	4	9	5	8	12	10	12	21	13	11	2	23	3	2	1	1	2	3	0	1	1	0.00	0.25	0.50
2226348	2025-01-18 23:00:00	25	0	4.10	3.50	1.82	4.15	3.85	1.82	1	0	2	4	1	1	5	1	3	0	4	2	5	1	3	2	3	1	2	1	1	0	0.05	0.35	0.00
2226351	2025-01-19 22:00:00	25	0	2.08	3.50	3.20	2.13	3.70	3.20	3	1	3	3	2	2	6	3	5	3	6	4	9	1	3	2	3	1	2	1	1	0	0.05	0.20	0.00
2226350	2024-08-18 21:00:00	25	3	2.36	3.45	2.74	2.36	3.50	2.94	0	0	1	0	1	3	0	1	4	4	3	0	4	3	2	1	1	2	3	0	1	1	0.00	0.05	0.20
2226353	2025-01-18 20:30:00	25	0	1.60	4.10	4.75	1.60	4.30	5.20	1	0	0	0	2	2	1	2	2	1	0	0	2	3	1	1	1	2	2	0	1	1	0.00	0.20	0.45
2226352	2024-11-26 04:00:00	25	0	1.53	4.45	5.80	1.51	4.45	6.00	2	2	3	2	4	4	4	6	7	3	1	0	7	3	2	1	1	2	3	-1	0	1	-0.02	0.00	0.20
2226355	2024-11-24 22:00:00	25	0	9.40	5.70	1.26	9.90	6.00	1.28	4	2	2	6	4	2	10	6	4	0	4	6	10	1	2	3	3	2	1	1	1	1	0.50	0.30	0.02
2226354	2025-01-19 22:00:00	25	3	1.35	4.80	7.80	1.38	4.85	8.40	5	5	8	6	6	9	11	11	17	6	6	0	17	2	2	1	1	1	3	1	1	1	0.03	0.05	0.60
2226357	2024-08-25 00:30:00	25	0	4.00	3.80	1.76	4.35	3.85	1.78	4	2	2	5	3	2	9	5	4	0	4	5	9	1	2	3	3	2	1	1	1	1	0.35	0.05	0.02
2226356	2025-01-18 23:00:00	25	0	2.56	3.25	2.61	2.82	3.35	2.51	6	2	13	14	2	7	20	4	20	2	18	2	22	1	3	1	2	1	2	1	1	-1	0.26	0.10	-0.10
2226359	2024-08-25 21:00:00	25	1	2.67	3.70	2.29	2.88	3.80	2.28	1	1	1	4	1	1	5	2	2	0	3	3	5	1	2	2	3	1	1	1	1	-1	0.21	0.10	-0.01
2226358	2024-11-30 23:00:00	25	3	1.63	4.05	4.60	1.65	4.15	4.95	4	2	5	5	4	6	9	6	11	4	7	2	13	2	3	1	2	1	3	1	1	1	0.02	0.10	0.35
2226361	2025-01-27 00:30:00	25	1	1.53	4.25	5.20	1.57	4.30	5.50	8	5	9	9	5	9	17	10	18	3	10	2	20	2	3	1	2	1	3	1	1	1	0.04	0.05	0.30
2226360	2025-01-25 23:00:00	25	3	2.05	3.50	3.25	2.13	3.60	3.30	4	0	6	9	1	5	13	1	11	1	13	3	14	1	3	2	3	1	2	1	1	1	0.08	0.10	0.05
2226363	2025-01-25 23:00:00	25	0	1.64	3.80	4.85	1.64	3.90	5.40	0	1	0	0	1	3	0	2	3	3	1	0	3	3	2	1	1	2	3	0	1	1	0.00	0.10	0.55
2226362	2024-11-30 04:00:00	25	1	1.37	5.00	6.90	1.37	5.20	7.90	9	0	8	9	3	13	18	3	21	9	24	6	27	2	3	1	2	1	3	0	1	1	0.00	0.20	1.00
2226365	2024-11-30 23:00:00	25	1	2.83	3.55	2.25	3.00	3.65	2.26	1	1	1	2	3	1	3	4	2	1	0	2	4	2	1	3	2	3	1	1	1	1	0.17	0.10	0.01
2226364	2024-12-01 21:30:00	25	3	1.73	4.00	4.00	1.70	4.05	4.10	1	1	2	0	2	3	1	3	5	5	3	1	6	3	2	1	1	2	3	-1	1	1	-0.03	0.05	0.10
2226367	2024-08-24 19:30:00	25	3	2.49	3.70	2.46	2.51	3.70	2.62	0	2	2	1	3	3	1	5	5	8	4	4	9	3	1	1	1	2	2	1	0	1	0.02	0.00	0.16
2226366	2025-01-26 22:00:00	25	0	2.11	3.55	3.10	2.02	3.60	3.60	4	1	3	3	2	5	7	3	8	2	6	1	9	2	3	1	2	1	3	-1	1	1	-0.09	0.05	0.50
2226307	2025-01-16 04:00:00	25	3	1.42	4.70	5.90	1.36	5.30	8.00	19	9	18	16	13	29	35	22	47	20	33	8	55	2	3	1	2	1	3	-1	1	1	-0.06	0.60	2.10
2226309	2024-11-09 23:00:00	25	3	2.42	3.50	2.61	2.40	3.70	2.77	1	0	3	1	2	2	2	2	5	3	3	0	5	2	2	1	1	1	3	-1	1	1	-0.02	0.20	0.16
2226308	2025-01-15 03:30:00	25	1	4.10	4.25	1.67	4.20	4.40	1.71	17	8	13	15	7	16	32	15	29	3	20	6	35	1	3	2	3	1	2	1	1	1	0.10	0.15	0.04
2226311	2025-01-17 03:30:00	25	0	3.80	3.50	1.89	3.60	3.60	2.03	19	4	9	11	3	20	30	7	29	4	27	5	34	1	3	2	3	1	2	-1	1	1	-0.20	0.10	0.14
2226310	2025-01-16 03:30:00	25	0	3.25	3.20	2.33	3.50	3.15	2.25	5	3	4	9	2	2	14	5	6	3	12	11	17	1	3	2	3	1	2	1	-1	-1	0.25	-0.05	-0.08
2226313	2025-01-16 03:30:00	25	0	3.60	3.65	1.89	3.65	3.55	2.02	16	8	8	11	7	18	27	15	26	8	20	9	35	1	3	2	3	1	2	1	-1	1	0.05	-0.10	0.13
2226312	2024-11-10 01:30:00	25	3	3.85	3.85	1.78	4.25	4.05	1.76	4	0	6	6	2	3	10	2	9	1	9	2	11	1	3	2	3	1	2	1	1	-1	0.40	0.20	-0.02
2226315	2024-11-11 00:30:00	25	1	2.65	3.30	2.51	2.75	3.45	2.51	10	1	8	11	2	7	21	3	15	0	18	6	21	1	3	2	3	1	2	1	1	0	0.10	0.15	0.00
2226314	2025-01-15 04:00:00	25	1	4.60	3.95	1.64	4.95	4.00	1.67	7	3	3	5	1	7	12	4	10	0	8	2	12	1	3	2	3	1	2	1	1	1	0.35	0.05	0.03
2226317	2024-11-09 23:00:00	25	0	2.55	3.45	2.51	2.81	3.40	2.51	5	1	3	6	0	3	11	1	6	0	10	5	11	1	3	2	3	1	2	1	-1	0	0.26	-0.05	0.00
2226316	2024-08-17 03:00:00	25	3	1.57	4.30	4.75	1.61	4.45	4.90	9	6	10	11	6	10	20	12	20	3	11	3	23	1	3	1	2	1	2	1	1	1	0.04	0.15	0.15
2226319	2024-11-10 04:00:00	25	3	1.43	4.75	6.00	1.47	4.65	6.70	7	9	8	7	8	11	14	17	19	14	11	9	28	3	2	1	1	2	3	1	-1	1	0.04	-0.10	0.70
2226318	2025-01-15 03:30:00	25	3	2.63	3.50	2.42	2.87	3.30	2.51	10	7	1	14	4	4	24	11	5	1	14	20	25	1	2	3	3	2	1	1	-1	1	0.24	-0.20	0.09
2226321	2024-11-10 22:00:00	25	3	1.37	5.10	6.40	1.37	5.30	7.90	3	1	3	3	3	5	6	4	8	4	6	2	10	2	3	1	2	1	3	0	1	1	0.00	0.20	1.50
2226320	2025-01-15 03:30:00	25	1	1.56	4.35	4.75	1.48	4.75	6.00	18	9	12	11	13	18	29	22	30	3	10	2	32	2	3	1	2	1	3	-1	1	1	-0.08	0.40	1.25
2226323	2024-08-17 19:30:00	25	0	7.00	5.30	1.34	8.50	5.70	1.32	7	3	5	10	7	5	17	10	10	1	8	8	18	1	2	2	3	1	1	1	1	-1	1.50	0.40	-0.02
2226322	2025-01-17 04:00:00	25	3	1.28	5.70	8.10	1.29	5.80	9.60	9	6	16	9	6	16	18	12	32	14	20	0	32	2	3	1	2	1	3	1	1	1	0.01	0.10	1.50
2226325	2024-11-10 22:00:00	25	0	2.55	3.25	2.63	2.61	3.45	2.66	3	1	2	3	2	4	6	3	6	2	5	2	8	1	3	1	2	1	2	1	1	1	0.06	0.20	0.03
2226324	2025-01-16 03:30:00	25	3	1.34	5.00	7.20	1.40	4.95	7.50	6	8	13	10	6	11	16	14	24	8	10	0	24	2	3	1	2	1	3	1	-1	1	0.06	-0.05	0.30
2226327	2024-08-17 22:00:00	25	3	1.18	6.90	12.00	1.19	7.20	14.00	3	2	4	4	4	5	7	6	9	7	8	5	14	2	3	1	2	1	3	1	1	1	0.01	0.30	2.00
2226326	2024-11-10 22:00:00	25	0	1.26	6.20	7.40	1.25	6.70	9.90	2	3	6	1	5	5	3	8	11	11	6	3	14	3	2	1	1	2	3	-1	1	1	-0.01	0.50	2.50
2226329	2024-08-17 22:00:00	25	0	2.61	3.45	2.47	2.59	3.55	2.61	2	1	1	1	2	4	3	3	5	3	3	1	6	2	2	1	1	1	3	-1	1	1	-0.02	0.10	0.14
2226328	2024-11-09 23:00:00	25	1	2.17	3.30	3.15	2.16	3.55	3.25	3	0	1	1	1	3	4	1	4	2	5	2	6	1	3	1	2	1	2	-1	1	1	-0.01	0.25	0.10
2226331	2024-08-17 22:00:00	25	1	2.42	3.45	2.65	2.42	3.55	2.83	0	1	3	0	1	6	0	2	9	9	7	0	9	3	2	1	1	2	3	0	1	1	0.00	0.10	0.18
2226330	2024-11-09 23:00:00	25	3	1.90	3.70	3.55	1.88	3.90	3.85	6	1	2	3	2	6	9	3	8	1	7	2	10	1	3	2	3	1	2	-1	1	1	-0.02	0.20	0.30
2226333	2024-11-23 23:00:00	25	0	2.35	3.70	2.61	2.35	3.60	2.88	0	2	2	0	2	3	0	4	5	6	2	1	6	3	2	1	1	2	3	0	-1	1	0.00	-0.10	0.27
2226332	2024-08-17 22:00:00	25	3	1.33	5.30	7.20	1.33	5.60	8.50	7	4	7	5	7	10	12	11	17	5	6	0	17	2	3	1	2	1	3	0	1	1	0.00	0.30	1.30
2226335	2024-08-18 00:30:00	25	0	2.42	3.60	2.56	2.44	3.70	2.70	2	0	5	3	1	4	5	1	9	4	8	0	9	2	3	1	2	1	3	1	1	1	0.02	0.10	0.14
2226334	2024-11-23 23:00:00	25	3	1.40	4.45	6.90	1.36	4.85	9.40	9	5	9	6	9	14	15	14	23	8	9	0	23	2	3	1	2	1	3	-1	1	1	-0.04	0.40	2.50
2226401	2024-09-01 20:30:00	25	3	2.47	3.80	2.42	2.42	4.00	2.59	4	2	2	2	3	5	6	5	7	4	5	3	10	2	3	1	2	1	3	-1	1	1	-0.05	0.20	0.17
2226400	2024-09-01 23:00:00	25	0	3.25	3.90	1.93	3.90	4.05	1.83	4	5	11	10	6	6	14	11	17	8	11	5	22	2	3	1	2	1	3	1	1	-1	0.65	0.15	-0.10
2226404	2024-08-31 22:00:00	25	1	2.08	3.50	3.20	2.08	3.50	3.50	5	2	5	7	2	7	12	4	12	6	14	6	18	1	3	1	2	1	2	0	0	1	0.00	0.00	0.30
2226406	2024-09-01 00:30:00	25	0	7.60	5.00	1.34	7.00	5.30	1.38	7	4	4	6	3	7	13	7	11	1	7	3	14	1	3	2	3	1	2	-1	1	1	-0.60	0.30	0.04
2226410	2024-09-15 03:00:00	25	0	3.05	3.90	2.02	3.15	4.00	2.08	11	4	7	8	6	12	19	10	19	11	20	11	30	1	3	1	2	1	2	1	1	1	0.10	0.10	0.06
2226413	2024-09-15 00:30:00	25	3	1.48	4.25	6.00	1.52	4.30	6.40	5	5	9	11	4	7	16	9	16	4	11	4	20	1	3	1	2	1	2	1	1	1	0.04	0.05	0.40
2226415	2024-09-14 22:00:00	25	1	1.39	4.70	6.90	1.39	5.10	7.60	3	3	5	4	4	5	7	7	10	4	4	1	11	2	2	1	1	1	3	0	1	1	0.00	0.40	0.70
2226417	2024-12-06 04:15:00	25	3	2.58	3.90	2.47	2.44	3.75	2.67	10	3	19	19	2	13	29	5	32	6	30	3	35	2	3	1	2	1	3	-1	-1	1	-0.14	-0.15	0.20
2226419	2024-12-05 04:15:00	25	3	1.40	4.50	7.00	1.43	4.50	7.60	19	23	30	27	17	25	46	40	55	27	33	18	73	2	3	1	2	1	3	1	0	1	0.03	0.00	0.60
2226418	2024-09-14 22:00:00	25	1	1.64	3.90	4.65	1.63	4.00	5.30	1	0	1	0	1	3	1	1	4	3	3	0	4	2	2	1	1	1	3	-1	1	1	-0.01	0.10	0.65
2226421	2024-12-05 04:15:00	25	3	1.84	3.80	3.65	1.90	3.85	3.80	8	4	9	9	3	7	17	7	16	6	16	7	23	1	3	2	3	1	2	1	1	1	0.06	0.05	0.15
2226420	2024-09-14 22:00:00	25	1	2.38	3.55	2.66	2.38	3.60	2.84	0	0	0	0	1	2	0	1	2	2	1	0	2	3	2	1	1	2	3	0	1	1	0.00	0.05	0.18
2226423	2024-09-14 22:00:00	25	3	1.18	6.80	12.00	1.17	7.50	16.00	3	3	1	2	5	3	5	8	4	5	2	6	10	2	1	3	2	3	1	-1	1	1	-0.01	0.70	4.00
2226422	2024-09-14 22:00:00	25	0	1.21	6.40	9.60	1.20	6.90	13.00	3	2	5	2	3	4	5	5	9	5	5	1	10	2	2	1	1	1	3	-1	1	1	-0.01	0.50	3.40
2226424	2024-12-05 03:30:00	25	3	2.20	3.30	3.10	2.23	3.40	3.25	4	2	7	6	3	5	10	5	12	7	12	5	17	2	3	1	2	1	3	1	1	1	0.03	0.10	0.15
2226426	2024-09-14 19:30:00	25	0	4.10	4.00	1.70	4.15	4.05	1.69	4	2	4	5	3	2	9	5	6	2	6	5	11	1	3	2	3	1	2	1	1	-1	0.05	0.05	-0.01
2226429	2024-09-15 21:00:00	25	0	2.84	3.65	2.21	3.05	3.70	2.21	2	1	1	3	3	0	5	4	1	0	1	4	5	1	2	3	3	2	1	1	1	0	0.21	0.05	0.00
2226428	2024-09-15 23:30:00	25	0	3.00	3.65	2.12	3.35	3.80	2.06	2	3	7	6	4	5	8	7	12	10	11	6	18	2	3	1	2	1	3	1	1	-1	0.35	0.15	-0.06
2226431	2024-12-04 03:30:00	25	0	2.86	3.35	2.49	2.98	3.30	2.42	8	5	2	10	4	2	18	9	4	1	10	15	19	1	2	3	3	2	1	1	-1	-1	0.12	-0.05	-0.07
2226369	2024-12-02 00:00:00	25	3	2.07	3.65	3.10	2.08	3.65	3.40	6	2	6	11	3	7	17	5	13	2	14	6	19	1	3	2	3	1	2	1	0	1	0.01	0.00	0.30
2226368	2025-01-27 03:00:00	25	0	2.23	3.35	2.99	2.36	3.45	2.98	5	5	10	9	5	8	14	10	18	11	15	7	25	2	3	1	2	1	3	1	1	-1	0.13	0.10	-0.01
2226371	2025-01-25 23:00:00	25	3	1.10	9.90	15.00	1.11	10.00	20.00	1	2	2	3	2	2	4	4	4	3	3	3	7	1	1	1	1	1	1	1	1	1	0.01	0.10	5.00
2226370	2024-08-24 22:00:00	25	0	2.21	3.55	2.91	2.13	3.65	3.25	2	0	4	2	3	6	4	3	10	9	10	3	13	2	3	1	2	1	3	-1	1	1	-0.08	0.10	0.34
2226373	2025-01-26 01:30:00	25	3	2.11	3.90	2.85	2.13	4.10	2.97	5	4	5	5	5	7	10	9	12	6	7	4	16	2	3	1	2	1	3	1	1	1	0.02	0.20	0.12
2226372	2024-12-01 21:30:00	25	3	1.54	3.95	5.60	1.57	4.15	5.80	3	2	3	3	3	4	6	5	7	4	5	3	10	2	3	1	2	1	3	1	1	1	0.03	0.20	0.20
2226375	2024-08-25 23:30:00	25	3	1.21	6.30	10.00	1.24	6.80	10.00	5	4	3	5	6	3	10	10	6	8	8	12	18	1	1	3	2	2	1	1	1	0	0.03	0.50	0.00
2226374	2024-11-30 23:00:00	25	3	1.72	3.70	4.35	1.77	3.70	4.65	0	5	3	2	3	3	2	8	6	6	0	2	8	3	1	2	1	3	2	1	0	1	0.05	0.00	0.30
2226377	2024-12-01 21:30:00	25	1	1.70	4.20	3.90	1.70	4.20	3.90	0	1	0	0	0	0	0	1	0	1	0	1	1	2	1	2	1	3	1	0	0	0	0.00	0.00	0.00
2226376	2025-01-26 22:00:00	25	0	1.43	4.75	5.90	1.48	5.00	5.80	2	1	2	2	4	3	4	5	5	2	1	1	6	3	1	1	1	2	2	1	1	-1	0.05	0.25	-0.10
2226379	2024-12-01 01:30:00	25	0	6.80	4.40	1.42	7.00	4.55	1.46	9	7	7	10	10	6	19	17	13	6	8	12	25	1	2	3	3	2	1	1	1	1	0.20	0.15	0.04
2226378	2024-08-24 22:00:00	25	3	1.07	10.00	23.00	1.09	11.00	23.00	1	0	2	1	1	4	2	1	6	5	6	1	7	2	3	1	2	1	3	1	1	0	0.02	1.00	0.00
2226381	2024-08-24 22:00:00	25	3	1.43	4.75	5.80	1.39	4.90	7.80	5	2	4	2	6	9	7	8	13	8	7	2	15	3	2	1	1	2	3	-1	1	1	-0.04	0.15	2.00
2226380	2024-08-24 22:00:00	25	0	2.44	3.35	2.70	2.47	3.40	2.86	0	1	6	1	3	3	1	4	9	8	5	0	9	3	2	1	1	2	3	1	1	1	0.03	0.05	0.16
2226383	2025-01-25 23:00:00	25	0	7.20	5.20	1.34	6.60	5.30	1.41	8	4	3	7	5	6	15	9	9	0	6	6	15	1	2	2	3	1	1	-1	1	1	-0.60	0.10	0.07
2226382	2024-08-25 21:00:00	25	0	4.05	3.95	1.72	4.40	4.00	1.75	3	3	1	2	2	3	5	5	4	1	1	2	6	1	1	3	2	2	1	1	1	1	0.35	0.05	0.03
2226385	2024-08-24 22:00:00	25	3	1.80	3.65	4.00	1.84	3.65	4.30	0	1	2	1	1	3	1	2	5	4	3	0	5	3	2	1	1	2	3	1	0	1	0.04	0.00	0.30
2226384	2025-01-25 23:00:00	25	0	6.20	4.30	1.46	7.00	4.60	1.45	5	6	6	6	8	6	11	14	12	7	4	6	18	3	1	2	1	3	2	1	1	-1	0.80	0.30	-0.01
2226387	2024-08-31 22:00:00	25	3	1.79	3.75	3.90	1.79	3.85	4.30	3	2	2	2	2	6	5	4	8	4	5	1	9	2	3	1	2	1	3	0	1	1	0.00	0.10	0.40
2226386	2024-08-31 19:30:00	25	1	1.37	4.80	6.80	1.37	5.10	8.10	8	6	7	6	9	12	14	15	19	6	5	1	20	3	2	1	1	2	3	0	1	1	0.00	0.30	1.30
2226389	2024-09-01 20:30:00	25	1	1.59	4.20	4.70	1.58	4.35	5.30	5	3	4	3	5	7	8	8	11	4	4	1	12	2	2	1	1	1	3	-1	1	1	-0.01	0.15	0.60
2226388	2024-11-30 23:00:00	25	0	2.55	3.55	2.47	2.75	3.65	2.42	13	3	5	10	5	7	23	8	12	0	15	11	23	1	3	2	3	1	2	1	1	-1	0.20	0.10	-0.05
2226392	2024-08-31 22:00:00	25	0	2.66	3.35	2.47	2.89	3.50	2.40	1	0	2	4	2	0	5	2	2	0	3	3	5	1	2	2	3	1	1	1	1	-1	0.23	0.15	-0.07
2226395	2024-08-31 22:00:00	25	1	2.88	3.45	2.26	3.00	3.50	2.31	4	0	0	2	1	2	6	1	2	0	5	4	6	1	3	2	3	1	2	1	1	1	0.12	0.05	0.05
2226398	2024-08-31 22:00:00	25	0	3.95	3.85	1.76	4.35	3.95	1.77	5	3	5	6	4	5	11	7	10	0	4	1	11	1	3	2	3	1	2	1	1	1	0.40	0.10	0.01
2226465	2024-10-01 03:00:00	25	3	1.65	4.00	4.45	1.57	4.60	5.10	12	6	9	5	10	17	17	16	26	14	15	5	31	2	3	1	2	1	3	-1	1	1	-0.08	0.60	0.65
2226466	2024-12-10 04:00:00	25	3	1.98	3.60	3.40	1.91	3.70	3.90	10	5	6	7	6	12	17	11	18	7	13	6	24	2	3	1	2	1	3	-1	1	1	-0.07	0.10	0.50
2226469	2024-09-28 22:00:00	25	3	1.20	6.70	10.00	1.18	6.90	16.00	4	3	2	3	3	4	7	6	6	4	5	5	11	1	2	2	3	1	1	-1	1	1	-0.02	0.20	6.00
2226468	2024-09-28 22:00:00	25	1	2.21	3.50	2.92	2.21	3.55	3.15	2	4	4	2	4	7	4	8	11	9	5	2	13	3	2	1	1	2	3	0	1	1	0.00	0.05	0.23
2226471	2024-09-28 22:00:00	25	3	1.68	4.05	4.20	1.71	4.10	4.55	2	2	3	2	3	5	4	5	8	5	4	1	9	3	2	1	1	2	3	1	1	1	0.03	0.05	0.35
2226470	2024-09-28 22:00:00	25	3	2.60	3.40	2.49	2.77	3.40	2.53	4	1	0	4	1	1	8	2	1	0	6	7	8	1	2	3	3	2	1	1	0	1	0.17	0.00	0.04
2226473	2024-09-29 21:00:00	25	1	3.45	3.55	1.97	4.10	3.75	1.86	4	0	12	11	3	3	15	3	15	2	14	2	17	1	3	1	2	1	2	1	1	-1	0.65	0.20	-0.11
2226472	2024-09-29 23:30:00	25	0	2.35	3.75	2.57	2.29	3.65	2.95	3	3	2	0	2	9	3	5	11	8	6	0	11	3	2	1	1	2	3	-1	-1	1	-0.06	-0.10	0.38
2226475	2024-12-17 04:00:00	25	1	1.72	4.00	4.05	1.72	4.20	4.35	4	7	7	4	10	7	8	17	14	10	1	4	18	3	1	2	1	3	2	0	1	1	0.00	0.20	0.30
2226474	2024-09-28 19:30:00	25	1	4.70	4.15	1.60	5.20	4.30	1.60	1	1	1	4	2	0	5	3	1	1	3	5	6	1	2	3	3	2	1	1	1	0	0.50	0.15	0.00
2226477	2024-12-14 23:00:00	25	1	1.19	5.90	14.00	1.24	6.10	13.00	2	3	2	6	2	1	8	5	3	1	4	6	9	1	2	3	3	2	1	1	1	-1	0.05	0.20	-1.00
2226476	2024-09-28 22:00:00	25	0	2.35	3.30	2.85	2.35	3.35	3.05	0	0	1	0	1	3	0	1	4	4	3	0	4	3	2	1	1	2	3	0	1	1	0.00	0.05	0.20
2226479	2024-12-16 03:00:00	25	3	1.32	5.90	8.20	1.40	5.40	6.70	6	6	12	12	4	9	18	10	21	6	14	3	24	2	3	1	2	1	3	1	-1	-1	0.08	-0.50	-1.50
2226478	2024-12-15 22:00:00	25	0	1.92	3.70	3.45	1.85	3.75	4.10	4	0	4	0	1	7	4	1	11	7	10	0	11	2	3	1	2	1	3	-1	1	1	-0.07	0.05	0.65
2226481	2024-12-14 23:00:00	25	1	1.30	5.30	8.30	1.32	5.70	8.90	3	1	6	4	3	9	7	4	15	11	14	3	18	2	3	1	2	1	3	1	1	1	0.02	0.40	0.60
2226480	2024-09-29 00:30:00	25	0	8.20	5.40	1.30	8.80	5.50	1.33	6	3	3	8	3	5	14	6	8	0	8	6	14	1	3	2	3	1	2	1	1	1	0.60	0.10	0.03
2226483	2024-12-16 00:30:00	25	0	1.61	4.30	4.35	1.62	4.45	4.80	5	10	11	8	9	11	13	19	22	14	8	5	27	3	2	1	1	2	3	1	1	1	0.01	0.15	0.45
2226482	2024-10-06 21:00:00	25	1	2.23	3.70	2.78	2.23	3.80	2.97	1	1	1	0	3	3	1	4	4	4	1	1	5	3	1	1	1	2	2	0	1	1	0.00	0.10	0.19
2226485	2024-12-14 23:00:00	25	3	1.29	5.50	8.40	1.31	5.80	9.00	4	4	14	6	4	11	10	8	25	15	17	0	25	2	3	1	2	1	3	1	1	1	0.02	0.30	0.60
2226484	2024-10-05 22:00:00	25	3	2.08	3.55	3.15	2.09	3.60	3.40	2	0	1	2	1	2	4	1	3	1	4	2	5	1	3	2	3	1	2	1	1	1	0.01	0.05	0.25
2226487	2024-12-15 01:30:00	25	3	2.58	3.30	2.57	2.69	3.30	2.66	6	3	9	8	3	9	14	6	18	6	14	2	20	2	3	1	2	1	3	1	0	1	0.11	0.00	0.09
2226486	2024-10-06 23:30:00	25	3	2.68	3.95	2.21	2.85	4.05	2.21	2	1	1	3	3	0	5	4	1	0	1	4	5	1	2	3	3	2	1	1	1	0	0.17	0.10	0.00
2226489	2024-10-06 21:00:00	25	1	1.46	4.45	5.90	1.51	4.50	6.00	3	4	5	5	2	4	8	6	9	3	5	2	11	2	3	1	2	1	3	1	1	1	0.05	0.05	0.10
2226488	2024-10-05 22:00:00	25	3	1.13	8.50	13.00	1.15	8.90	15.00	0	3	1	3	2	1	3	5	2	2	0	3	5	2	1	3	2	3	1	1	1	1	0.02	0.40	2.00
2226490	2024-12-16 03:00:00	25	0	3.95	4.30	1.68	4.35	4.45	1.68	2	0	3	4	2	1	6	2	4	0	4	2	6	1	3	2	3	1	2	1	1	0	0.40	0.15	0.00
2226493	2024-10-05 19:30:00	25	0	6.60	4.40	1.42	5.80	4.40	1.47	2	2	1	2	1	1	4	3	2	1	2	3	5	1	2	3	3	2	1	-1	0	1	-0.80	0.00	0.05
2226495	2024-12-14 23:00:00	25	0	1.99	3.60	3.30	2.04	3.70	3.45	0	2	3	4	2	2	4	4	5	3	3	2	7	2	2	1	1	1	3	1	1	1	0.05	0.10	0.15
2226494	2024-10-06 00:30:00	25	1	2.79	3.60	2.26	3.10	3.65	2.20	1	0	2	2	1	1	3	1	3	1	3	1	4	1	3	1	2	1	2	1	1	-1	0.31	0.05	-0.06
2023742	2023-08-26 22:00:00	25	1	1.20	6.40	12.00	1.22	6.50	13.00	1	2	1	2	1	2	3	3	3	2	2	2	5	1	1	1	1	1	1	1	1	1	0.02	0.10	1.00
2226433	2024-09-22 21:00:00	25	1	1.79	3.70	4.00	1.78	3.70	4.55	2	4	2	2	6	4	4	10	6	9	3	7	13	3	1	2	1	3	2	-1	0	1	-0.01	0.00	0.55
2023743	2023-12-17 22:00:00	25	0	3.00	3.50	2.16	3.25	3.55	2.17	3	2	0	2	2	2	5	4	2	0	1	3	5	1	2	3	3	2	1	1	1	1	0.25	0.05	0.01
2226432	2024-12-04 04:15:00	25	3	2.76	3.45	2.51	2.82	3.45	2.47	17	5	4	15	4	4	32	9	8	3	26	27	35	1	2	3	3	2	1	1	0	-1	0.06	0.00	-0.04
2023740	2023-08-26 19:30:00	25	0	3.35	3.85	1.92	3.35	3.95	1.89	2	1	1	1	2	1	3	3	2	0	0	1	3	1	1	3	2	2	1	0	1	-1	0.00	0.10	-0.03
2226435	2024-12-05 03:30:00	25	3	1.36	4.75	7.60	1.34	5.50	8.20	16	10	20	12	16	25	28	26	45	26	28	9	54	2	3	1	2	1	3	-1	1	1	-0.02	0.75	0.60
2023741	2023-08-19 22:00:00	25	0	3.60	3.75	1.87	3.60	3.75	1.87	1	1	0	0	0	1	1	1	1	0	0	0	1	1	1	1	1	1	1	0	0	0	0.00	0.00	0.00
2226434	2024-09-21 22:00:00	25	3	1.57	4.15	4.90	1.56	4.50	5.40	4	3	5	2	5	8	6	8	13	7	5	0	13	3	2	1	1	2	3	-1	1	1	-0.01	0.35	0.50
2023738	2023-08-20 23:30:00	25	3	3.20	3.50	2.08	3.70	3.55	2.00	6	2	12	12	4	5	18	6	17	1	13	2	19	1	3	2	3	1	2	1	1	-1	0.50	0.05	-0.08
2226437	2024-09-21 22:00:00	25	3	2.64	3.50	2.42	2.82	3.55	2.42	1	1	0	1	2	0	2	3	0	1	0	3	3	2	1	3	2	3	1	1	1	0	0.18	0.05	0.00
2023739	2023-12-24 21:00:00	25	3	3.50	3.60	1.94	3.75	3.65	1.97	7	2	6	7	3	8	14	5	14	2	11	2	16	1	3	1	2	1	2	1	1	1	0.25	0.05	0.03
2226436	2024-09-22 00:30:00	25	1	2.62	3.55	2.40	2.85	3.70	2.33	3	0	3	7	1	2	10	1	5	0	9	5	10	1	3	2	3	1	2	1	1	-1	0.23	0.15	-0.07
2023736	2023-12-28 04:15:00	25	0	4.95	4.05	1.58	5.60	4.15	1.59	21	17	30	29	22	20	50	39	50	16	27	16	66	1	3	1	2	1	2	1	1	1	0.65	0.10	0.01
2226439	2024-09-21 22:00:00	25	1	2.51	3.35	2.60	2.51	3.40	2.79	1	0	1	0	1	3	1	1	4	3	3	0	4	2	2	1	1	1	3	0	1	1	0.00	0.05	0.19
2023737	2023-12-27 04:00:00	25	3	2.53	3.65	2.64	2.47	3.75	2.65	12	5	24	14	8	20	26	13	44	19	32	1	45	2	3	1	2	1	3	-1	1	1	-0.06	0.10	0.01
2226438	2024-12-05 03:30:00	25	0	7.70	5.50	1.32	9.30	5.70	1.31	12	4	6	13	6	4	25	10	10	0	15	15	25	1	2	2	3	1	1	1	1	-1	1.60	0.20	-0.01
2023734	2023-12-27 01:30:00	25	0	6.80	4.70	1.39	7.80	4.95	1.40	7	6	4	7	6	6	14	12	10	3	5	7	17	1	2	3	3	2	1	1	1	1	1.00	0.25	0.01
2226441	2024-09-21 22:00:00	25	3	1.28	5.80	7.80	1.31	6.40	7.90	6	4	11	7	3	10	13	7	21	8	14	0	21	2	3	1	2	1	3	1	1	1	0.03	0.60	0.10
2023735	2023-12-28 03:30:00	25	3	1.71	3.75	4.35	1.68	3.90	5.10	4	6	7	3	8	9	7	14	16	16	9	7	23	3	2	1	1	2	3	-1	1	1	-0.03	0.15	0.75
2023732	2023-08-20 03:00:00	25	3	1.68	4.15	4.70	1.76	4.00	4.30	1	3	3	3	1	3	4	4	6	3	3	1	7	2	2	1	1	1	3	1	-1	-1	0.08	-0.15	-0.40
2226443	2024-12-07 23:00:00	25	3	1.36	4.95	7.00	1.34	5.40	8.40	11	6	9	7	8	16	18	14	25	8	12	1	26	2	3	1	2	1	3	-1	1	1	-0.02	0.45	1.40
2023733	2023-12-29 03:30:00	25	3	2.66	3.55	2.36	2.51	3.85	2.55	36	5	40	50	6	32	86	11	72	3	78	17	89	1	3	2	3	1	2	-1	1	1	-0.15	0.30	0.19
2023730	2023-12-28 03:30:00	25	0	2.02	3.45	3.40	2.09	3.50	3.50	11	6	18	23	6	11	34	12	29	10	32	15	44	1	3	2	3	1	2	1	1	1	0.07	0.05	0.10
2226444	2024-09-22 23:30:00	25	1	1.78	3.50	4.35	1.78	3.60	4.75	0	3	3	1	3	4	1	6	7	7	2	1	8	3	2	1	1	2	3	0	1	1	0.00	0.10	0.40
2023728	2023-08-19 22:00:00	25	3	1.22	5.80	12.00	1.22	7.00	11.00	2	1	1	1	2	1	3	3	2	1	1	2	4	1	1	3	2	2	1	0	1	-1	0.00	1.20	-1.00
2023729	2023-12-29 04:15:00	25	0	1.33	4.95	8.00	1.34	5.20	9.00	15	8	25	15	12	24	30	20	49	25	35	6	55	2	3	1	2	1	3	1	1	1	0.01	0.25	1.00
2023727	2023-12-26 23:00:00	25	3	2.23	3.50	2.88	2.23	3.60	3.10	0	1	1	0	1	4	0	2	5	5	3	0	5	3	2	1	1	2	3	0	1	1	0.00	0.10	0.22
2226448	2024-12-07 23:00:00	25	3	2.67	3.60	2.33	2.85	3.70	2.33	2	1	0	3	2	0	5	3	0	0	2	5	5	1	2	3	3	2	1	1	1	0	0.18	0.10	0.00
2023724	2023-08-20 21:00:00	25	3	1.69	3.80	4.45	1.72	3.90	4.70	0	1	2	1	2	1	1	3	3	2	0	0	3	3	1	1	1	2	2	1	1	1	0.03	0.10	0.25
2023725	2023-08-22 03:00:00	25	0	4.75	3.85	1.64	5.20	4.10	1.63	5	3	8	9	8	6	14	11	14	1	4	1	15	1	3	1	2	1	2	1	1	-1	0.45	0.25	-0.01
2226450	2024-12-07 23:00:00	25	1	4.95	4.20	1.56	5.40	4.25	1.59	3	3	0	1	2	3	4	5	3	1	0	2	5	2	1	3	2	3	1	1	1	1	0.45	0.05	0.03
2023722	2023-08-15 03:00:00	25	3	1.25	5.50	9.80	1.29	5.80	9.70	4	4	11	6	4	9	10	8	20	10	12	0	20	2	3	1	2	1	3	1	1	-1	0.04	0.30	-0.10
2023723	2023-08-13 00:30:00	25	3	1.75	3.80	4.10	1.78	3.85	4.35	0	2	2	1	1	2	1	3	4	3	1	0	4	3	2	1	1	2	3	1	1	1	0.03	0.05	0.25
2226452	2024-09-21 22:00:00	25	3	1.55	4.45	4.75	1.55	4.60	5.30	0	0	0	0	1	2	0	1	2	2	1	0	2	3	2	1	1	2	3	0	1	1	0.00	0.15	0.55
2023720	2023-08-13 23:30:00	25	1	2.82	3.75	2.33	2.88	3.70	2.31	5	2	4	8	2	3	13	4	7	0	9	6	13	1	3	2	3	1	2	1	-1	-1	0.06	-0.05	-0.02
2226455	2024-12-08 22:00:00	25	1	5.30	4.10	1.55	5.50	4.25	1.58	3	2	3	3	4	3	6	6	6	3	3	3	9	1	1	1	1	1	1	1	1	1	0.20	0.15	0.03
2226457	2024-09-21 19:30:00	25	0	3.15	3.75	2.02	3.30	3.95	2.02	6	3	10	9	4	7	15	7	17	5	13	3	20	2	3	1	2	1	3	1	1	0	0.15	0.20	0.00
2226459	2024-12-08 22:00:00	25	0	3.25	3.70	1.99	3.45	3.70	2.04	6	2	7	7	1	9	13	3	16	7	17	4	20	2	3	1	2	1	3	1	0	1	0.20	0.00	0.05
2023717	2023-08-12 22:00:00	25	3	1.26	5.50	9.70	1.32	5.50	9.40	1	2	3	2	1	1	3	3	4	1	1	0	4	2	2	1	1	1	3	1	0	-1	0.06	0.00	-0.30
2226461	2024-12-08 01:30:00	25	0	1.68	3.85	4.40	1.82	3.65	4.45	6	7	14	9	3	11	15	10	25	10	15	0	25	2	3	1	2	1	3	1	-1	1	0.14	-0.20	0.05
2226460	2024-12-08 22:00:00	25	1	4.10	3.80	1.74	4.75	4.10	1.68	2	2	2	5	3	1	7	5	3	3	5	7	10	1	2	3	3	2	1	1	1	-1	0.65	0.30	-0.06
2023712	2023-08-12 03:00:00	25	0	8.00	5.00	1.32	8.70	5.10	1.34	17	10	12	21	9	14	38	19	26	3	22	15	41	1	3	2	3	1	2	1	1	1	0.70	0.10	0.02
2226463	2024-12-09 00:30:00	25	0	2.88	3.95	2.09	2.86	3.95	2.23	6	3	7	7	2	9	13	5	16	5	13	2	18	2	3	1	2	1	3	-1	0	1	-0.02	0.00	0.14
2023713	2023-08-12 19:30:00	25	3	1.14	7.20	16.00	1.13	7.50	18.00	2	0	0	0	3	2	2	3	2	1	0	1	3	2	1	2	1	3	1	-1	1	1	-0.01	0.30	2.00
2226462	2024-09-21 22:00:00	25	1	2.25	3.45	2.88	2.28	3.50	3.05	0	2	4	2	2	6	2	4	10	9	7	1	11	3	2	1	1	2	3	1	1	1	0.03	0.05	0.17
2226529	2024-12-26 23:00:00	25	1	1.99	3.60	3.30	1.93	3.75	3.75	3	0	4	3	2	5	6	2	9	3	7	0	9	2	3	1	2	1	3	-1	1	1	-0.06	0.15	0.45
2023775	2024-05-19 23:00:00	25	0	2.69	3.65	2.31	2.81	3.85	2.30	6	1	5	4	4	4	10	5	9	3	8	4	13	1	3	2	3	1	2	1	1	-1	0.12	0.20	-0.01
2023772	2023-12-11 00:30:00	25	3	2.17	3.75	2.84	2.17	3.75	3.10	1	1	3	1	1	4	2	2	7	5	5	0	7	2	2	1	1	1	3	0	0	1	0.00	0.00	0.26
2023773	2023-09-02 22:00:00	25	0	1.35	4.90	7.50	1.37	5.00	8.40	1	0	0	1	3	3	2	3	3	2	1	1	4	3	1	1	1	2	2	1	1	1	0.02	0.10	0.90
2226530	2024-10-19 22:00:00	25	0	2.02	3.60	3.25	2.00	3.65	3.30	3	0	0	0	1	2	3	1	2	0	2	1	3	1	3	2	3	1	2	-1	1	1	-0.02	0.05	0.05
2226533	2024-10-22 03:00:00	25	3	2.51	3.15	2.99	2.51	3.15	2.99	1	1	3	1	2	6	2	3	9	7	6	0	9	3	2	1	1	2	3	0	0	0	0.00	0.00	0.00
2023771	2024-05-19 23:00:00	25	0	2.66	3.85	2.25	2.80	4.00	2.25	6	1	0	4	4	0	10	5	0	1	6	11	11	1	2	3	3	2	1	1	1	0	0.14	0.15	0.00
2023768	2023-12-09 23:00:00	25	0	1.55	4.35	5.00	1.54	4.45	5.70	1	1	1	1	1	3	2	2	4	2	2	0	4	2	2	1	1	1	3	-1	1	1	-0.01	0.10	0.70
2023769	2023-09-03 00:30:00	25	3	2.57	3.65	2.40	2.44	3.85	2.63	11	1	11	12	3	11	23	4	22	2	21	3	25	1	3	2	3	1	2	-1	1	1	-0.13	0.20	0.23
2226534	2024-12-28 03:30:00	25	1	1.60	4.20	4.60	1.67	4.35	4.50	9	12	19	13	11	16	22	23	35	15	14	2	37	3	2	1	1	2	3	1	1	-1	0.07	0.15	-0.10
2023766	2023-09-03 23:30:00	25	3	1.79	3.90	3.75	1.77	4.05	4.20	1	2	2	3	2	2	4	4	4	1	1	1	5	1	1	1	1	1	1	-1	1	1	-0.02	0.15	0.45
2226537	2024-10-19 22:00:00	25	0	2.36	3.40	2.77	2.36	3.35	2.78	0	2	2	0	0	3	0	2	5	5	3	0	5	3	2	1	1	2	3	0	-1	1	0.00	-0.05	0.01
2226536	2024-12-28 04:15:00	25	3	1.13	9.00	19.00	1.13	9.10	19.00	6	14	8	7	14	7	13	28	15	17	2	15	30	3	1	2	1	3	2	0	1	0	0.00	0.10	0.00
2023764	2023-12-10 22:00:00	25	3	2.77	3.55	2.28	2.98	3.65	2.26	0	1	1	3	1	0	3	2	1	0	1	2	3	1	2	3	3	2	1	1	1	-1	0.21	0.10	-0.02
2226539	2024-10-19 19:30:00	25	3	1.48	4.60	5.40	1.47	4.65	5.40	6	3	7	6	4	7	12	7	14	2	7	0	14	2	3	1	2	1	3	-1	1	0	-0.01	0.05	0.00
2023765	2023-12-10 22:00:00	25	3	2.26	3.40	2.90	2.26	3.50	3.10	0	2	0	0	2	2	0	4	2	4	0	2	4	3	1	2	1	3	2	0	1	1	0.00	0.10	0.20
2226538	2024-12-26 23:00:00	25	0	1.45	4.55	5.90	1.47	4.75	6.10	5	1	6	5	2	7	10	3	13	4	11	1	14	2	3	1	2	1	3	1	1	1	0.02	0.20	0.20
2023762	2023-08-27 21:00:00	25	0	14.00	6.80	1.17	14.00	7.40	1.19	2	1	1	1	2	2	3	3	3	2	2	2	5	1	1	1	1	1	1	0	1	1	0.00	0.60	0.02
2226541	2024-10-20 21:00:00	25	0	7.90	5.40	1.30	9.10	5.70	1.30	4	2	4	8	4	3	12	6	7	0	6	5	12	1	3	2	3	1	2	1	1	0	1.20	0.30	0.00
2023763	2023-12-09 20:30:00	25	0	6.20	4.35	1.47	6.50	4.55	1.48	3	5	0	5	5	1	8	10	1	6	4	13	14	2	1	3	2	3	1	1	1	1	0.30	0.20	0.01
2226540	2024-12-27 04:00:00	25	3	1.06	12.00	21.00	1.07	14.00	23.00	2	1	12	2	3	15	4	4	27	25	25	2	29	2	2	1	1	1	3	1	1	1	0.01	2.00	2.00
2023760	2023-08-27 23:30:00	25	0	2.23	3.90	2.90	2.28	3.95	2.80	0	0	3	2	2	1	2	2	4	2	2	0	4	2	2	1	1	1	3	1	1	-1	0.05	0.05	-0.10
2226543	2024-12-26 20:30:00	25	1	1.32	4.95	8.10	1.34	5.40	8.60	5	6	8	6	7	9	11	13	17	6	4	0	17	3	2	1	1	2	3	1	1	1	0.02	0.45	0.50
2023758	2023-12-10 01:30:00	25	3	3.15	3.55	2.09	3.25	3.70	2.11	7	2	6	5	4	10	12	6	16	6	12	2	18	2	3	1	2	1	3	1	1	1	0.10	0.15	0.02
2023759	2023-08-26 22:00:00	25	3	1.31	5.60	9.30	1.31	5.60	9.30	0	0	0	0	1	1	0	1	1	1	0	0	1	3	1	1	1	2	2	0	0	0	0.00	0.00	0.00
2023756	2024-05-19 23:00:00	25	3	1.16	7.20	13.00	1.15	8.20	18.00	7	9	8	7	13	9	14	22	17	14	6	11	28	3	1	2	1	3	2	-1	1	1	-0.01	1.00	5.00
2226547	2024-10-28 00:30:00	25	1	2.44	3.25	2.77	2.47	3.45	2.81	2	1	2	1	1	5	3	2	7	4	5	0	7	2	3	1	2	1	3	1	1	1	0.03	0.20	0.04
2023757	2023-08-26 22:00:00	25	0	2.29	3.40	3.15	2.29	3.40	3.15	0	0	0	0	1	1	0	1	1	1	0	0	1	3	1	1	1	2	2	0	0	0	0.00	0.00	0.00
2226546	2024-12-26 23:00:00	25	3	1.98	3.80	3.20	1.98	3.80	3.55	5	3	3	4	4	3	9	7	6	4	6	7	13	1	2	3	3	2	1	0	0	1	0.00	0.00	0.35
2023755	2023-08-26 03:00:00	25	3	1.23	6.30	13.00	1.22	6.40	13.00	8	6	5	7	8	6	15	14	11	5	6	9	20	1	2	3	3	2	1	-1	1	0	-0.01	0.10	0.00
2226548	2024-12-26 23:00:00	25	3	2.28	3.70	2.68	2.28	3.75	2.91	0	1	2	0	1	3	0	2	5	7	5	2	7	3	2	1	1	2	3	0	1	1	0.00	0.05	0.23
2023752	2023-12-16 04:00:00	25	0	4.15	4.05	1.69	4.75	4.05	1.69	8	6	3	9	7	4	17	13	7	5	9	15	22	1	2	3	3	2	1	1	0	0	0.60	0.00	0.00
2226551	2024-12-26 23:00:00	25	0	2.85	3.50	2.25	3.15	3.55	2.21	2	0	1	2	1	1	4	1	2	0	3	2	4	1	3	2	3	1	2	1	1	-1	0.30	0.05	-0.04
2023753	2023-12-17 22:00:00	25	3	2.12	3.45	3.15	2.11	3.45	3.45	1	2	0	0	1	3	1	3	3	3	1	1	4	3	1	1	1	2	2	-1	0	1	-0.01	0.00	0.30
2226550	2024-10-26 22:00:00	25	1	1.84	3.85	3.65	1.87	3.80	3.95	8	3	7	4	4	10	12	7	17	10	15	5	22	2	3	1	2	1	3	1	-1	1	0.03	-0.05	0.30
2023750	2023-12-16 23:00:00	25	1	1.17	6.80	13.00	1.18	6.70	17.00	4	8	5	4	10	6	8	18	11	13	3	10	21	3	1	2	1	3	2	1	-1	1	0.01	-0.10	4.00
2226553	2024-12-27 01:30:00	25	3	3.40	3.65	1.96	3.90	3.65	1.92	6	4	6	10	5	5	16	9	11	6	13	11	22	1	3	2	3	1	2	1	0	-1	0.50	0.00	-0.04
2023751	2023-12-16 23:00:00	25	3	1.84	3.75	3.70	1.91	3.70	3.90	7	4	11	11	3	10	18	7	21	5	16	2	23	2	3	1	2	1	3	1	-1	1	0.07	-0.05	0.20
2023748	2023-12-18 00:30:00	25	1	1.31	5.60	7.30	1.34	5.60	8.00	11	10	21	15	9	16	26	19	37	13	20	2	39	2	3	1	2	1	3	1	0	1	0.03	0.00	0.70
2226555	2024-10-26 22:00:00	25	3	1.65	4.20	4.85	1.65	4.25	4.80	0	0	1	0	2	1	0	2	2	2	0	0	2	3	1	1	1	2	2	0	1	-1	0.00	0.05	-0.05
2023749	2023-12-16 23:00:00	25	3	1.23	6.00	9.80	1.25	6.00	12.00	4	4	5	5	4	6	9	8	11	6	7	4	15	2	3	1	2	1	3	1	0	1	0.02	0.00	2.20
2226554	2024-10-26 22:00:00	25	1	1.66	3.95	4.45	1.66	4.15	4.85	0	1	2	1	2	1	1	3	3	2	0	0	3	3	1	1	1	2	2	0	1	1	0.00	0.20	0.40
2226557	2024-12-31 03:45:00	25	1	1.97	3.70	3.30	2.14	3.70	3.20	12	6	14	14	4	13	26	10	27	8	24	7	34	2	3	1	2	1	3	1	0	-1	0.17	0.00	-0.10
2023747	2023-08-27 00:30:00	25	0	1.53	4.65	5.50	1.46	4.85	6.30	2	1	1	2	4	4	4	5	5	1	0	0	5	3	1	1	1	2	2	-1	1	1	-0.07	0.20	0.80
2023745	2023-12-17 22:00:00	25	3	1.47	4.45	5.80	1.45	4.60	7.00	3	2	5	5	3	4	8	5	9	2	5	1	10	2	3	1	2	1	3	-1	1	1	-0.02	0.15	1.20
2023806	2023-12-02 23:00:00	25	3	1.27	5.70	8.90	1.26	5.80	12.00	6	4	9	7	4	4	13	8	13	3	8	3	16	1	3	1	2	1	2	-1	1	1	-0.01	0.10	3.10
2023807	2024-05-11 22:00:00	25	0	1.97	3.90	3.15	1.99	4.00	3.40	2	2	3	4	3	3	6	5	6	2	3	2	8	1	3	1	2	1	2	1	1	1	0.02	0.10	0.25
2023804	2023-09-16 22:00:00	25	0	2.17	4.00	2.71	2.17	4.00	2.94	0	0	2	0	1	2	0	1	4	4	3	0	4	3	2	1	1	2	3	0	0	1	0.00	0.00	0.23
2226498	2024-12-21 20:30:00	25	3	3.00	3.65	2.11	3.15	3.80	2.12	7	2	6	4	4	4	11	6	10	3	8	4	14	1	3	2	3	1	2	1	1	1	0.15	0.15	0.01
2023803	2024-05-14 03:00:00	25	1	3.95	4.20	1.70	3.75	4.55	1.77	5	5	1	3	4	4	8	9	5	3	2	6	11	2	1	3	2	3	1	-1	1	1	-0.20	0.35	0.07
2023800	2023-09-17 23:30:00	25	0	5.80	4.35	1.49	6.20	4.45	1.51	2	2	0	3	2	2	5	4	2	2	3	5	7	1	2	3	3	2	1	1	1	1	0.40	0.10	0.02
2226503	2024-12-22 01:30:00	25	0	5.30	4.00	1.56	6.90	4.15	1.51	4	7	8	10	8	5	14	15	13	5	4	6	19	2	1	3	2	3	1	1	1	-1	1.60	0.15	-0.05
2226502	2024-10-05 22:00:00	25	3	3.05	3.60	2.11	3.20	3.70	2.14	5	1	5	7	2	4	12	3	9	0	9	3	12	1	3	2	3	1	2	1	1	1	0.15	0.10	0.03
2023798	2023-12-07 04:15:00	25	3	2.82	3.70	2.35	2.55	3.65	2.61	11	1	3	8	1	8	19	2	11	0	17	8	19	1	3	2	3	1	2	-1	-1	1	-0.27	-0.05	0.26
2226505	2024-12-22 22:00:00	25	1	5.20	4.10	1.63	5.30	4.10	1.62	0	0	1	2	0	0	2	0	1	0	2	1	2	1	3	2	3	1	2	1	0	-1	0.10	0.00	-0.01
2023796	2023-12-06 04:15:00	25	0	12.00	6.20	1.20	13.00	6.20	1.23	12	20	16	13	17	19	25	37	35	30	18	20	55	3	1	2	1	3	2	1	0	1	1.00	0.00	0.03
2023797	2023-12-07 04:15:00	25	3	4.20	4.05	1.68	4.55	4.05	1.71	10	10	4	11	9	4	21	19	8	5	7	18	26	1	2	3	3	2	1	1	0	1	0.35	0.00	0.03
2226506	2024-10-05 22:00:00	25	3	1.82	3.70	3.85	1.80	3.85	4.25	2	0	0	0	1	4	2	1	4	2	3	0	4	2	3	1	2	1	3	-1	1	1	-0.02	0.15	0.40
2023794	2023-09-03 21:00:00	25	3	1.65	4.25	4.20	1.65	4.35	4.65	0	2	1	0	2	3	0	4	4	5	1	1	5	3	1	1	1	2	2	0	1	1	0.00	0.10	0.45
2226509	2024-12-21 23:00:00	25	0	4.20	3.85	1.72	4.65	3.95	1.72	1	0	1	3	1	1	4	1	2	0	3	2	4	1	3	2	3	1	2	1	1	0	0.45	0.10	0.00
2023795	2023-12-07 03:30:00	25	3	2.02	3.35	3.50	2.08	3.30	3.75	13	6	12	13	5	16	26	11	28	10	25	8	36	2	3	1	2	1	3	1	-1	1	0.06	-0.05	0.25
2023792	2024-05-19 23:00:00	25	3	1.13	8.20	14.00	1.15	8.60	14.00	2	3	3	3	5	2	5	8	5	6	3	6	11	2	1	2	1	3	1	1	1	0	0.02	0.40	0.00
2226511	2024-10-20 00:30:00	25	3	4.55	3.90	1.65	4.75	3.95	1.71	2	1	0	1	1	3	3	2	3	0	1	0	3	1	3	1	2	1	2	1	1	1	0.20	0.05	0.06
2023793	2023-12-08 04:15:00	25	0	1.74	4.05	3.85	1.74	4.15	4.30	9	6	9	6	7	13	15	13	22	11	13	4	26	2	3	1	2	1	3	0	1	1	0.00	0.10	0.45
2226510	2024-12-22 22:00:00	25	0	2.42	3.55	2.61	2.49	3.60	2.69	0	2	3	1	3	2	1	5	5	6	2	2	7	3	1	1	1	2	2	1	1	1	0.07	0.05	0.08
2023790	2024-05-19 23:00:00	25	0	2.05	3.95	2.93	2.21	4.05	2.84	1	5	6	2	4	7	3	9	13	10	4	0	13	3	2	1	1	2	3	1	1	-1	0.16	0.10	-0.09
2226513	2024-10-19 22:00:00	25	0	2.38	3.45	2.69	2.47	3.45	2.59	0	1	3	1	1	1	1	2	4	4	3	1	5	3	2	1	1	2	3	1	0	-1	0.09	0.00	-0.10
2023791	2024-05-19 23:00:00	25	3	1.40	5.10	6.00	1.44	5.40	6.00	7	1	7	6	3	10	13	4	17	10	19	6	23	2	3	1	2	1	3	1	1	0	0.04	0.30	0.00
2023788	2024-05-19 23:00:00	25	0	6.80	5.50	1.33	8.60	6.10	1.30	8	7	13	14	11	10	22	18	23	4	8	3	26	2	3	1	2	1	3	1	1	-1	1.80	0.60	-0.03
2226515	2024-12-23 00:30:00	25	0	3.70	4.30	1.74	4.05	4.50	1.72	3	2	4	6	4	1	9	6	5	2	5	6	11	1	2	3	3	2	1	1	1	-1	0.35	0.20	-0.02
2023789	2023-09-17 21:00:00	25	1	4.15	4.10	1.77	4.15	4.10	1.77	0	0	0	1	1	1	1	1	1	0	0	0	1	1	1	1	1	1	1	0	0	0	0.00	0.00	0.00
2023786	2023-12-07 03:30:00	25	0	12.00	7.30	1.17	14.00	7.50	1.18	1	9	4	4	8	4	5	17	8	15	3	12	20	3	1	2	1	3	2	1	1	1	2.00	0.20	0.01
2226516	2024-10-19 22:00:00	25	0	2.33	3.30	2.89	2.44	3.25	2.77	0	1	2	2	0	3	2	1	5	3	4	0	5	2	3	1	2	1	3	1	-1	-1	0.11	-0.05	-0.12
2023784	2023-09-02 22:00:00	25	0	3.70	3.90	1.81	4.25	3.85	1.80	3	2	5	5	3	2	8	5	7	0	3	1	8	1	3	2	3	1	2	1	-1	-1	0.55	-0.05	-0.01
2226519	2024-10-05 22:00:00	25	3	1.24	6.00	8.80	1.23	6.40	11.00	3	3	4	4	2	5	7	5	9	3	5	1	10	2	3	1	2	1	3	-1	1	1	-0.01	0.40	2.20
2023785	2024-05-19 23:00:00	25	3	1.06	12.00	19.00	1.11	11.00	19.00	5	3	12	8	2	10	13	5	22	13	21	4	26	2	3	1	2	1	3	1	-1	0	0.05	-1.00	0.00
2226518	2024-12-21 23:00:00	25	0	2.31	3.55	2.73	2.33	3.45	3.00	1	2	3	1	0	4	2	2	7	5	5	0	7	2	2	1	1	1	3	1	-1	1	0.02	-0.10	0.27
2023782	2023-12-07 03:30:00	25	0	2.23	3.35	3.00	2.29	3.40	3.15	2	3	7	5	3	5	7	6	12	6	7	1	13	2	3	1	2	1	3	1	1	1	0.06	0.05	0.15
2023783	2024-05-19 23:00:00	25	0	2.70	3.80	2.25	2.85	3.90	2.25	4	1	0	2	2	1	6	3	1	0	3	5	6	1	2	3	3	2	1	1	1	0	0.15	0.10	0.00
2226520	2024-12-22 22:00:00	25	1	1.40	4.55	6.80	1.43	4.75	7.10	1	2	3	2	1	3	3	3	6	3	3	0	6	2	2	1	1	1	3	1	1	1	0.03	0.20	0.30
2023780	2024-05-19 23:00:00	25	3	1.83	4.10	3.45	1.87	4.20	3.60	1	3	2	3	5	1	4	8	3	6	2	7	10	2	1	3	2	3	1	1	1	1	0.04	0.10	0.15
2226523	2024-12-21 23:00:00	25	1	2.76	3.70	2.23	2.84	3.80	2.29	3	0	1	2	1	1	5	1	2	0	4	3	5	1	3	2	3	1	2	1	1	1	0.08	0.10	0.06
2023781	2023-09-02 19:30:00	25	1	2.79	3.10	2.51	2.92	3.10	2.40	1	0	1	1	1	1	2	1	2	0	1	0	2	1	3	1	2	1	2	1	0	-1	0.13	0.00	-0.11
2226522	2024-12-22 22:00:00	25	0	1.82	3.80	3.75	1.80	3.95	4.15	6	1	1	1	3	5	7	4	6	2	5	3	9	1	3	2	3	1	2	-1	1	1	-0.02	0.15	0.40
2023778	2023-09-02 22:00:00	25	3	1.13	8.10	15.00	1.18	7.80	14.00	2	6	5	4	6	5	6	12	10	9	3	5	15	3	1	2	1	3	2	1	-1	-1	0.05	-0.30	-1.00
2226525	2024-10-20 23:30:00	25	3	1.62	4.10	4.60	1.63	4.35	4.85	5	3	12	6	5	10	11	8	22	11	14	0	22	2	3	1	2	1	3	1	1	1	0.01	0.25	0.25
2023779	2023-12-07 03:30:00	25	3	1.88	3.70	3.60	1.95	3.75	3.70	9	2	11	12	2	9	21	4	20	4	21	5	25	1	3	2	3	1	2	1	1	1	0.07	0.05	0.10
2226527	2024-10-19 22:00:00	25	3	1.71	3.95	4.15	1.71	3.90	4.20	0	1	0	0	1	1	0	2	1	2	0	1	2	3	1	2	1	3	2	0	-1	1	0.00	-0.05	0.05
2023838	2023-11-12 22:00:00	25	1	1.27	5.50	9.10	1.24	6.20	12.00	4	2	4	1	5	7	5	7	11	7	5	1	12	3	2	1	1	2	3	-1	1	1	-0.03	0.70	2.90
2226593	2024-11-02 23:00:00	25	3	2.20	3.40	3.05	2.08	3.55	3.45	5	2	6	5	4	7	10	6	13	6	10	3	16	2	3	1	2	1	3	-1	1	1	-0.12	0.15	0.40
2023839	2024-04-27 22:00:00	25	1	2.06	3.60	3.15	2.07	3.65	3.40	1	0	2	2	2	2	3	2	4	2	3	1	5	2	3	1	2	1	3	1	1	1	0.01	0.05	0.25
2226592	2025-01-05 22:00:00	25	1	1.55	4.15	5.20	1.55	4.35	5.70	5	1	4	4	4	5	9	5	9	1	5	1	10	1	3	1	2	1	2	0	1	1	0.00	0.20	0.50
2023836	2024-04-28 21:00:00	25	3	2.21	3.70	2.80	2.21	3.95	2.91	5	0	7	4	3	8	9	3	15	6	12	0	15	2	3	1	2	1	3	0	1	1	0.00	0.25	0.11
2226595	2025-01-04 23:00:00	25	3	1.28	5.40	8.70	1.35	5.40	8.30	2	5	11	7	3	8	9	8	19	11	12	1	20	2	3	1	2	1	3	1	0	-1	0.07	0.00	-0.40
2023837	2023-09-30 22:00:00	25	3	9.50	5.30	1.28	10.00	5.60	1.29	5	3	5	5	4	4	10	7	9	0	3	1	10	1	3	2	3	1	2	1	1	1	0.50	0.30	0.01
2226594	2025-01-04 23:00:00	25	3	1.31	5.60	7.10	1.32	6.00	8.10	3	2	6	3	5	7	6	7	13	8	7	1	14	3	2	1	1	2	3	1	1	1	0.01	0.40	1.00
2023834	2023-11-12 01:30:00	25	3	4.25	3.55	1.77	4.25	3.85	1.80	4	3	2	4	2	4	8	5	6	1	4	3	9	1	3	2	3	1	2	0	1	1	0.00	0.30	0.03
2226597	2024-11-03 22:00:00	25	3	1.95	3.85	3.25	1.89	4.10	3.60	7	2	2	2	5	5	9	7	7	5	7	7	14	1	2	2	3	1	1	-1	1	1	-0.06	0.25	0.35
2023835	2023-09-30 22:00:00	25	3	1.39	4.85	8.10	1.39	4.85	8.10	1	0	0	0	1	1	1	1	1	0	0	0	1	1	1	1	1	1	1	0	0	0	0.00	0.00	0.00
2226596	2025-01-04 23:00:00	25	0	2.57	3.45	2.49	3.00	3.65	2.25	2	1	4	6	4	1	8	5	5	3	6	6	11	1	2	2	3	1	1	1	1	-1	0.43	0.20	-0.24
2023832	2024-04-28 03:00:00	25	1	2.07	3.80	2.99	2.14	4.10	2.95	1	4	8	4	4	7	5	8	15	12	9	2	17	3	2	1	1	2	3	1	1	-1	0.07	0.30	-0.04
2226599	2024-11-03 01:30:00	25	1	2.35	3.45	2.75	2.38	3.45	2.93	1	2	1	1	1	3	2	3	4	3	2	1	5	3	2	1	1	2	3	1	0	1	0.03	0.00	0.18
2226601	2025-01-07 04:00:00	25	0	3.05	3.20	2.29	3.30	3.15	2.33	6	4	6	8	3	5	14	7	11	5	12	8	19	1	3	2	3	1	2	1	-1	1	0.25	-0.05	0.04
2226600	2025-01-04 20:30:00	25	0	2.60	3.80	2.31	3.60	4.20	1.88	20	7	19	21	12	19	41	19	38	8	30	11	49	1	3	2	3	1	2	1	1	-1	1.00	0.40	-0.43
2023829	2024-05-11 22:00:00	25	0	2.78	3.50	2.30	2.83	3.60	2.38	3	1	3	2	2	3	5	3	6	3	5	2	8	2	3	1	2	1	3	1	1	1	0.05	0.10	0.08
2226602	2024-11-04 00:30:00	25	1	2.49	3.80	2.40	2.63	3.85	2.45	6	3	12	6	4	11	12	7	23	15	20	4	27	2	3	1	2	1	3	1	1	1	0.14	0.05	0.05
2023826	2024-05-11 22:00:00	25	3	1.36	5.40	6.40	1.36	5.80	7.00	6	3	5	4	4	9	10	7	14	6	9	2	16	2	3	1	2	1	3	0	1	1	0.00	0.40	0.60
2023827	2023-09-24 21:00:00	25	1	1.67	4.10	4.20	1.65	4.40	4.60	2	3	2	1	4	5	3	7	7	4	0	0	7	3	1	1	1	2	2	-1	1	1	-0.02	0.30	0.40
2023824	2023-12-03 22:00:00	25	1	2.02	3.40	3.45	1.97	3.50	3.85	5	0	1	3	1	4	8	1	5	1	8	4	9	1	3	2	3	1	2	-1	1	1	-0.05	0.10	0.40
2226607	2024-11-02 23:00:00	25	3	2.51	3.55	2.51	2.51	3.55	2.69	0	0	3	0	1	2	0	1	5	5	4	0	5	3	2	1	1	2	3	0	0	1	0.00	0.00	0.18
2023825	2024-05-11 22:00:00	25	3	1.80	4.05	3.60	1.80	4.15	3.95	1	0	0	0	1	1	1	1	1	1	1	1	2	1	1	1	1	1	1	0	1	1	0.00	0.10	0.35
2023822	2024-05-12 00:30:00	25	0	3.05	3.70	2.08	3.30	3.85	2.06	3	1	8	5	2	6	8	3	14	7	12	1	15	2	3	1	2	1	3	1	1	-1	0.25	0.15	-0.02
2041230	2023-11-26 22:00:00	25	0	2.47	3.80	2.43	2.49	3.80	2.60	9	0	10	10	0	9	19	0	19	0	19	0	19	1	3	1	2	1	2	1	0	1	0.02	0.00	0.17
2023820	2023-12-03 04:00:00	25	3	1.95	3.70	3.35	2.14	3.65	3.20	19	5	18	25	5	15	44	10	33	8	42	19	52	1	3	2	3	1	2	1	-1	-1	0.19	-0.05	-0.15
2041228	2023-11-25 23:00:00	25	3	2.63	3.45	2.43	2.47	3.60	2.72	1	1	6	1	1	8	2	2	14	12	12	0	14	2	2	1	1	1	3	-1	1	1	-0.16	0.15	0.29
2023821	2024-05-11 22:00:00	25	1	1.51	4.60	4.95	1.57	4.75	4.95	3	2	4	3	5	5	6	7	9	4	3	1	10	3	2	1	1	2	3	1	1	0	0.06	0.15	0.00
2023818	2023-09-16 19:30:00	25	0	5.80	4.50	1.46	6.10	4.65	1.49	2	2	1	2	3	2	4	5	3	1	0	2	5	2	1	3	2	3	1	1	1	1	0.30	0.15	0.03
2041227	2023-11-25 20:30:00	25	1	1.77	4.00	3.80	1.76	4.10	4.20	1	1	1	0	3	3	1	4	4	4	1	1	5	3	1	1	1	2	2	-1	1	1	-0.01	0.10	0.40
2023819	2024-05-12 23:30:00	25	0	6.90	5.10	1.36	6.70	5.30	1.40	20	11	8	13	10	13	33	21	21	2	14	14	35	1	2	2	3	1	1	-1	1	1	-0.20	0.20	0.04
2041225	2023-11-28 04:00:00	25	3	2.38	3.25	3.10	2.49	3.15	3.00	1	9	12	4	7	11	5	16	23	23	12	5	28	3	2	1	1	2	3	1	-1	-1	0.11	-0.10	-0.10
2023816	2024-05-11 19:30:00	25	0	12.00	6.70	1.16	12.00	6.80	1.22	4	3	4	4	5	4	8	8	8	7	7	7	15	1	1	1	1	1	1	0	1	1	0.00	0.10	0.06
2041224	2023-11-27 00:30:00	25	0	2.58	3.45	2.49	2.89	3.50	2.38	14	5	17	19	5	14	33	10	31	0	23	2	33	1	3	2	3	1	2	1	1	-1	0.31	0.05	-0.11
2023817	2023-12-04 00:30:00	25	1	1.27	5.80	8.00	1.28	6.20	9.50	7	10	15	10	8	12	17	18	27	14	13	4	31	3	2	1	1	2	3	1	1	1	0.01	0.40	1.50
2041223	2023-11-25 23:00:00	25	0	3.35	3.55	2.00	3.30	3.65	2.11	6	2	2	3	2	8	9	4	10	3	8	2	12	2	3	1	2	1	3	-1	1	1	-0.05	0.10	0.11
2023814	2023-12-03 22:00:00	25	3	1.27	5.80	8.70	1.26	6.30	11.00	5	3	4	3	6	8	8	9	12	5	4	1	13	3	2	1	1	2	3	-1	1	1	-0.01	0.50	2.30
2023815	2023-09-16 22:00:00	25	0	6.00	4.30	1.47	6.30	4.50	1.50	6	4	3	4	5	5	10	9	8	0	1	2	10	1	2	3	3	2	1	1	1	1	0.30	0.20	0.03
2041222	2023-11-26 01:30:00	25	0	4.45	3.80	1.69	4.75	3.85	1.73	6	1	1	4	2	3	10	3	4	0	7	6	10	1	3	2	3	1	2	1	1	1	0.30	0.05	0.04
2023813	2023-09-16 22:00:00	25	3	1.24	6.00	9.90	1.28	6.00	9.90	2	2	5	4	3	5	6	5	10	4	5	0	10	2	3	1	2	1	3	1	0	0	0.04	0.00	0.00
2023811	2023-12-03 22:00:00	25	3	1.74	4.00	4.40	1.74	4.00	4.40	0	0	0	0	1	1	0	1	1	1	0	0	1	3	1	1	1	2	2	0	0	0	0.00	0.00	0.00
2023809	2023-09-19 02:45:00	25	1	2.19	3.45	3.00	2.19	3.50	3.25	4	2	2	2	3	5	6	5	7	3	4	2	9	2	3	1	2	1	3	0	1	1	0.00	0.05	0.25
2226561	2024-12-29 23:00:00	25	3	1.58	4.00	5.10	1.58	4.05	5.90	5	2	5	4	3	6	9	5	11	2	6	0	11	2	3	1	2	1	3	0	1	1	0.00	0.05	0.80
2023871	2024-05-16 03:00:00	25	3	2.60	3.90	2.28	2.62	4.05	2.38	11	4	0	13	5	3	24	9	3	0	15	21	24	1	2	3	3	2	1	1	1	1	0.02	0.15	0.10
2226563	2024-10-27 22:00:00	25	3	3.70	3.80	1.83	3.95	4.05	1.82	2	0	6	6	2	3	8	2	9	2	8	1	10	2	3	1	2	1	3	1	1	-1	0.25	0.25	-0.01
2023869	2024-04-20 22:00:00	25	0	2.84	3.65	2.20	3.05	3.75	2.20	1	0	0	1	1	0	2	1	0	0	1	2	2	1	2	3	3	2	1	1	1	0	0.21	0.10	0.00
2226562	2024-10-27 22:00:00	25	3	1.73	3.95	4.00	1.70	4.35	4.35	3	2	2	0	4	7	3	6	9	10	7	4	13	3	2	1	1	2	3	-1	1	1	-0.03	0.40	0.35
2023866	2024-04-21 23:30:00	25	0	5.10	4.70	1.50	5.60	4.90	1.50	1	1	2	2	3	2	3	4	4	2	1	1	5	3	1	1	1	2	2	1	1	0	0.50	0.20	0.00
2226565	2024-12-29 23:00:00	25	0	2.56	3.05	2.76	2.66	3.05	2.73	5	2	10	7	1	11	12	3	21	9	18	0	21	2	3	1	2	1	3	1	0	-1	0.10	0.00	-0.03
2023864	2023-11-13 00:30:00	25	1	4.80	3.60	1.69	4.55	3.80	1.76	6	4	0	3	4	3	9	8	3	2	3	8	11	1	2	3	3	2	1	-1	1	1	-0.25	0.20	0.07
2226567	2024-12-29 23:00:00	25	1	2.36	3.55	2.68	2.36	3.45	2.97	0	2	2	0	0	6	0	2	8	8	6	0	8	3	2	1	1	2	3	0	-1	1	0.00	-0.10	0.29
2023865	2024-04-27 22:00:00	25	3	1.22	6.50	9.50	1.23	7.20	10.00	2	1	3	2	4	4	4	5	7	5	4	2	9	3	2	1	1	2	3	1	1	1	0.01	0.70	0.50
2226566	2024-10-27 00:30:00	25	1	2.64	3.30	2.51	2.65	3.50	2.58	6	0	4	4	1	4	10	1	8	0	9	2	10	1	3	2	3	1	2	1	1	1	0.01	0.20	0.07
2023862	2024-04-21 22:00:00	25	3	2.07	3.60	3.15	2.03	3.70	3.50	5	0	2	5	2	4	10	2	6	1	9	5	11	1	3	2	3	1	2	-1	1	1	-0.04	0.10	0.35
2226569	2024-10-26 03:00:00	25	0	2.84	3.20	2.42	2.89	3.35	2.47	9	3	2	8	5	2	17	8	4	0	9	13	17	1	2	3	3	2	1	1	1	1	0.05	0.15	0.05
2023863	2023-11-04 23:00:00	25	1	2.98	3.65	2.12	3.10	3.75	2.17	6	2	1	6	2	2	12	4	3	0	8	9	12	1	2	3	3	2	1	1	1	1	0.12	0.10	0.05
2023860	2023-10-07 22:00:00	25	3	1.72	3.95	4.05	1.72	4.00	4.55	0	1	1	1	1	1	1	2	2	1	0	0	2	3	1	1	1	2	2	0	1	1	0.00	0.05	0.50
2023861	2023-11-04 20:30:00	25	0	3.05	3.60	2.11	3.20	3.65	2.17	3	3	2	7	2	4	10	5	6	2	7	6	12	1	3	2	3	1	2	1	1	1	0.15	0.05	0.06
2226570	2024-12-31 03:45:00	25	3	7.00	4.95	1.37	7.20	5.20	1.39	7	1	4	10	2	5	17	3	9	0	14	8	17	1	3	2	3	1	2	1	1	1	0.20	0.25	0.02
2023858	2024-05-16 02:45:00	25	0	3.00	3.85	2.06	3.15	4.00	2.08	10	4	18	16	5	10	26	9	28	8	25	6	34	2	3	1	2	1	3	1	1	1	0.15	0.15	0.02
2226573	2024-12-29 22:30:00	25	0	7.80	5.30	1.30	8.20	5.80	1.32	15	6	7	14	10	7	29	16	14	0	13	15	29	1	2	3	3	2	1	1	1	1	0.40	0.50	0.02
2226572	2024-10-26 22:00:00	25	3	1.09	9.80	17.00	1.09	10.00	26.00	2	3	2	2	3	5	4	6	7	6	4	3	10	3	2	1	1	2	3	0	1	1	0.00	0.20	9.00
2023856	2023-10-07 19:30:00	25	0	5.90	4.50	1.45	5.90	4.55	1.45	4	3	2	2	2	3	6	5	5	0	1	1	6	1	2	2	3	1	1	0	1	0	0.00	0.05	0.00
2226575	2024-10-27 22:00:00	25	3	2.69	3.65	2.31	2.83	3.75	2.33	2	0	0	4	1	1	6	1	1	0	5	5	6	1	2	2	3	1	1	1	1	1	0.14	0.10	0.02
2023854	2023-10-01 00:30:00	25	3	2.80	3.80	2.17	2.92	3.95	2.20	1	4	1	6	2	1	7	6	2	0	1	5	7	1	2	3	3	2	1	1	1	1	0.12	0.15	0.03
2023855	2024-04-21 22:00:00	25	3	1.87	3.90	3.50	1.86	3.95	3.85	2	0	1	2	1	2	4	1	3	1	4	2	5	1	3	2	3	1	2	-1	1	1	-0.01	0.05	0.35
2023852	2024-04-27 22:00:00	25	3	2.02	3.65	3.25	2.04	3.90	3.30	7	0	4	6	2	6	13	2	10	1	12	4	14	1	3	2	3	1	2	1	1	1	0.02	0.25	0.05
2226578	2024-12-31 04:00:00	25	0	2.68	3.60	2.51	2.69	3.30	2.67	11	7	10	21	4	9	32	11	19	4	25	17	36	1	3	2	3	1	2	1	-1	1	0.01	-0.30	0.16
2023850	2023-11-11 23:00:00	25	3	1.17	6.70	13.00	1.19	6.80	14.00	7	9	7	8	8	6	15	17	13	5	3	7	20	2	1	3	2	3	1	1	1	1	0.02	0.10	1.00
2023851	2024-04-27 19:30:00	25	1	5.40	4.60	1.48	5.70	5.00	1.48	3	1	2	6	3	1	9	4	3	0	5	6	9	1	2	3	3	2	1	1	1	0	0.30	0.40	0.00
2226580	2024-12-29 23:00:00	25	1	1.63	4.30	4.25	1.67	4.55	4.35	1	3	3	3	3	2	4	6	5	5	3	4	9	3	1	2	1	3	2	1	1	1	0.04	0.25	0.10
2023848	2024-04-28 21:00:00	25	0	3.85	4.00	1.76	4.15	4.20	1.75	7	9	6	7	12	5	14	21	11	9	2	12	23	2	1	3	2	3	1	1	1	-1	0.30	0.20	-0.01
2226583	2024-11-05 04:00:00	25	3	2.04	3.50	3.30	2.07	3.75	3.35	5	4	6	7	4	7	12	8	13	11	15	10	23	2	3	1	2	1	3	1	1	1	0.03	0.25	0.05
2023849	2023-11-11 20:30:00	25	3	2.98	3.45	2.19	3.15	3.80	2.14	3	0	2	3	2	3	6	2	5	1	5	2	7	1	3	2	3	1	2	1	1	-1	0.17	0.35	-0.05
2226582	2024-11-02 23:00:00	25	3	4.75	4.15	1.59	5.60	4.20	1.58	12	10	10	11	9	10	23	19	20	6	10	9	29	1	3	2	3	1	2	1	1	-1	0.85	0.05	-0.01
2023847	2023-10-08 21:00:00	25	1	3.00	3.90	2.04	3.25	4.10	2.01	1	2	5	4	2	1	5	4	6	3	4	2	8	2	3	1	2	1	3	1	1	-1	0.25	0.20	-0.03
2226584	2025-01-04 23:00:00	25	3	1.73	3.40	4.75	1.72	3.90	4.70	2	1	3	0	3	5	2	4	8	8	6	2	10	3	2	1	1	2	3	-1	1	-1	-0.01	0.50	-0.05
2023844	2023-11-12 22:00:00	25	3	1.40	4.75	6.60	1.37	5.20	7.60	6	4	4	4	6	9	10	10	13	3	3	0	13	2	2	1	1	1	3	-1	1	1	-0.03	0.45	1.00
2226587	2024-11-02 23:00:00	25	3	1.38	5.10	6.20	1.38	5.20	7.50	5	1	4	4	3	9	9	4	13	6	11	2	15	2	3	1	2	1	3	0	1	1	0.00	0.10	1.30
2023845	2024-04-28 23:30:00	25	0	10.00	5.50	1.26	9.90	5.90	1.28	15	10	10	16	13	10	31	23	20	6	14	17	37	1	2	3	3	2	1	-1	1	1	-0.10	0.40	0.02
2226586	2024-11-02 23:00:00	25	1	2.25	3.55	2.82	2.23	3.65	3.05	4	4	6	4	5	6	8	9	12	9	8	5	17	3	2	1	1	2	3	-1	1	1	-0.02	0.10	0.23
2226589	2024-11-02 20:30:00	25	3	3.60	3.60	1.90	3.90	3.70	1.92	6	2	11	6	3	11	12	5	22	12	19	2	24	2	3	1	2	1	3	1	1	1	0.30	0.10	0.02
2023843	2023-10-08 23:30:00	25	3	2.74	3.45	2.35	2.95	3.60	2.31	2	0	3	4	2	0	6	2	3	0	4	3	6	1	3	2	3	1	2	1	1	-1	0.21	0.15	-0.04
2226588	2025-01-04 23:00:00	25	1	3.40	3.65	1.96	3.75	3.75	1.93	5	3	10	9	5	3	14	8	13	4	10	5	18	1	3	2	3	1	2	1	1	-1	0.35	0.10	-0.03
2023840	2024-04-27 22:00:00	25	1	1.51	4.45	5.20	1.53	4.95	5.10	4	4	8	6	7	5	10	11	13	7	6	4	17	3	2	1	1	2	3	1	1	-1	0.02	0.50	-0.10
2226591	2025-01-06 00:30:00	25	1	1.28	5.80	8.10	1.33	5.60	8.50	6	7	15	10	5	13	16	12	28	14	18	2	30	2	3	1	2	1	3	1	-1	1	0.05	-0.20	0.40
2023841	2024-04-28 00:30:00	25	3	2.38	3.55	2.87	2.44	3.55	2.80	0	0	2	2	1	1	2	1	3	1	2	0	3	2	3	1	2	1	3	1	0	-1	0.06	0.00	-0.07
2226590	2025-01-05 01:30:00	25	1	3.80	3.70	1.83	4.30	3.65	1.84	9	6	17	14	5	10	23	11	27	7	19	3	30	2	3	1	2	1	3	1	-1	1	0.50	-0.05	0.01
2023902	2023-10-29 23:30:00	25	0	5.10	4.15	1.63	5.10	4.15	1.64	0	1	1	1	2	1	1	3	2	2	0	1	3	3	1	2	1	3	2	0	0	1	0.00	0.00	0.01
2023903	2024-04-13 22:00:00	25	3	1.41	4.60	6.30	1.42	4.90	6.90	2	0	0	1	2	3	3	2	3	0	1	0	3	1	3	1	2	1	2	1	1	1	0.01	0.30	0.60
2023900	2024-04-14 23:30:00	25	0	1.30	5.40	7.60	1.33	5.40	9.00	2	2	8	5	2	7	7	4	15	8	11	0	15	2	3	1	2	1	3	1	0	1	0.03	0.00	1.40
2023901	2024-04-14 00:30:00	25	1	2.36	3.90	2.70	2.47	3.90	2.58	1	0	3	3	1	3	4	1	6	2	5	0	6	2	3	1	2	1	3	1	0	-1	0.11	0.00	-0.12
2023898	2023-10-28 03:00:00	25	0	4.35	3.90	1.77	4.35	3.80	1.80	7	6	14	16	7	5	23	13	19	3	13	7	26	1	3	2	3	1	2	0	-1	1	0.00	-0.10	0.03
2023899	2023-10-29 22:00:00	25	3	1.21	6.30	11.00	1.21	7.00	13.00	2	0	0	1	3	3	3	3	3	0	0	0	3	1	1	1	1	1	1	0	1	1	0.00	0.70	2.00
2023896	2023-10-28 19:30:00	25	0	1.60	3.95	4.90	1.60	3.95	4.90	1	1	2	2	0	1	3	1	3	0	2	0	3	1	3	1	2	1	2	0	0	0	0.00	0.00	0.00
2023897	2023-10-24 03:00:00	25	3	1.44	4.50	6.20	1.46	4.65	6.60	7	6	8	8	8	9	15	14	17	6	7	4	21	2	3	1	2	1	3	1	1	1	0.02	0.15	0.40
2023895	2023-10-22 03:00:00	25	0	7.70	4.90	1.40	9.60	5.50	1.31	11	8	12	19	12	7	30	20	19	1	11	12	31	1	2	3	3	2	1	1	1	-1	1.90	0.60	-0.09
2023891	2024-04-21 02:30:00	25	0	8.90	5.10	1.30	8.70	5.30	1.33	11	3	6	8	5	5	19	8	11	1	12	9	20	1	3	2	3	1	2	-1	1	1	-0.20	0.20	0.03
2023888	2024-05-15 03:00:00	25	0	6.80	5.20	1.35	6.80	5.50	1.39	33	17	22	27	17	27	60	34	49	18	44	29	78	1	3	2	3	1	2	0	1	1	0.00	0.30	0.04
2023889	2023-10-28 22:00:00	25	3	1.12	9.00	15.00	1.12	9.20	21.00	1	2	2	1	3	3	2	5	5	3	0	0	5	3	1	1	1	2	2	0	1	1	0.00	0.20	6.00
2023887	2023-10-21 22:00:00	25	3	1.36	4.90	7.10	1.36	5.30	7.80	3	3	5	3	3	6	6	6	11	5	5	0	11	2	2	1	1	1	3	0	1	1	0.00	0.40	0.70
2023885	2023-10-21 19:30:00	25	3	1.34	5.00	7.50	1.38	4.80	6.70	1	4	4	4	1	1	5	5	5	0	0	0	5	1	1	1	1	1	1	1	-1	-1	0.04	-0.20	-0.80
2023882	2024-04-21 20:30:00	25	3	2.13	3.40	3.20	2.11	3.40	3.55	2	1	1	2	1	3	4	2	4	2	4	2	6	1	3	1	2	1	2	-1	0	1	-0.02	0.00	0.35
2023883	2023-11-05 01:30:00	25	3	2.68	3.40	2.42	2.80	3.45	2.47	6	5	2	8	5	2	14	10	4	1	5	11	15	1	2	3	3	2	1	1	1	1	0.12	0.05	0.05
2023880	2024-04-20 22:00:00	25	0	2.60	3.50	2.44	2.76	3.60	2.44	2	0	0	4	1	0	6	1	0	0	5	6	6	1	2	3	3	2	1	1	1	0	0.16	0.10	0.00
2023881	2023-10-08 21:00:00	25	1	3.25	3.55	2.05	3.40	3.80	2.03	1	0	2	3	3	1	4	3	3	0	1	1	4	1	2	2	3	1	1	1	1	-1	0.15	0.25	-0.02
2023878	2023-11-04 23:00:00	25	3	1.08	11.00	14.00	1.08	12.00	30.00	8	5	7	7	6	13	15	11	20	9	13	4	24	2	3	1	2	1	3	0	1	1	0.00	1.00	16.00
2023879	2023-11-06 00:30:00	25	1	10.00	6.20	1.23	13.00	6.70	1.22	3	3	4	5	7	3	8	10	7	3	1	4	11	2	1	3	2	3	1	1	1	-1	3.00	0.50	-0.01
2023876	2023-11-07 04:00:00	25	0	2.17	3.60	2.92	2.21	3.60	3.15	8	6	4	7	5	8	15	11	12	8	12	11	23	1	3	2	3	1	2	1	0	1	0.04	0.00	0.23
2023874	2023-10-08 21:00:00	25	1	3.10	3.60	2.09	3.35	3.70	2.09	0	0	0	1	1	1	1	1	1	1	1	1	2	1	1	1	1	1	1	1	1	0	0.25	0.10	0.00
2023875	2023-10-22 00:30:00	25	1	3.05	3.45	2.17	3.15	3.50	2.23	2	1	4	4	2	5	6	3	9	3	6	0	9	2	3	1	2	1	3	1	1	1	0.10	0.05	0.06
2023872	2023-10-22 23:30:00	25	3	1.94	3.60	3.50	1.94	3.85	3.65	6	4	7	10	4	6	16	8	13	2	10	5	18	1	3	2	3	1	2	0	1	1	0.00	0.25	0.15
2023934	2024-04-04 03:15:00	25	3	1.24	5.80	10.00	1.26	6.10	11.00	10	10	12	13	10	10	23	20	22	14	17	15	37	1	3	2	3	1	2	1	1	1	0.02	0.30	1.00
2023935	2024-04-03 02:45:00	25	3	1.97	3.65	3.35	2.01	3.65	3.60	5	4	5	8	3	5	13	7	10	2	8	5	15	1	3	2	3	1	2	1	0	1	0.04	0.00	0.25
2023932	2024-04-05 02:30:00	25	3	1.08	13.00	21.00	1.08	13.00	21.00	2	0	0	1	1	1	3	1	1	0	2	2	3	1	2	2	3	1	1	0	0	0	0.00	0.00	0.00
2023933	2024-04-03 02:30:00	25	1	1.98	3.80	3.20	2.00	3.80	3.50	13	6	7	11	5	8	24	11	15	4	17	13	28	1	3	2	3	1	2	1	0	1	0.02	0.00	0.30
2023931	2024-04-05 03:15:00	25	3	1.98	4.00	3.10	1.94	4.15	3.40	24	15	26	37	15	20	61	30	46	23	54	38	84	1	3	2	3	1	2	-1	1	1	-0.04	0.15	0.30
2023928	2024-04-08 01:00:00	25	3	1.33	5.00	7.60	1.40	5.10	7.00	4	2	7	5	2	4	9	4	11	3	8	1	12	2	3	1	2	1	3	1	1	-1	0.07	0.10	-0.60
2023929	2024-04-06 22:00:00	25	0	2.40	3.50	2.66	2.40	3.60	2.81	0	0	2	0	1	2	0	1	4	4	3	0	4	3	2	1	1	2	3	0	1	1	0.00	0.10	0.15
2023926	2024-04-07 22:30:00	25	1	4.10	4.35	1.65	4.95	4.65	1.58	7	4	11	14	8	6	21	12	17	1	10	5	22	1	3	2	3	1	2	1	1	-1	0.85	0.30	-0.07
2023927	2024-04-08 00:30:00	25	1	7.10	5.00	1.35	6.90	5.30	1.40	3	1	2	4	2	2	7	3	4	2	6	5	9	1	3	2	3	1	2	-1	1	1	-0.20	0.30	0.05
2023925	2023-11-05 22:00:00	25	3	3.65	3.65	1.88	4.35	3.90	1.78	1	1	7	6	3	0	7	4	7	3	6	3	10	1	3	1	2	1	2	1	1	-1	0.70	0.25	-0.10
2023922	2023-12-09 23:00:00	25	1	1.88	3.50	3.80	1.87	3.55	4.25	3	1	1	3	1	3	6	2	4	2	6	4	8	1	3	2	3	1	2	-1	1	1	-0.01	0.05	0.45
2023920	2024-04-06 22:00:00	25	3	3.30	3.85	1.92	3.55	4.00	1.93	3	2	1	2	3	3	5	5	4	1	1	2	6	1	1	3	2	2	1	1	1	1	0.25	0.15	0.01
2023918	2024-04-06 22:00:00	25	3	1.67	3.90	4.45	1.67	4.00	4.95	0	1	3	0	3	2	0	4	5	5	1	0	5	3	2	1	1	2	3	0	1	1	0.00	0.10	0.50
2023919	2024-04-06 22:00:00	25	0	2.33	3.70	2.62	2.33	3.85	2.78	1	1	3	0	4	3	1	5	6	5	1	0	6	3	2	1	1	2	3	0	1	1	0.00	0.15	0.16
2023916	2024-04-06 19:30:00	25	0	9.40	4.95	1.30	9.10	5.30	1.33	8	5	7	10	6	7	18	11	14	3	10	7	21	1	3	2	3	1	2	-1	1	1	-0.30	0.35	0.03
2023914	2024-04-07 00:30:00	25	0	5.00	4.00	1.59	5.30	4.15	1.61	4	3	3	4	4	4	8	7	7	7	8	8	15	1	2	2	3	1	1	1	1	1	0.30	0.15	0.02
2023915	2023-11-11 23:00:00	25	3	1.34	4.80	8.10	1.33	5.30	9.40	3	1	6	2	4	7	5	5	13	8	8	0	13	2	2	1	1	1	3	-1	1	1	-0.01	0.50	1.30
2023912	2024-04-14 21:00:00	25	0	2.38	3.70	2.78	2.38	3.70	2.78	0	0	0	0	1	1	0	1	1	1	0	0	1	3	1	1	1	2	2	0	0	0	0.00	0.00	0.00
2023913	2024-04-06 22:00:00	25	1	1.68	4.10	4.15	1.68	4.20	4.60	0	0	2	0	2	1	0	2	3	3	1	0	3	3	2	1	1	2	3	0	1	1	0.00	0.10	0.45
2023910	2024-04-13 19:30:00	25	3	2.57	3.95	2.29	2.58	3.90	2.29	2	1	0	1	1	0	3	2	0	0	1	3	3	1	2	3	3	2	1	1	-1	0	0.01	-0.05	0.00
2023911	2024-04-13 22:00:00	25	1	2.23	3.45	2.93	2.13	3.50	3.40	3	1	0	0	2	5	3	3	5	2	2	0	5	2	2	1	1	1	3	-1	1	1	-0.10	0.05	0.47
2023908	2024-04-14 21:00:00	25	0	1.20	6.60	11.00	1.21	6.90	13.00	1	1	0	2	2	1	3	3	1	1	1	3	4	1	1	3	2	2	1	1	1	1	0.01	0.30	2.00
2023909	2024-04-13 22:00:00	25	3	1.10	8.90	18.00	1.10	10.00	20.00	1	3	2	1	4	3	2	7	5	6	1	3	8	3	1	2	1	3	2	0	1	1	0.00	1.10	2.00
2023906	2024-04-16 03:00:00	25	3	1.69	4.10	4.65	1.71	4.10	4.50	0	3	3	1	3	2	1	6	5	9	4	5	10	3	1	2	1	3	2	1	0	-1	0.02	0.00	-0.15
2023907	2023-10-29 00:30:00	25	1	3.70	3.75	1.84	4.10	3.90	1.82	5	4	5	6	7	1	11	11	6	4	4	9	15	1	1	3	2	2	1	1	1	-1	0.40	0.15	-0.02
2023904	2023-10-29 21:00:00	25	0	2.16	3.60	2.95	2.16	3.60	2.95	0	0	1	0	1	0	0	1	1	1	0	0	1	3	1	1	1	2	2	0	0	0	0.00	0.00	0.00
2023905	2024-04-13 22:00:00	25	1	3.20	3.60	2.05	3.45	3.70	2.04	0	2	3	2	2	3	2	4	6	6	4	2	8	3	2	1	1	2	3	1	1	-1	0.25	0.10	-0.01
2023966	2024-03-10 22:00:00	25	3	1.76	3.80	4.05	1.78	3.90	4.30	0	1	1	2	1	1	2	2	2	1	1	1	3	1	1	1	1	1	1	1	1	1	0.02	0.10	0.25
2023967	2024-03-12 04:00:00	25	3	1.97	3.85	3.20	1.97	4.05	3.40	19	5	12	17	7	13	36	12	25	5	29	16	41	1	3	2	3	1	2	0	1	1	0.00	0.20	0.20
2023964	2024-03-10 21:00:00	25	0	2.42	3.95	2.42	2.42	3.90	2.43	0	1	0	0	0	2	0	1	2	2	1	0	2	3	2	1	1	2	3	0	-1	1	0.00	-0.05	0.01
2023965	2024-03-09 23:00:00	25	1	1.33	4.95	7.90	1.35	5.20	8.60	1	1	1	1	3	4	2	4	5	4	2	1	6	3	2	1	1	2	3	1	1	1	0.02	0.25	0.70
2023962	2024-04-25 02:45:00	25	0	2.56	3.45	2.49	2.82	3.60	2.40	7	2	7	11	3	4	18	5	11	0	13	7	18	1	3	2	3	1	2	1	1	-1	0.26	0.15	-0.09
2023963	2024-03-10 01:30:00	25	3	1.19	6.40	12.00	1.22	6.50	13.00	2	3	0	2	5	1	4	8	1	6	2	9	10	2	1	3	2	3	1	1	1	1	0.03	0.10	1.00
2023960	2024-04-25 03:00:00	25	3	1.36	5.20	6.30	1.35	5.50	7.80	10	7	15	10	8	20	20	15	35	16	21	1	36	2	3	1	2	1	3	-1	1	1	-0.01	0.30	1.50
2023961	2024-03-17 22:00:00	25	1	2.56	3.65	2.42	2.75	3.75	2.38	1	0	4	5	1	1	6	1	5	0	5	1	6	1	3	2	3	1	2	1	1	-1	0.19	0.10	-0.04
2023958	2024-04-25 03:00:00	25	3	6.70	4.60	1.41	7.00	4.80	1.44	8	6	11	13	12	9	21	18	20	4	7	5	25	1	3	2	3	1	2	1	1	1	0.30	0.20	0.03
2023959	2024-03-16 23:00:00	25	1	2.63	3.60	2.38	2.78	3.70	2.38	1	0	0	1	2	0	2	2	0	1	1	3	3	1	1	3	2	2	1	1	1	0	0.15	0.10	0.00
2023956	2024-04-25 03:00:00	25	3	2.60	3.60	2.40	2.73	3.70	2.42	5	1	6	8	3	4	13	4	10	0	9	3	13	1	3	2	3	1	2	1	1	1	0.13	0.10	0.02
2023957	2024-03-17 01:30:00	25	3	3.30	3.70	1.98	3.30	3.90	2.03	5	2	8	4	3	6	9	5	14	10	14	5	19	2	3	1	2	1	3	0	1	1	0.00	0.20	0.05
2023954	2024-04-26 03:00:00	25	0	6.80	4.80	1.39	7.50	5.10	1.39	22	9	18	27	14	17	49	23	35	6	32	20	55	1	3	2	3	1	2	1	1	0	0.70	0.30	0.00
2023955	2024-03-16 23:00:00	25	3	3.10	3.50	2.13	3.30	3.60	2.14	1	0	0	2	1	1	3	1	1	0	2	2	3	1	2	2	3	1	1	1	1	1	0.20	0.10	0.01
2023952	2024-03-30 23:00:00	25	3	1.21	6.80	9.50	1.24	6.80	11.00	3	2	3	5	2	4	8	4	7	1	5	2	9	1	3	2	3	1	2	1	0	1	0.03	0.00	1.50
2023953	2024-04-24 03:00:00	25	3	1.44	4.60	6.00	1.46	4.85	6.30	18	21	22	17	19	21	35	40	43	19	14	11	54	3	2	1	1	2	3	1	1	1	0.02	0.25	0.30
2023951	2024-03-30 23:00:00	25	1	4.05	3.90	1.74	4.40	4.00	1.74	1	0	0	1	2	0	2	2	0	1	1	3	3	1	1	3	2	2	1	1	1	0	0.35	0.10	0.00
2023948	2024-03-30 20:30:00	25	3	1.89	3.85	3.45	1.87	4.00	3.80	4	2	2	3	3	5	7	5	7	3	5	3	10	1	3	1	2	1	2	-1	1	1	-0.02	0.15	0.35
2023949	2024-03-30 23:00:00	25	1	2.20	3.35	3.35	2.20	3.35	3.40	0	0	0	0	0	2	0	0	2	2	2	0	2	2	2	1	1	1	3	0	0	1	0.00	0.00	0.05
2023946	2024-03-31 23:30:00	25	1	1.96	3.55	3.45	1.97	3.65	3.75	12	2	12	13	3	11	25	5	23	5	25	7	30	1	3	2	3	1	2	1	1	1	0.01	0.10	0.30
2023944	2024-03-31 04:00:00	25	1	2.59	3.75	2.33	2.63	3.80	2.47	10	3	2	5	4	6	15	7	8	2	10	9	17	1	3	2	3	1	2	1	1	1	0.04	0.05	0.14
2023945	2024-03-31 21:00:00	25	3	1.32	5.60	7.10	1.35	5.60	7.60	2	1	3	2	2	5	4	3	8	4	5	0	8	2	3	1	2	1	3	1	0	1	0.03	0.00	0.50
2023942	2024-03-30 23:00:00	25	3	2.17	3.60	2.94	2.17	3.65	3.15	0	0	1	0	2	1	0	2	2	2	0	0	2	3	1	1	1	2	2	0	1	1	0.00	0.05	0.21
2023943	2024-03-30 23:00:00	25	1	1.24	5.60	10.00	1.28	5.70	11.00	5	1	0	5	3	1	10	4	1	0	6	9	10	1	2	3	3	2	1	1	1	1	0.04	0.10	1.00
2023940	2024-04-04 02:30:00	25	1	2.36	3.55	2.66	2.53	3.65	2.62	1	4	11	6	4	4	7	8	15	9	8	1	16	3	2	1	1	2	3	1	1	-1	0.17	0.10	-0.04
2023941	2024-03-31 01:30:00	25	3	1.66	4.10	4.90	1.64	4.15	5.00	1	1	2	2	2	2	3	3	4	1	1	0	4	2	2	1	1	1	3	-1	1	1	-0.02	0.05	0.10
2023938	2024-04-03 03:15:00	25	1	2.86	3.85	2.13	3.15	4.00	2.06	4	4	10	9	5	5	13	9	15	6	10	4	19	2	3	1	2	1	3	1	1	-1	0.29	0.15	-0.07
2023939	2024-04-03 02:30:00	25	3	2.53	3.45	2.54	2.56	3.55	2.66	5	1	7	6	2	7	11	3	14	5	13	2	16	2	3	1	2	1	3	1	1	1	0.03	0.10	0.12
2023936	2024-04-04 02:30:00	25	3	1.09	10.00	16.00	1.10	11.00	22.00	4	2	10	4	3	12	8	5	22	18	21	4	26	2	3	1	2	1	3	1	1	1	0.01	1.00	6.00
2023937	2024-04-03 02:45:00	25	1	2.87	3.55	2.38	2.47	3.50	2.78	8	1	1	4	1	7	12	2	8	0	10	4	12	1	3	2	3	1	2	-1	-1	1	-0.40	-0.05	0.40
2226689	2024-12-05 03:30:00	25	1	3.75	3.90	1.80	4.20	3.90	1.80	12	2	13	13	1	11	25	3	24	2	24	3	27	1	3	2	3	1	2	1	0	0	0.45	0.00	0.00
2226688	2024-12-06 03:30:00	25	3	2.33	3.60	2.67	2.26	3.60	3.00	7	6	14	7	6	14	14	12	28	16	18	2	30	2	3	1	2	1	3	-1	0	1	-0.07	0.00	0.33
2023996	2024-02-20 04:00:00	25	1	1.70	3.60	4.65	1.70	3.65	5.30	2	2	2	2	2	3	4	4	5	4	4	3	8	2	2	1	1	1	3	0	1	1	0.00	0.05	0.65
2226691	2025-01-02 01:30:00	25	0	6.50	4.60	1.42	6.90	4.80	1.44	14	7	6	8	5	10	22	12	16	2	12	8	24	1	3	2	3	1	2	1	1	1	0.40	0.20	0.02
2226690	2024-12-30 01:15:00	25	0	7.20	5.20	1.34	7.30	5.40	1.37	9	2	6	11	4	6	20	6	12	2	16	10	22	1	3	2	3	1	2	1	1	1	0.10	0.20	0.03
2023992	2024-02-27 04:00:00	25	3	2.42	3.55	2.81	2.44	3.60	2.77	9	0	9	7	2	12	16	2	21	5	19	0	21	2	3	1	2	1	3	1	1	-1	0.02	0.05	-0.04
2023993	2024-02-25 21:30:00	25	3	1.43	4.35	6.70	1.44	4.60	6.90	1	1	2	2	2	2	3	3	4	2	2	1	5	2	2	1	1	1	3	1	1	1	0.01	0.25	0.20
2023990	2024-02-22 03:30:00	25	3	1.22	6.50	8.80	1.25	6.50	10.00	5	7	12	7	8	16	12	15	28	20	17	4	32	3	2	1	1	2	3	1	0	1	0.03	0.00	1.20
2023991	2024-02-24 23:00:00	25	0	1.52	4.25	5.40	1.61	4.25	5.30	0	2	3	3	2	2	3	4	5	4	3	2	7	3	2	1	1	2	3	1	0	-1	0.09	0.00	-0.10
2023988	2024-05-03 02:30:00	25	3	2.31	4.10	2.68	2.33	4.10	2.65	3	1	6	2	2	6	5	3	12	7	9	0	12	2	3	1	2	1	3	1	0	-1	0.02	0.00	-0.03
2023989	2024-02-24 23:00:00	25	3	2.04	3.30	3.50	2.01	3.35	3.90	4	0	1	3	1	4	7	1	5	2	8	4	9	1	3	2	3	1	2	-1	1	1	-0.03	0.05	0.40
2023986	2024-02-25 01:30:00	25	0	6.70	4.85	1.39	7.70	5.20	1.38	11	9	9	14	12	9	25	21	18	6	10	13	31	1	2	3	3	2	1	1	1	-1	1.00	0.35	-0.01
2023987	2024-02-24 23:00:00	25	1	1.90	3.70	3.55	1.89	3.85	3.85	3	1	3	3	1	4	6	2	7	2	6	1	8	2	3	1	2	1	3	-1	1	1	-0.01	0.15	0.30
2023984	2024-02-25 04:00:00	25	3	1.32	5.10	8.00	1.35	5.40	8.00	9	8	19	11	8	14	20	16	33	15	19	2	35	2	3	1	2	1	3	1	1	0	0.03	0.30	0.00
2023985	2024-02-24 23:00:00	25	3	1.56	4.15	4.95	1.56	4.45	5.50	1	2	1	1	2	3	2	4	4	2	0	0	4	3	1	1	1	2	2	0	1	1	0.00	0.30	0.55
2023982	2024-03-05 04:00:00	25	0	12.00	7.20	1.18	17.00	7.50	1.17	1	3	3	3	4	2	4	7	5	5	2	4	9	3	1	2	1	3	2	1	1	-1	5.00	0.30	-0.01
2023983	2024-03-02 23:00:00	25	3	1.48	4.40	6.80	1.50	4.50	6.20	0	0	1	1	1	1	1	1	2	1	1	0	2	2	2	1	1	1	3	1	1	-1	0.02	0.10	-0.60
2023980	2024-03-02 23:00:00	25	3	1.94	3.75	3.35	1.90	3.85	3.75	4	1	4	3	2	5	7	3	9	4	8	2	11	2	3	1	2	1	3	-1	1	1	-0.04	0.10	0.40
2023981	2024-03-02 23:00:00	25	0	5.50	4.35	1.49	6.30	4.60	1.48	2	1	2	3	2	2	5	3	4	0	2	1	5	1	3	2	3	1	2	1	1	-1	0.80	0.25	-0.01
2023978	2024-03-03 01:30:00	25	0	3.95	4.10	1.72	4.65	4.30	1.66	3	2	3	6	5	1	9	7	4	1	3	6	10	1	2	3	3	2	1	1	1	-1	0.70	0.20	-0.06
2023979	2024-03-03 23:30:00	25	3	1.26	5.90	8.50	1.27	6.30	10.00	3	3	12	3	6	10	6	9	22	18	15	2	24	3	2	1	1	2	3	1	1	1	0.01	0.40	1.50
2023976	2024-03-02 23:00:00	25	0	2.09	3.40	3.25	2.11	3.60	3.35	1	1	4	2	2	3	3	3	7	4	4	0	7	2	2	1	1	1	3	1	1	1	0.02	0.20	0.10
2023977	2024-03-02 23:00:00	25	3	2.54	3.45	2.53	2.63	3.70	2.51	1	0	1	3	1	0	4	1	1	0	3	3	4	1	2	2	3	1	1	1	1	-1	0.09	0.25	-0.02
2023974	2024-03-02 23:00:00	25	1	2.88	3.60	2.19	3.10	3.75	2.17	0	0	2	4	1	0	4	1	2	0	3	2	4	1	3	2	3	1	2	1	1	-1	0.22	0.15	-0.02
2023975	2024-03-03 21:00:00	25	0	3.30	3.50	2.04	3.50	3.75	2.01	1	0	3	3	2	0	4	2	3	3	5	4	7	1	3	2	3	1	2	1	1	-1	0.20	0.25	-0.03
2023972	2024-03-10 22:00:00	25	1	1.65	3.90	4.55	1.64	3.95	5.40	1	0	1	0	1	2	1	1	3	3	3	1	4	2	2	1	1	1	3	-1	1	1	-0.01	0.05	0.85
2023973	2024-03-09 23:00:00	25	3	2.49	3.45	2.78	2.49	3.45	2.78	0	0	0	0	1	1	0	1	1	1	0	0	1	3	1	1	1	2	2	0	0	0	0.00	0.00	0.00
2023970	2024-03-10 23:45:00	25	1	2.71	3.75	2.25	2.94	3.75	2.25	2	1	0	3	1	0	5	2	0	0	3	5	5	1	2	3	3	2	1	1	0	0	0.23	0.00	0.00
2023971	2024-03-09 20:30:00	25	3	1.86	3.75	3.65	1.80	3.90	4.20	10	1	3	4	3	8	14	4	11	2	12	5	16	1	3	2	3	1	2	-1	1	1	-0.06	0.15	0.55
2023968	2024-03-09 23:00:00	25	1	1.79	3.70	3.95	1.79	3.80	4.35	0	1	1	0	2	1	0	3	2	4	1	2	4	3	1	2	1	3	2	0	1	1	0.00	0.10	0.40
2024026	2024-02-04 01:30:00	25	0	5.40	4.10	1.61	5.10	4.15	1.63	3	1	1	2	3	2	5	4	3	2	3	4	7	1	2	3	3	2	1	-1	1	1	-0.30	0.05	0.02
2024024	2024-01-31 04:00:00	25	3	1.62	3.80	6.00	1.63	3.75	5.80	2	4	5	3	4	5	5	8	10	6	3	1	11	3	2	1	1	2	3	1	-1	-1	0.01	-0.05	-0.20
2024025	2024-02-01 03:30:00	25	3	1.09	11.00	15.00	1.11	10.00	20.00	3	4	9	5	3	6	8	7	15	11	12	4	19	2	3	1	2	1	3	1	-1	1	0.02	-1.00	5.00
2024022	2024-02-03 23:00:00	25	1	1.39	4.65	6.80	1.44	4.65	7.00	8	7	18	11	7	12	19	14	30	13	18	2	32	2	3	1	2	1	3	1	0	1	0.05	0.00	0.20
2024023	2024-02-01 04:15:00	25	3	1.56	4.40	4.75	1.55	4.60	5.30	11	8	12	12	9	12	23	17	24	5	11	4	28	2	3	1	2	1	3	-1	1	1	-0.01	0.20	0.55
2024020	2024-02-03 20:30:00	25	1	2.76	3.45	2.35	2.94	3.70	2.28	1	0	2	3	1	0	4	1	2	0	3	2	4	1	3	2	3	1	2	1	1	-1	0.18	0.25	-0.07
2024021	2024-02-04 22:00:00	25	3	1.66	3.95	4.50	1.66	4.10	4.90	1	0	5	0	3	5	1	3	10	9	7	0	10	3	2	1	1	2	3	0	1	1	0.00	0.15	0.40
2024018	2024-02-03 23:00:00	25	1	2.88	3.15	2.42	2.96	3.30	2.44	6	2	0	7	2	1	13	4	1	0	9	12	13	1	2	3	3	2	1	1	1	1	0.08	0.15	0.02
2024019	2024-02-04 22:00:00	25	0	1.58	4.15	4.90	1.58	4.30	5.40	4	4	6	5	6	6	9	10	12	3	2	0	12	3	2	1	1	2	3	0	1	1	0.00	0.15	0.50
2024016	2024-02-06 04:00:00	25	0	7.10	4.85	1.37	8.00	5.00	1.37	11	3	5	11	6	4	22	9	9	2	15	15	24	1	2	2	3	1	1	1	1	0	0.90	0.15	0.00
2024017	2024-02-03 23:00:00	25	3	1.70	3.75	4.45	1.78	3.85	4.40	0	3	4	4	1	1	4	4	5	1	1	0	5	2	2	1	1	1	3	1	1	-1	0.08	0.10	-0.05
2024014	2024-02-05 00:30:00	25	3	2.29	3.50	2.78	2.31	3.70	2.88	2	3	5	2	4	6	4	7	11	8	5	1	12	3	2	1	1	2	3	1	1	1	0.02	0.20	0.10
2024015	2024-02-04 22:00:00	25	1	1.72	3.95	4.10	1.72	4.10	4.45	0	0	1	0	2	2	0	2	3	3	1	0	3	3	2	1	1	2	3	0	1	1	0.00	0.15	0.35
2024002	2024-02-18 22:00:00	25	0	4.85	4.15	1.66	4.85	4.15	1.66	0	0	0	1	1	0	1	1	0	0	0	1	1	1	1	3	2	2	1	0	0	0	0.00	0.00	0.00
2024001	2024-02-19 00:30:00	25	0	3.65	4.00	1.80	4.60	4.15	1.69	2	0	8	8	4	1	10	4	9	2	8	3	12	1	3	2	3	1	2	1	1	-1	0.95	0.15	-0.11
2024060	2024-01-14 01:30:00	25	0	4.60	4.10	1.62	5.10	4.20	1.63	3	1	2	4	1	3	7	2	5	1	6	3	8	1	3	2	3	1	2	1	1	1	0.50	0.10	0.01
2024061	2024-01-21 22:00:00	25	1	3.40	3.35	2.20	3.40	3.30	2.20	1	2	0	2	2	0	3	4	0	1	0	4	4	2	1	3	2	3	1	0	-1	0	0.00	-0.05	0.00
2024058	2024-01-14 22:00:00	25	1	2.57	3.50	2.47	2.74	3.55	2.47	2	1	0	4	1	0	6	2	0	0	4	6	6	1	2	3	3	2	1	1	1	0	0.17	0.05	0.00
2024059	2024-01-15 00:30:00	25	1	2.16	3.85	2.79	2.21	3.90	2.93	2	2	7	4	2	7	6	4	14	11	13	3	17	2	3	1	2	1	3	1	1	1	0.05	0.05	0.14
2024056	2024-01-13 03:45:00	25	1	2.03	3.55	3.65	2.04	3.55	3.60	4	1	7	5	2	6	9	3	13	5	11	1	14	2	3	1	2	1	3	1	0	-1	0.01	0.00	-0.05
2024057	2024-01-13 20:30:00	25	3	1.60	4.05	4.85	1.60	4.15	5.40	2	2	1	1	2	3	3	4	4	3	2	2	6	3	1	1	1	2	2	0	1	1	0.00	0.10	0.55
2024054	2024-01-21 01:30:00	25	3	1.84	3.65	3.80	1.80	3.75	4.40	5	2	3	2	3	8	7	5	11	6	8	2	13	2	3	1	2	1	3	-1	1	1	-0.04	0.10	0.60
2024055	2024-01-23 03:45:00	25	1	1.66	4.05	4.30	1.68	4.05	4.80	3	3	7	6	3	3	9	6	10	4	7	3	13	2	3	1	2	1	3	1	0	1	0.02	0.00	0.50
2024052	2024-01-20 20:30:00	25	3	1.27	5.20	10.00	1.26	5.60	12.00	8	5	3	6	7	8	14	12	11	5	7	8	19	1	2	3	3	2	1	-1	1	1	-0.01	0.40	2.00
2024053	2024-01-22 00:30:00	25	0	4.05	4.05	1.71	4.30	4.20	1.73	3	2	3	4	3	3	7	5	6	3	5	4	10	1	3	2	3	1	2	1	1	1	0.25	0.15	0.02
2024048	2024-01-03 03:30:00	25	1	2.31	3.65	2.69	2.47	3.65	2.70	7	3	13	10	3	15	17	6	28	11	22	0	28	2	3	1	2	1	3	1	0	1	0.16	0.00	0.01
2024046	2023-12-31 22:00:00	25	3	1.81	4.10	3.55	1.77	4.35	3.95	4	2	2	1	5	6	5	7	8	7	5	4	12	3	2	1	1	2	3	-1	1	1	-0.04	0.25	0.40
2024047	2023-12-30 23:00:00	25	3	2.57	3.25	2.60	2.61	3.40	2.70	6	0	9	8	2	7	14	2	16	3	15	1	17	2	3	1	2	1	3	1	1	1	0.04	0.15	0.10
2024044	2023-12-30 23:00:00	25	3	1.07	11.00	20.00	1.09	12.00	24.00	4	0	5	4	2	6	8	2	11	5	11	2	13	2	3	1	2	1	3	1	1	1	0.02	1.00	4.00
2024045	2023-12-31 01:30:00	25	3	2.98	3.55	2.17	3.10	3.65	2.20	2	0	1	2	2	2	4	2	3	3	5	4	7	1	3	2	3	1	2	1	1	1	0.12	0.10	0.03
2024042	2024-01-02 04:00:00	25	3	1.46	4.60	5.80	1.44	4.90	6.70	11	8	15	15	10	10	26	18	25	4	12	5	30	1	3	2	3	1	2	-1	1	1	-0.02	0.30	0.90
2024043	2023-12-30 20:30:00	25	0	5.30	4.25	1.52	5.50	4.35	1.57	3	2	1	2	2	3	5	4	4	3	4	4	8	1	2	2	3	1	1	1	1	1	0.20	0.10	0.05
2024040	2023-12-30 23:00:00	25	3	2.31	3.20	2.97	2.20	3.30	3.45	1	2	4	1	3	7	2	5	11	10	7	1	12	3	2	1	1	2	3	-1	1	1	-0.11	0.10	0.48
2024041	2023-12-31 22:00:00	25	3	5.20	4.05	1.56	6.00	4.20	1.55	7	5	11	12	7	6	19	12	17	3	10	5	22	1	3	2	3	1	2	1	1	-1	0.80	0.15	-0.01
2024038	2024-01-31 04:15:00	25	0	1.96	3.85	3.25	1.89	3.95	3.75	16	4	12	15	6	14	31	10	26	7	28	12	38	1	3	2	3	1	2	-1	1	1	-0.07	0.10	0.50
2024039	2023-12-30 23:00:00	25	3	1.39	4.70	6.80	1.43	4.70	7.30	0	3	4	3	1	1	3	4	5	2	1	0	5	3	2	1	1	2	3	1	0	1	0.04	0.00	0.50
2024036	2024-02-02 03:30:00	25	1	2.35	3.60	2.65	2.42	3.70	2.72	6	2	10	7	3	10	13	5	20	9	17	2	22	2	3	1	2	1	3	1	1	1	0.07	0.10	0.07
2024037	2024-01-31 03:45:00	25	1	2.42	3.25	2.78	2.47	3.25	2.96	1	2	6	2	1	8	3	3	14	11	11	0	14	2	2	1	1	1	3	1	0	1	0.05	0.00	0.18
2024034	2024-02-02 04:15:00	25	0	2.64	3.45	2.44	2.66	3.55	2.56	19	2	20	23	4	16	42	6	36	2	38	8	44	1	3	2	3	1	2	1	1	1	0.02	0.10	0.12
2024035	2024-01-31 03:30:00	25	0	7.30	4.65	1.38	8.50	4.95	1.37	11	3	8	15	8	6	26	11	14	1	16	13	27	1	3	2	3	1	2	1	1	-1	1.20	0.30	-0.01
2024032	2024-01-31 03:45:00	25	3	4.70	4.00	1.70	4.25	3.90	1.79	4	3	1	2	2	5	6	5	6	1	2	1	7	1	3	1	2	1	2	-1	-1	1	-0.45	-0.10	0.09
2024033	2024-02-01 03:30:00	25	3	1.65	4.10	4.35	1.68	4.25	4.55	2	1	4	3	2	4	5	3	8	4	6	1	9	2	3	1	2	1	3	1	1	1	0.03	0.15	0.20
2026308	2023-08-20 00:30:00	25	3	2.87	3.80	2.28	2.78	3.80	2.35	2	0	1	1	1	2	3	1	3	0	2	0	3	1	3	1	2	1	2	-1	0	1	-0.09	0.00	0.07
2079647	2023-12-26 20:30:00	25	0	1.44	4.35	6.50	1.47	4.45	6.90	0	1	1	1	2	2	1	3	3	2	0	0	3	3	1	1	1	2	2	1	1	1	0.03	0.10	0.40
2079646	2024-05-05 00:30:00	25	3	1.11	8.90	15.00	1.10	11.00	21.00	5	4	6	5	4	5	10	8	11	8	10	7	18	2	3	1	2	1	3	-1	1	1	-0.01	2.10	6.00
2079645	2023-09-30 22:00:00	25	0	5.40	4.15	1.52	5.70	4.20	1.57	1	1	0	1	1	2	2	2	2	0	0	0	2	1	1	1	1	1	1	1	1	1	0.30	0.05	0.05
2079644	2023-09-23 22:00:00	25	3	1.13	7.50	16.00	1.15	7.80	17.00	2	2	1	2	2	3	4	4	4	2	2	2	6	1	1	1	1	1	1	1	1	1	0.02	0.30	1.00
2079643	2024-05-05 21:00:00	25	3	2.62	3.65	2.35	2.79	3.75	2.35	2	1	0	2	2	0	4	3	0	0	1	4	4	1	2	3	3	2	1	1	1	0	0.17	0.10	0.00
2079642	2023-09-24 21:00:00	25	0	1.82	3.90	3.65	1.87	3.95	3.80	2	2	4	5	3	2	7	5	6	1	3	2	8	1	3	2	3	1	2	1	1	1	0.05	0.05	0.15
2079641	2024-05-04 19:30:00	25	3	1.21	6.40	9.50	1.21	7.10	11.00	11	11	15	12	8	15	23	19	30	13	17	6	36	2	3	1	2	1	3	0	1	1	0.00	0.70	1.50
2079640	2024-02-21 03:30:00	25	3	1.17	7.10	12.00	1.18	7.20	15.00	5	11	6	6	13	7	11	24	13	17	4	15	28	3	1	2	1	3	2	1	1	1	0.01	0.10	3.00
2079639	2023-12-24 01:30:00	25	1	2.40	3.55	2.63	2.42	3.65	2.77	12	4	14	11	5	15	23	9	29	8	22	2	31	2	3	1	2	1	3	1	1	1	0.02	0.10	0.14
2079638	2023-12-23 04:00:00	25	1	1.18	6.40	12.00	1.25	6.10	11.00	8	14	9	11	12	6	19	26	15	18	11	22	37	2	1	3	2	3	1	1	-1	-1	0.07	-0.30	-1.00
2080735	2023-09-24 21:00:00	25	3	1.40	4.90	6.30	1.41	5.30	6.60	0	1	1	2	1	1	2	2	2	0	0	0	2	1	1	1	1	1	1	1	1	1	0.01	0.40	0.30
2080734	2024-05-05 23:30:00	25	3	1.42	4.95	5.60	1.44	5.40	5.90	5	6	8	8	6	8	13	12	16	9	10	6	22	2	3	1	2	1	3	1	1	1	0.02	0.45	0.30
2080733	2023-12-23 20:30:00	25	3	2.45	3.55	2.56	2.72	3.70	2.42	5	0	7	8	2	4	13	2	11	0	11	2	13	1	3	2	3	1	2	1	1	-1	0.27	0.15	-0.14
2080732	2023-12-23 23:00:00	25	3	1.80	3.90	3.75	1.79	4.00	4.15	1	1	1	0	2	3	1	3	4	4	2	1	5	3	2	1	1	2	3	-1	1	1	-0.01	0.10	0.40
2080731	2023-12-26 23:00:00	25	0	2.36	3.15	2.93	2.36	3.25	3.15	0	2	1	0	2	3	0	4	4	5	1	1	5	3	1	1	1	2	2	0	1	1	0.00	0.10	0.22
2080730	2023-12-23 23:00:00	25	0	2.71	3.35	2.42	2.74	3.45	2.53	4	1	5	6	2	4	10	3	9	0	7	1	10	1	3	2	3	1	2	1	1	1	0.03	0.10	0.11
2080763	2024-05-04 22:00:00	25	0	3.10	3.80	2.01	3.35	4.10	1.97	0	0	4	3	1	1	3	1	5	3	5	1	6	2	3	1	2	1	3	1	1	-1	0.25	0.30	-0.04
2080762	2023-09-24 03:00:00	25	0	4.80	4.05	1.68	4.45	4.00	1.74	4	3	3	4	4	3	8	7	6	0	1	2	8	1	2	3	3	2	1	-1	-1	1	-0.35	-0.05	0.06
2080761	2024-05-07 03:00:00	25	3	2.23	3.65	2.79	2.25	3.85	2.89	14	2	13	10	4	18	24	6	31	7	25	0	31	2	3	1	2	1	3	1	1	1	0.02	0.20	0.10
2080760	2024-05-04 03:00:00	25	1	2.49	3.55	2.53	2.61	3.55	2.59	10	3	12	11	3	15	21	6	27	7	22	1	28	2	3	1	2	1	3	1	0	1	0.12	0.00	0.06
2080758	2023-12-08 03:30:00	25	3	2.90	3.45	2.25	3.10	3.50	2.28	8	9	8	10	8	9	18	17	17	14	15	15	32	1	2	2	3	1	1	1	1	1	0.20	0.05	0.03
2080757	2023-12-23 23:00:00	25	3	4.75	4.00	1.61	5.40	4.10	1.61	0	0	1	3	2	0	3	2	1	0	1	2	3	1	2	3	3	2	1	1	1	0	0.65	0.10	0.00
2080756	2024-05-04 22:00:00	25	1	2.11	3.65	3.00	2.11	3.80	3.20	0	6	7	0	8	7	0	14	14	14	0	0	14	3	1	1	1	2	2	0	1	1	0.00	0.15	0.20
2080755	2023-12-23 23:00:00	25	0	1.68	3.75	4.60	1.68	3.80	5.20	0	1	1	0	1	3	0	2	4	5	3	1	5	3	2	1	1	2	3	0	1	1	0.00	0.05	0.60
2080754	2023-12-22 04:00:00	25	1	3.40	3.50	2.14	3.15	3.45	2.26	7	3	1	6	3	5	13	6	6	3	10	10	16	1	2	2	3	1	1	-1	-1	1	-0.25	-0.05	0.12
2080737	2024-05-04 22:00:00	25	0	4.15	4.05	1.68	4.70	4.25	1.66	6	4	5	8	6	4	14	10	9	1	5	6	15	1	2	3	3	2	1	1	1	-1	0.55	0.20	-0.02
2080736	2024-05-05 21:00:00	25	3	1.58	4.40	4.50	1.60	4.70	4.70	3	0	3	2	2	4	5	2	7	3	6	1	8	2	3	1	2	1	3	1	1	1	0.02	0.30	0.20
2230305	2024-09-29 21:00:00	26	0	2.33	3.35	2.68	2.50	3.60	2.69	2	3	6	5	4	4	7	7	10	4	4	1	11	2	2	1	1	1	3	1	1	1	0.17	0.25	0.01
2230314	2024-10-07 02:45:00	26	1	4.45	3.85	1.68	4.90	4.10	1.66	2	0	3	4	2	1	6	2	4	0	4	2	6	1	3	2	3	1	2	1	1	-1	0.45	0.25	-0.02
2230319	2024-10-06 03:00:00	26	0	2.66	3.55	2.37	2.73	3.55	2.49	4	4	6	8	2	7	12	6	13	2	8	1	14	2	3	1	2	1	3	1	0	1	0.07	0.00	0.12
2230331	2024-10-19 02:45:00	26	1	1.93	3.70	3.45	1.96	3.75	3.65	10	5	11	14	5	10	24	10	21	9	23	12	33	1	3	2	3	1	2	1	1	1	0.03	0.05	0.20
2230278	2024-09-23 02:45:00	26	0	2.96	3.75	2.25	2.83	3.60	2.38	5	5	0	7	3	2	12	8	2	0	4	10	12	1	2	3	3	2	1	-1	-1	1	-0.13	-0.15	0.13
2230276	2024-09-21 23:00:00	26	1	1.70	3.70	4.15	1.70	3.85	5.00	1	0	0	0	2	2	1	2	2	2	1	1	3	3	1	1	1	2	2	0	1	1	0.00	0.15	0.85
2230280	2024-09-22 21:00:00	26	3	1.37	4.75	6.30	1.36	5.00	8.70	2	1	1	2	3	3	4	4	4	0	0	0	4	1	1	1	1	1	1	-1	1	1	-0.01	0.25	2.40
2230288	2024-09-21 02:45:00	26	3	1.60	3.80	4.75	1.57	4.05	5.90	6	3	4	5	5	6	11	8	10	0	3	1	11	1	3	2	3	1	2	-1	1	1	-0.03	0.25	1.15
2230297	2024-09-29 03:00:00	26	3	1.32	5.00	7.20	1.33	5.50	8.40	6	3	12	6	7	11	12	10	23	11	13	0	23	2	3	1	2	1	3	1	1	1	0.01	0.50	1.20
2230300	2024-09-28 03:00:00	26	3	1.38	5.00	5.70	1.40	4.95	7.20	12	8	12	10	8	20	22	16	32	16	22	6	38	2	3	1	2	1	3	1	-1	1	0.02	-0.05	1.50
2230371	2024-11-03 00:00:00	26	3	1.40	4.65	6.80	1.41	4.80	7.40	2	1	1	2	3	3	4	4	4	1	1	1	5	1	1	1	1	1	1	1	1	1	0.01	0.15	0.60
2230385	2024-11-09 03:45:00	26	0	1.38	4.70	6.30	1.43	4.90	6.80	10	9	18	13	10	14	23	19	32	11	15	2	34	2	3	1	2	1	3	1	1	1	0.05	0.20	0.50
2230390	2024-11-10 22:00:00	26	1	2.53	3.30	2.84	2.47	3.30	2.92	1	0	0	0	1	2	1	1	2	1	1	0	2	2	2	1	1	1	3	-1	0	1	-0.06	0.00	0.08
2230395	2024-11-25 00:00:00	26	3	1.81	3.65	3.65	1.80	3.70	4.45	1	0	2	0	2	3	1	2	5	4	3	0	5	3	2	1	1	2	3	-1	1	1	-0.01	0.05	0.80
2230392	2024-11-10 00:00:00	26	0	3.05	3.55	2.04	3.30	3.75	2.07	2	0	3	2	1	3	4	1	6	3	6	1	7	2	3	1	2	1	3	1	1	1	0.25	0.20	0.03
2230399	2024-11-24 22:00:00	26	3	1.89	3.45	3.55	1.89	3.60	4.10	3	1	2	2	3	3	5	4	5	2	3	2	7	1	3	1	2	1	2	0	1	1	0.00	0.15	0.55
2230397	2024-11-24 00:00:00	26	0	2.31	3.40	2.67	2.31	3.60	2.95	0	1	0	0	1	2	0	2	2	2	0	0	2	3	1	1	1	2	2	0	1	1	0.00	0.20	0.28
2230337	2024-10-20 03:00:00	26	3	1.29	5.70	9.70	1.25	6.20	11.00	6	2	3	3	5	6	9	7	9	3	5	3	12	1	3	1	2	1	2	-1	1	1	-0.04	0.50	1.30
2230344	2024-10-27 03:00:00	26	0	2.28	3.30	2.78	2.26	3.40	3.20	1	4	5	2	4	5	3	8	10	7	2	0	10	3	2	1	1	2	3	-1	1	1	-0.02	0.10	0.42
2230348	2024-10-28 03:45:00	26	0	3.55	3.80	1.81	3.80	4.00	1.87	11	4	5	7	3	11	18	7	16	2	13	4	20	1	3	2	3	1	2	1	1	1	0.25	0.20	0.06
2230366	2024-11-02 04:00:00	26	1	2.16	3.70	2.88	2.14	3.80	3.15	6	0	5	5	2	7	11	2	12	1	10	0	12	2	3	1	2	1	3	-1	1	1	-0.02	0.10	0.27
2035359	2023-08-13 03:00:00	26	1	1.38	4.75	6.80	1.36	5.10	8.00	13	11	13	13	12	15	26	23	28	4	7	2	30	2	3	1	2	1	3	-1	1	1	-0.02	0.35	1.20
2230434	2024-12-08 00:00:00	26	3	1.72	4.00	4.60	1.73	3.95	4.55	0	1	1	1	1	2	1	2	3	2	1	0	3	3	2	1	1	2	3	1	-1	-1	0.01	-0.05	-0.05
2035358	2023-08-12 03:00:00	26	1	2.60	3.35	2.51	2.64	3.45	2.61	5	2	2	3	2	5	8	4	7	0	4	1	8	1	3	2	3	1	2	1	1	1	0.04	0.10	0.10
2230432	2024-12-07 02:00:00	26	3	1.68	3.60	4.85	1.81	3.60	4.50	6	7	8	6	7	8	12	14	16	7	5	3	19	3	2	1	1	2	3	1	0	-1	0.13	0.00	-0.35
2230433	2024-12-02 00:00:00	26	3	1.70	3.95	4.80	1.70	3.95	4.80	0	0	0	0	1	1	0	1	1	1	0	0	1	3	1	1	1	2	2	0	0	0	0.00	0.00	0.00
2035355	2023-08-12 23:00:00	26	3	1.68	3.95	4.95	1.68	3.95	4.95	0	0	0	0	1	1	0	1	1	1	0	0	1	3	1	1	1	2	2	0	0	0	0.00	0.00	0.00
2035354	2023-08-13 21:00:00	26	0	3.15	3.55	2.09	3.05	3.55	2.14	4	1	2	2	1	4	6	2	6	0	4	0	6	1	3	1	2	1	2	-1	0	1	-0.10	0.00	0.05
2230439	2024-12-08 02:00:00	26	3	1.59	3.70	5.50	1.59	3.95	6.00	3	4	6	5	5	6	8	9	12	6	5	2	14	3	2	1	1	2	3	0	1	1	0.00	0.25	0.50
2035353	2023-08-13 19:00:00	26	3	3.50	3.35	2.02	3.45	3.35	2.03	1	0	1	1	0	1	2	0	2	0	2	0	2	1	3	1	2	1	2	-1	0	1	-0.05	0.00	0.01
2230442	2024-12-09 03:45:00	26	0	4.70	3.90	1.64	5.70	4.10	1.58	5	10	6	11	9	3	16	19	9	11	8	18	27	2	1	3	2	3	1	1	1	-1	1.00	0.20	-0.06
2230441	2024-12-09 00:00:00	26	3	2.88	3.15	2.42	3.25	3.15	2.35	2	4	1	6	3	0	8	7	1	1	2	8	9	1	2	3	3	2	1	1	0	-1	0.37	0.00	-0.07
2230446	2024-12-15 02:00:00	26	1	3.40	3.55	1.99	4.40	3.60	1.83	10	6	9	10	6	11	20	12	20	3	11	3	23	1	3	1	2	1	2	1	1	-1	1.00	0.05	-0.16
2230448	2024-12-07 04:00:00	26	1	7.80	4.80	1.35	7.80	5.70	1.34	18	10	15	19	12	14	37	22	29	3	18	11	40	1	3	2	3	1	2	0	1	-1	0.00	0.90	-0.01
2230449	2024-12-16 00:00:00	26	0	2.72	3.25	2.47	3.00	3.00	2.47	2	1	0	2	0	0	4	1	0	0	3	4	4	1	2	3	3	2	1	1	-1	0	0.28	-0.25	0.00
2230454	2024-12-15 00:00:00	26	1	2.19	3.50	2.95	2.19	3.40	3.30	1	4	4	1	2	7	2	6	11	11	7	2	13	3	2	1	1	2	3	0	-1	1	0.00	-0.10	0.35
2230455	2024-12-09 00:00:00	26	1	2.36	3.55	2.90	2.38	3.50	2.89	0	2	4	1	2	4	1	4	8	7	4	0	8	3	2	1	1	2	3	1	-1	-1	0.02	-0.05	-0.01
2230453	2024-12-15 22:00:00	26	1	3.05	3.55	2.28	3.05	3.55	2.28	0	1	0	1	0	0	1	1	0	0	0	1	1	1	1	3	2	2	1	0	0	0	0.00	0.00	0.00
2230458	2024-12-16 00:00:00	26	3	2.13	3.30	3.25	2.23	3.15	3.50	4	1	7	9	0	4	13	1	11	1	13	3	14	1	3	2	3	1	2	1	-1	1	0.10	-0.15	0.25
2230459	2024-12-16 00:00:00	26	3	1.54	3.95	5.70	1.62	3.95	5.70	1	0	1	2	0	2	3	0	3	0	3	0	3	1	3	1	2	1	2	1	0	0	0.08	0.00	0.00
2230463	2025-01-05 22:00:00	26	3	3.30	3.20	2.29	3.30	3.20	2.29	0	0	0	1	1	0	1	1	0	0	0	1	1	1	1	3	2	2	1	0	0	0	0.00	0.00	0.00
2230461	2024-12-14 03:45:00	26	3	1.42	4.55	6.60	1.40	4.70	8.30	16	14	17	12	18	26	28	32	43	24	20	9	52	3	2	1	1	2	3	-1	1	1	-0.02	0.15	1.70
2230402	2024-11-25 00:00:00	26	0	1.86	3.30	3.90	1.86	3.30	4.75	2	4	3	2	4	5	4	8	8	12	8	8	16	3	1	1	1	2	2	0	0	1	0.00	0.00	0.85
2035390	2023-12-10 04:00:00	26	3	1.21	6.30	10.00	1.25	6.30	10.00	8	12	8	10	11	6	18	23	14	14	9	18	32	2	1	3	2	3	1	1	0	0	0.04	0.00	0.00
2035389	2023-12-18 03:45:00	26	1	3.50	3.65	1.84	3.45	3.85	2.01	22	9	12	13	10	22	35	19	34	15	31	16	50	1	3	2	3	1	2	-1	1	1	-0.05	0.20	0.17
2230400	2024-11-23 02:00:00	26	3	1.48	4.20	5.50	1.50	4.40	6.30	1	5	3	3	5	2	4	10	5	6	0	5	10	3	1	2	1	3	2	1	1	1	0.02	0.20	0.80
2035387	2023-12-03 20:00:00	26	0	8.10	5.40	1.27	9.80	5.80	1.29	2	1	1	3	2	2	5	3	3	1	3	3	6	1	2	2	3	1	1	1	1	1	1.70	0.40	0.02
2230407	2024-11-23 04:00:00	26	3	1.32	4.90	7.30	1.35	5.30	8.40	4	4	4	5	5	8	9	9	12	3	3	0	12	2	2	1	1	1	3	1	1	1	0.03	0.40	1.10
2035385	2023-11-25 04:00:00	26	3	1.45	4.40	5.50	1.47	4.80	6.10	5	9	10	9	8	9	14	17	19	9	6	4	23	3	2	1	1	2	3	1	1	1	0.02	0.40	0.60
2035384	2023-11-12 00:00:00	26	0	4.60	4.35	1.53	5.80	4.40	1.54	1	1	0	3	2	1	4	3	1	0	1	3	4	1	2	3	3	2	1	1	1	1	1.20	0.05	0.01
2230405	2024-11-25 03:45:00	26	3	1.82	3.70	4.35	1.83	3.75	4.25	5	2	5	4	3	8	9	5	13	5	9	1	14	2	3	1	2	1	3	1	1	-1	0.01	0.05	-0.10
2035383	2023-11-26 22:00:00	26	0	2.25	3.25	2.86	2.25	3.45	3.15	1	0	0	0	1	2	1	1	2	1	1	0	2	2	2	1	1	1	3	0	1	1	0.00	0.20	0.29
2035382	2023-12-08 03:30:00	26	1	1.79	3.60	4.70	1.78	3.60	4.80	7	3	6	4	4	11	11	7	17	7	11	1	18	2	3	1	2	1	3	-1	0	1	-0.01	0.00	0.10
2230411	2024-11-24 02:00:00	26	3	2.33	3.65	2.88	2.36	3.60	2.88	0	1	3	1	2	4	1	3	7	6	4	0	7	3	2	1	1	2	3	1	-1	0	0.03	-0.05	0.00
2035381	2023-11-04 04:00:00	26	3	1.26	6.00	8.70	1.24	6.70	11.00	12	8	8	10	13	11	22	21	19	7	8	10	29	1	2	3	3	2	1	-1	1	1	-0.02	0.70	2.30
2035378	2023-10-21 23:00:00	26	3	1.22	6.40	9.40	1.22	6.60	12.00	5	1	1	3	6	4	8	7	5	2	3	5	10	1	2	3	3	2	1	0	1	1	0.00	0.20	2.60
2035377	2023-10-22 21:00:00	26	3	1.82	3.55	4.00	1.82	3.65	4.40	0	1	0	0	1	2	0	2	2	2	0	0	2	3	1	1	1	2	2	0	1	1	0.00	0.10	0.40
2035376	2023-10-09 02:45:00	26	0	3.20	3.40	2.04	3.50	3.70	2.02	3	2	6	4	4	3	7	6	9	3	4	1	10	2	3	1	2	1	3	1	1	-1	0.30	0.30	-0.02
2230413	2024-12-01 02:00:00	26	3	2.20	3.50	2.77	2.21	3.45	3.25	2	3	5	5	2	5	7	5	10	4	6	1	11	2	3	1	2	1	3	1	-1	1	0.01	-0.05	0.48
2230418	2024-12-02 00:00:00	26	0	2.33	3.15	2.84	2.33	3.25	3.20	3	0	3	3	1	4	6	1	7	1	6	0	7	2	3	1	2	1	3	0	1	1	0.00	0.10	0.36
2035373	2023-09-30 23:00:00	26	1	6.60	4.35	1.40	7.10	4.55	1.45	5	4	4	5	3	5	10	7	9	0	3	1	10	1	3	2	3	1	2	1	1	1	0.50	0.20	0.05
2035371	2023-09-25 02:45:00	26	3	1.59	4.05	4.45	1.60	4.40	5.10	1	1	1	1	2	2	2	3	3	1	0	0	3	3	1	1	1	2	2	1	1	1	0.01	0.35	0.65
2230422	2024-12-01 04:00:00	26	1	1.19	6.70	9.50	1.21	6.60	14.00	2	5	1	3	5	4	5	10	5	7	2	7	12	2	1	2	1	3	1	1	-1	1	0.02	-0.10	4.50
2035370	2023-09-16 03:00:00	26	0	1.50	4.65	5.90	1.49	4.65	6.00	5	5	5	5	7	7	10	12	12	5	3	3	15	3	1	1	1	2	2	-1	0	1	-0.01	0.00	0.10
2230420	2024-12-01 22:00:00	26	1	3.50	3.70	1.84	4.00	3.80	1.87	6	2	2	5	2	4	11	4	6	2	9	7	13	1	3	2	3	1	2	1	1	1	0.50	0.10	0.03
2035368	2023-09-04 02:45:00	26	0	5.70	4.70	1.51	5.60	4.65	1.53	1	1	0	1	1	2	2	2	2	0	0	0	2	1	1	1	1	1	1	-1	-1	1	-0.10	-0.05	0.02
2230421	2024-12-02 03:45:00	26	3	2.47	3.55	2.42	2.67	3.50	2.57	1	4	4	8	2	6	9	6	10	1	4	0	10	2	3	1	2	1	3	1	-1	1	0.20	-0.05	0.15
2035366	2023-08-27 03:00:00	26	3	1.60	4.25	5.30	1.62	4.20	5.10	3	1	2	3	2	3	6	3	5	1	4	2	7	1	3	2	3	1	2	1	-1	-1	0.02	-0.05	-0.20
2035364	2023-08-20 03:00:00	26	1	4.45	3.95	1.66	5.40	4.30	1.58	2	1	5	6	6	1	8	7	6	0	1	2	8	1	2	3	3	2	1	1	1	-1	0.95	0.35	-0.08
2230425	2024-12-01 00:00:00	26	3	1.48	4.35	4.95	1.50	4.40	6.40	5	5	5	5	5	8	10	10	13	5	5	2	15	2	2	1	1	1	3	1	1	1	0.02	0.05	1.45
2230430	2024-12-08 22:00:00	26	3	1.33	4.85	8.20	1.37	5.10	8.30	1	3	5	3	2	6	4	5	11	7	6	0	11	3	2	1	1	2	3	1	1	1	0.04	0.25	0.10
2230428	2024-11-30 03:45:00	26	0	2.74	3.35	2.29	2.99	3.35	2.40	8	1	3	8	1	3	16	2	6	0	14	10	16	1	3	2	3	1	2	1	0	1	0.25	0.00	0.11
2230498	2025-01-13 00:15:00	26	0	1.81	3.65	3.95	1.77	3.60	4.85	2	2	3	2	3	3	4	5	6	3	2	1	7	3	2	1	1	2	3	-1	-1	1	-0.04	-0.05	0.90
2035422	2023-08-20 21:00:00	26	3	1.85	3.60	3.80	1.87	3.55	3.75	1	2	1	1	0	1	2	2	2	0	0	0	2	1	1	1	1	1	1	1	-1	-1	0.02	-0.05	-0.05
2035421	2024-05-20 03:00:00	26	0	4.55	4.40	1.57	5.40	4.55	1.57	6	4	9	10	7	7	16	11	16	6	11	6	22	1	3	1	2	1	2	1	1	0	0.85	0.15	0.00
2230496	2025-01-12 04:00:00	26	0	3.10	3.25	2.38	3.20	3.20	2.35	2	3	1	4	2	1	6	5	2	3	4	7	9	1	2	3	3	2	1	1	-1	-1	0.10	-0.05	-0.03
2035420	2024-05-13 03:00:00	26	0	1.31	5.10	7.00	1.40	5.10	7.30	6	6	12	9	5	12	15	11	24	9	13	0	24	2	3	1	2	1	3	1	0	1	0.09	0.00	0.30
2035419	2024-05-16 03:00:00	26	0	2.23	3.55	2.86	2.36	3.65	2.85	5	2	8	8	3	8	13	5	16	6	14	3	19	2	3	1	2	1	3	1	1	-1	0.13	0.10	-0.01
2035418	2024-04-28 03:00:00	26	1	1.27	5.00	8.90	1.32	5.60	8.70	7	4	12	7	7	12	14	11	24	12	15	2	26	2	3	1	2	1	3	1	1	-1	0.05	0.60	-0.20
2035417	2024-04-22 03:00:00	26	3	1.47	4.40	5.10	1.49	4.80	5.90	5	3	7	6	2	7	11	5	14	7	13	4	18	2	3	1	2	1	3	1	1	1	0.02	0.40	0.80
2230500	2025-01-12 02:00:00	26	0	2.53	3.40	2.55	2.74	3.40	2.55	4	2	7	5	2	6	9	4	13	8	13	4	17	2	3	1	2	1	3	1	0	0	0.21	0.00	0.00
2035415	2024-04-25 01:00:00	26	0	6.10	5.00	1.37	7.00	5.00	1.41	6	4	3	5	5	5	11	9	8	1	3	4	12	1	2	3	3	2	1	1	0	1	0.90	0.00	0.04
2035414	2024-04-07 03:00:00	26	1	1.17	6.90	13.00	1.20	6.80	14.00	2	5	2	3	2	4	5	7	6	5	3	4	10	3	1	2	1	3	2	1	-1	1	0.03	-0.10	1.00
2035413	2024-04-07 19:00:00	26	3	1.51	3.80	6.30	1.49	3.90	6.60	2	0	1	0	2	2	2	2	3	2	2	1	4	2	2	1	1	1	3	-1	1	1	-0.02	0.10	0.30
2230504	2025-01-18 04:05:00	26	3	2.00	3.50	3.80	2.06	3.35	3.75	7	6	11	12	4	11	19	10	22	13	22	10	32	2	3	1	2	1	3	1	-1	-1	0.06	-0.15	-0.05
2035412	2024-04-01 02:45:00	26	0	2.86	3.60	2.11	3.40	3.65	2.08	9	5	9	10	5	9	19	10	18	8	17	9	27	1	3	2	3	1	2	1	1	-1	0.54	0.05	-0.03
2230505	2025-01-19 00:00:00	26	0	3.65	3.85	1.77	4.50	4.20	1.70	3	1	1	5	5	0	8	6	1	4	6	11	12	1	2	3	3	2	1	1	1	-1	0.85	0.35	-0.07
2035410	2024-03-18 03:45:00	26	0	5.50	4.40	1.56	5.60	4.45	1.54	1	1	1	2	2	1	3	3	2	0	0	1	3	1	1	3	2	2	1	1	1	-1	0.10	0.05	-0.02
2035409	2024-03-17 20:00:00	26	1	2.36	3.05	2.87	2.47	3.15	3.05	3	0	1	2	1	4	5	1	5	0	4	0	5	1	3	1	2	1	2	1	1	1	0.11	0.10	0.18
2035408	2024-03-10 20:00:00	26	1	1.42	4.70	6.10	1.40	4.80	6.40	2	1	0	0	1	4	2	2	4	2	2	0	4	2	2	1	1	1	3	-1	1	1	-0.02	0.10	0.30
2230509	2025-01-20 03:45:00	26	1	1.57	4.30	5.50	1.61	4.25	5.10	7	7	13	8	7	13	15	14	26	16	17	5	31	2	3	1	2	1	3	1	-1	-1	0.04	-0.05	-0.40
2035406	2024-03-02 04:00:00	26	1	3.05	3.75	2.06	3.30	3.80	2.07	3	4	5	4	4	5	7	8	10	9	8	6	16	3	2	1	1	2	3	1	1	1	0.25	0.05	0.01
2035403	2024-02-26 00:05:00	26	1	1.44	4.40	6.50	1.45	4.60	6.90	3	3	4	4	4	6	7	7	10	6	6	3	13	2	2	1	1	1	3	1	1	1	0.01	0.20	0.40
2035401	2024-02-19 03:45:00	26	3	2.39	3.20	2.85	2.45	3.25	2.99	6	4	6	6	4	10	12	8	16	8	12	4	20	2	3	1	2	1	3	1	1	1	0.06	0.05	0.14
2230517	2025-01-19 22:00:00	26	1	2.44	3.10	2.71	2.73	3.25	2.67	8	1	10	13	1	9	21	2	19	3	22	5	24	1	3	2	3	1	2	1	1	-1	0.29	0.15	-0.04
2035398	2024-02-03 04:00:00	26	0	6.00	4.50	1.45	5.60	4.45	1.54	11	5	2	8	6	5	19	11	7	0	8	12	19	1	2	3	3	2	1	-1	-1	1	-0.40	-0.05	0.09
2035397	2024-02-05 00:05:00	26	1	2.44	3.20	3.05	2.47	3.15	3.05	1	1	1	1	1	2	2	2	3	2	2	1	4	2	2	1	1	1	3	1	-1	0	0.03	-0.05	0.00
2230520	2025-01-25 03:45:00	26	1	2.01	3.55	3.30	1.96	3.55	3.85	9	6	10	11	5	11	20	11	21	6	15	5	26	2	3	1	2	1	3	-1	0	1	-0.05	0.00	0.55
2035396	2024-01-29 03:45:00	26	1	1.36	4.90	7.00	1.40	4.95	7.70	4	5	10	8	5	8	12	10	18	9	11	3	21	2	3	1	2	1	3	1	1	1	0.04	0.05	0.70
2035395	2024-01-15 03:45:00	26	0	3.30	3.65	1.90	3.50	3.80	2.00	7	5	8	6	5	10	13	10	18	8	11	3	21	2	3	1	2	1	3	1	1	1	0.20	0.15	0.10
2035392	2023-12-21 04:00:00	26	3	1.14	7.60	12.00	1.17	7.50	15.00	12	22	12	14	16	11	26	38	23	23	11	26	49	2	1	3	2	3	1	1	-1	1	0.03	-0.10	3.00
2230525	2025-01-27 03:45:00	26	3	2.71	3.60	2.31	2.61	3.45	2.66	18	8	5	19	6	11	37	14	16	1	24	22	38	1	3	2	3	1	2	-1	-1	1	-0.10	-0.15	0.35
2230465	2025-01-05 02:00:00	26	1	1.50	3.85	6.50	1.50	4.25	6.80	2	3	4	2	5	4	4	8	8	4	0	0	8	3	1	1	1	2	2	0	1	1	0.00	0.40	0.30
2230470	2025-01-06 03:45:00	26	3	1.31	5.40	9.90	1.32	5.20	9.90	10	9	16	12	8	15	22	17	31	15	20	6	37	2	3	1	2	1	3	1	-1	0	0.01	-0.20	0.00
2035449	2023-10-08 19:00:00	26	3	1.42	4.30	6.30	1.40	4.40	6.50	2	0	0	0	2	2	2	2	2	0	0	0	2	1	1	1	1	1	1	-1	1	1	-0.02	0.10	0.20
2035447	2023-09-30 03:00:00	26	0	2.89	3.20	2.26	3.05	3.40	2.36	5	1	4	4	3	5	9	4	9	4	9	4	13	1	3	1	2	1	2	1	1	1	0.16	0.20	0.10
2230474	2025-01-04 04:00:00	26	3	2.28	3.45	2.86	2.13	3.30	3.60	6	4	5	5	3	9	11	7	14	5	9	2	16	2	3	1	2	1	3	-1	-1	1	-0.15	-0.15	0.74
2230475	2025-01-05 22:00:00	26	0	2.02	3.15	3.70	2.07	3.25	3.85	3	1	5	7	1	4	10	2	9	1	9	2	11	1	3	2	3	1	2	1	1	1	0.05	0.10	0.15
2230472	2024-12-15 04:00:00	26	1	3.30	3.55	2.03	3.45	3.55	2.08	6	3	2	4	2	7	10	5	9	6	11	7	16	1	3	2	3	1	2	1	0	1	0.15	0.00	0.05
2230473	2024-12-19 04:00:00	26	0	3.55	3.75	1.88	3.85	3.80	1.89	18	10	18	19	9	22	37	19	40	11	29	8	48	2	3	1	2	1	3	1	1	1	0.30	0.05	0.01
2035442	2023-09-27 03:00:00	26	0	1.95	3.55	3.90	1.99	3.55	3.75	9	3	11	8	4	10	17	7	21	7	17	3	24	2	3	1	2	1	3	1	0	-1	0.04	0.00	-0.15
2214095	2024-05-22 02:30:00	26	1	2.44	3.20	2.79	2.56	3.10	2.72	1	4	7	5	2	7	6	6	14	8	8	0	14	2	2	1	1	1	3	1	-1	-1	0.12	-0.10	-0.07
2230477	2025-01-05 00:00:00	26	3	3.35	3.25	2.12	3.50	3.40	2.13	2	1	4	4	1	3	6	2	7	2	6	1	8	2	3	1	2	1	3	1	1	1	0.15	0.15	0.01
2230483	2025-01-05 22:00:00	26	3	1.85	3.45	4.00	1.86	3.80	4.05	5	0	4	5	1	6	10	1	10	2	11	2	12	1	3	1	2	1	2	1	1	1	0.01	0.35	0.05
2230481	2025-01-11 04:00:00	26	1	3.90	3.60	1.83	4.80	3.60	1.78	14	8	17	21	10	13	35	18	30	4	21	9	39	1	3	2	3	1	2	1	0	-1	0.90	0.00	-0.05
2035434	2023-08-27 19:00:00	26	1	1.41	4.50	7.00	1.43	4.45	6.60	2	1	1	1	2	3	3	3	4	1	1	0	4	2	2	1	1	1	3	1	-1	-1	0.02	-0.05	-0.40
2230487	2025-01-12 22:00:00	26	0	6.00	3.75	1.62	6.00	3.75	1.62	1	0	0	2	1	0	3	1	0	0	2	3	3	1	2	3	3	2	1	0	0	0	0.00	0.00	0.00
2035431	2024-05-20 03:00:00	26	0	3.40	3.60	1.96	3.60	3.75	1.98	12	3	12	9	4	13	21	7	25	5	19	1	26	2	3	1	2	1	3	1	1	1	0.20	0.15	0.02
2230490	2025-01-11 02:00:00	26	1	4.05	3.65	1.79	4.45	3.80	1.78	5	2	5	6	4	4	11	6	9	1	6	3	12	1	3	2	3	1	2	1	1	-1	0.40	0.15	-0.01
2230488	2025-01-13 00:15:00	26	0	2.14	3.40	3.10	2.23	3.35	3.30	0	3	4	4	1	2	4	4	6	5	5	3	9	2	2	1	1	1	3	1	-1	1	0.09	-0.05	0.20
2035428	2024-04-28 23:05:00	26	0	2.20	3.25	2.95	2.20	3.40	3.30	0	0	0	0	1	2	0	1	2	2	1	0	2	3	2	1	1	2	3	0	1	1	0.00	0.15	0.35
2035427	2024-04-21 23:05:00	26	0	2.59	3.40	2.38	2.75	3.50	2.50	0	0	2	2	1	1	2	1	3	1	2	0	3	2	3	1	2	1	3	1	1	1	0.16	0.10	0.12
2230492	2025-01-13 03:45:00	26	3	1.10	11.00	20.00	1.10	11.00	20.00	3	3	7	4	3	8	7	6	15	13	14	5	20	2	3	1	2	1	3	0	0	0	0.00	0.00	0.00
2035424	2023-09-03 19:00:00	26	1	2.00	3.50	3.40	1.98	3.50	3.45	2	0	0	0	0	1	2	0	1	0	2	1	2	1	3	2	3	1	2	-1	0	1	-0.02	0.00	0.05
2035486	2024-01-14 00:00:00	26	0	1.75	3.85	3.75	1.73	3.95	4.55	1	0	0	0	2	2	1	2	2	2	1	1	3	3	1	1	1	2	2	-1	1	1	-0.02	0.10	0.80
2035485	2024-01-15 00:05:00	26	3	2.92	3.15	2.28	3.25	3.30	2.28	2	0	2	3	1	3	5	1	5	2	6	2	7	1	3	1	2	1	2	1	1	0	0.33	0.15	0.00
2035480	2023-12-17 04:00:00	26	3	1.97	3.50	3.30	2.17	3.40	3.40	1	5	9	8	2	5	9	7	14	9	11	4	18	2	3	1	2	1	3	1	-1	1	0.20	-0.10	0.10
2035477	2023-12-10 20:00:00	26	3	1.93	3.35	3.80	1.92	3.45	4.15	6	1	4	5	1	8	11	2	12	3	12	2	14	2	3	1	2	1	3	-1	1	1	-0.01	0.10	0.35
2035473	2023-12-03 00:00:00	26	3	1.70	3.95	4.80	1.66	4.00	5.00	1	2	2	1	3	2	2	5	4	3	0	1	5	3	1	2	1	3	2	-1	1	1	-0.04	0.05	0.20
2035459	2023-10-28 23:00:00	26	3	1.65	3.90	4.60	1.65	4.05	5.10	0	1	1	0	2	2	0	3	3	3	0	0	3	3	1	1	1	2	2	0	1	1	0.00	0.15	0.50
2035519	2023-09-03 21:00:00	26	3	1.77	3.85	3.90	1.82	3.95	4.05	0	0	1	1	2	1	1	2	2	1	0	0	2	3	1	1	1	2	2	1	1	1	0.05	0.10	0.15
2035518	2023-08-26 03:00:00	26	1	4.30	3.95	1.77	4.50	3.85	1.76	7	7	2	10	6	1	17	13	3	3	7	17	20	1	2	3	3	2	1	1	-1	-1	0.20	-0.10	-0.01
2230528	2025-01-26 04:05:00	26	1	1.21	6.10	11.00	1.18	7.30	14.00	6	3	3	2	11	7	8	14	10	10	4	8	18	3	1	2	1	3	2	-1	1	1	-0.03	1.20	3.00
2035515	2023-08-19 03:00:00	26	1	4.20	3.85	1.81	4.20	3.80	1.82	2	2	3	5	2	3	7	4	6	0	3	1	7	1	3	2	3	1	2	0	-1	1	0.00	-0.05	0.01
2035512	2023-08-20 19:00:00	26	3	1.39	4.70	7.00	1.40	4.65	6.80	0	1	1	1	0	1	1	1	2	1	1	0	2	2	2	1	1	1	3	1	-1	-1	0.01	-0.05	-0.20
2035511	2024-03-17 04:00:00	26	0	2.03	3.35	3.25	2.11	3.30	3.65	6	6	12	14	4	8	20	10	20	4	14	4	24	1	3	1	2	1	2	1	-1	1	0.08	-0.05	0.40
2035509	2024-03-04 03:45:00	26	0	2.49	3.35	2.65	2.68	3.40	2.60	7	0	12	12	1	8	19	1	20	1	19	0	20	2	3	1	2	1	3	1	1	-1	0.19	0.05	-0.05
2035506	2024-03-03 00:00:00	26	0	2.69	3.40	2.59	2.80	3.40	2.49	0	0	3	4	1	1	4	1	4	0	3	0	4	1	3	1	2	1	2	1	0	-1	0.11	0.00	-0.10
2035504	2024-02-25 22:00:00	26	1	1.43	4.10	7.40	1.45	4.25	8.00	1	0	0	1	2	2	2	2	2	0	0	0	2	1	1	1	1	1	1	1	1	1	0.02	0.15	0.60
2035503	2024-02-25 20:00:00	26	0	2.38	3.50	2.68	2.38	3.55	2.86	0	3	2	0	3	5	0	6	7	7	1	0	7	3	2	1	1	2	3	0	1	1	0.00	0.05	0.18
2035501	2024-02-18 22:00:00	26	3	1.50	4.30	6.60	1.50	4.30	6.60	0	0	0	1	1	1	1	1	1	0	0	0	1	1	1	1	1	1	1	0	0	0	0.00	0.00	0.00
2035500	2024-02-19 00:05:00	26	1	2.58	3.25	2.60	2.63	3.35	2.69	6	2	4	4	3	6	10	5	10	0	5	0	10	1	3	1	2	1	2	1	1	1	0.05	0.10	0.09
2230548	2025-02-10 03:45:00	26	0	5.20	3.85	1.59	5.60	4.05	1.60	6	4	4	5	8	5	11	12	9	7	6	9	18	2	1	3	2	3	1	1	1	1	0.40	0.20	0.01
2035495	2024-02-04 22:00:00	26	0	1.77	3.70	4.65	1.79	3.65	4.55	0	1	1	1	1	1	1	2	2	2	1	1	3	3	1	1	1	2	2	1	-1	-1	0.02	-0.05	-0.10
2035494	2024-02-04 04:00:00	26	0	3.45	3.35	2.17	3.05	3.35	2.38	6	2	0	2	3	5	8	5	5	1	4	4	9	1	2	2	3	1	1	-1	0	1	-0.40	0.00	0.21
2230555	2025-02-09 00:00:00	26	3	2.31	3.50	3.00	2.31	3.50	3.00	0	0	0	0	1	1	0	1	1	1	0	0	1	3	1	1	1	2	2	0	0	0	0.00	0.00	0.00
2035493	2024-02-04 20:00:00	26	1	1.46	4.15	5.60	1.47	4.15	5.60	2	0	0	2	0	0	4	0	0	0	4	4	4	1	2	2	3	1	1	1	0	0	0.01	0.00	0.00
2035492	2024-02-04 22:00:00	26	3	1.40	4.30	6.40	1.42	4.55	7.80	2	4	6	4	3	6	6	7	12	7	6	1	13	3	2	1	1	2	3	1	1	1	0.02	0.25	1.40
2035491	2024-01-29 00:05:00	26	0	3.45	3.45	2.01	3.50	3.50	2.09	5	1	3	2	2	8	7	3	11	5	9	1	12	2	3	1	2	1	3	1	1	1	0.05	0.05	0.08
1837857	2023-06-04 03:00:00	26	3	2.38	3.70	2.56	2.38	3.95	2.65	6	5	10	7	8	7	13	13	17	5	5	1	18	2	2	1	1	1	3	0	1	1	0.00	0.25	0.09
2035490	2024-01-28 22:00:00	26	1	1.87	3.60	3.75	1.86	3.70	4.15	1	0	1	1	1	2	2	1	3	1	2	0	3	2	3	1	2	1	3	-1	1	1	-0.01	0.10	0.40
2230559	2025-02-08 04:05:00	26	3	1.39	5.10	6.20	1.38	5.40	7.10	10	10	13	9	11	16	19	21	29	15	13	5	34	3	2	1	1	2	3	-1	1	1	-0.01	0.30	0.90
2035489	2024-01-28 22:00:00	26	1	2.90	3.05	2.47	3.00	3.15	2.49	1	0	3	4	1	2	5	1	5	0	4	0	5	1	3	1	2	1	2	1	1	1	0.10	0.10	0.02
2035488	2024-01-28 22:00:00	26	1	2.87	3.15	2.41	2.95	3.25	2.48	2	0	3	4	1	3	6	1	6	0	5	0	6	1	3	1	2	1	2	1	1	1	0.08	0.10	0.07
2035549	2023-12-03 22:00:00	26	3	1.59	4.20	4.30	1.62	4.30	5.00	0	0	0	1	1	1	1	1	1	1	1	1	2	1	1	1	1	1	1	1	1	1	0.03	0.10	0.70
2035545	2023-11-05 04:00:00	26	1	2.21	3.55	3.15	2.08	3.60	3.45	9	3	6	6	5	11	15	8	17	6	13	4	21	2	3	1	2	1	3	-1	1	1	-0.13	0.05	0.30
2035542	2023-11-12 22:00:00	26	3	2.67	3.25	2.40	2.95	3.40	2.40	0	0	0	2	1	0	2	1	0	0	1	2	2	1	2	3	3	2	1	1	1	0	0.28	0.15	0.00
2215272	2024-05-25 02:30:00	26	3	1.84	3.55	3.90	1.86	3.70	3.70	17	4	16	15	7	13	32	11	29	9	30	12	41	1	3	2	3	1	2	1	1	-1	0.02	0.15	-0.20
2035541	2023-11-12 22:00:00	26	1	1.55	4.20	4.55	1.55	4.30	5.80	0	1	1	1	1	1	1	2	2	1	0	0	2	3	1	1	1	2	2	0	1	1	0.00	0.10	1.25
2035540	2023-11-05 20:00:00	26	1	1.59	3.95	5.00	1.59	3.90	5.10	0	3	1	0	1	3	0	4	4	6	2	2	6	3	1	1	1	2	2	0	-1	1	0.00	-0.05	0.10
2035537	2023-10-29 22:00:00	26	3	2.28	3.55	2.79	2.28	3.75	2.89	0	1	1	0	2	3	0	3	4	4	1	0	4	3	2	1	1	2	3	0	1	1	0.00	0.20	0.10
2035534	2023-10-22 23:05:00	26	3	1.33	5.50	8.60	1.33	5.50	8.70	1	0	1	2	1	4	3	1	5	2	4	0	5	2	3	1	2	1	3	0	0	1	0.00	0.00	0.10
2035531	2023-10-08 21:00:00	26	1	1.61	3.85	4.55	1.61	4.20	5.30	1	0	0	0	2	3	1	2	3	2	1	0	3	3	2	1	1	2	3	0	1	1	0.00	0.35	0.75
2035526	2023-09-23 03:00:00	26	0	2.12	3.60	2.85	2.17	3.50	3.30	3	6	3	5	3	7	8	9	10	7	6	5	15	3	2	1	1	2	3	1	-1	1	0.05	-0.10	0.45
2035524	2023-09-24 19:00:00	26	0	2.78	3.15	2.38	2.78	3.15	2.38	1	0	0	0	0	1	1	0	1	0	1	0	1	1	3	1	2	1	2	0	0	0	0.00	0.00	0.00
2035522	2023-09-17 19:00:00	26	1	3.85	3.80	1.80	3.85	3.80	1.80	0	0	1	1	1	0	1	1	1	0	0	0	1	1	1	1	1	1	1	0	0	0	0.00	0.00	0.00
2035520	2023-09-02 03:00:00	26	1	4.25	3.85	1.71	4.65	3.95	1.72	4	2	4	6	4	3	10	6	7	0	4	3	10	1	3	2	3	1	2	1	1	1	0.40	0.10	0.01
2035579	2024-05-04 23:00:00	26	3	1.32	5.30	7.50	1.33	5.70	8.30	6	0	7	8	1	8	14	1	15	3	16	2	17	2	3	1	2	1	3	1	1	1	0.01	0.40	0.80
2035577	2024-05-04 21:00:00	26	3	2.31	3.10	3.10	2.38	3.20	3.15	8	0	1	6	1	3	14	1	4	1	14	11	15	1	3	2	3	1	2	1	1	1	0.07	0.10	0.05
2035574	2024-04-21 21:00:00	26	0	2.03	3.55	3.10	2.05	3.65	3.45	1	0	1	1	1	2	2	1	3	1	2	0	3	2	3	1	2	1	3	1	1	1	0.02	0.10	0.35
2035570	2024-04-13 03:00:00	26	3	4.05	3.55	1.81	4.20	3.65	1.86	9	5	9	11	5	8	20	10	17	2	12	5	22	1	3	2	3	1	2	1	1	1	0.15	0.10	0.05
2035567	2024-04-07 21:00:00	26	1	2.41	3.25	2.80	2.48	3.25	2.95	2	0	1	2	0	3	4	0	4	0	4	0	4	1	3	1	2	1	2	1	0	1	0.07	0.00	0.15
2035560	2023-12-21 04:00:00	26	3	1.70	3.80	4.05	1.77	3.85	4.40	1	4	5	4	2	3	5	6	8	5	4	2	10	3	2	1	1	2	3	1	1	1	0.07	0.05	0.35
2035556	2023-12-17 22:00:00	26	0	2.47	3.25	2.96	2.47	3.25	2.96	0	0	0	0	1	1	0	1	1	1	0	0	1	3	1	1	1	2	2	0	0	0	0.00	0.00	0.00
2035555	2023-12-10 00:00:00	26	0	2.38	3.60	2.62	2.54	3.65	2.62	4	0	8	8	1	7	12	1	15	3	14	0	15	2	3	1	2	1	3	1	1	0	0.16	0.05	0.00
2035554	2023-12-11 00:05:00	26	3	2.03	3.55	3.25	2.04	3.65	3.50	4	1	3	4	1	3	8	2	6	1	7	3	9	1	3	2	3	1	2	1	1	1	0.01	0.10	0.25
2035615	2024-02-24 04:00:00	26	0	4.20	3.50	1.79	3.75	3.40	2.04	14	6	13	13	4	13	27	10	26	6	23	7	33	1	3	2	3	1	2	-1	-1	1	-0.45	-0.10	0.25
2035611	2024-02-18 22:00:00	26	3	1.79	3.50	4.90	1.79	3.50	4.90	0	0	0	0	1	1	0	1	1	1	0	0	1	3	1	1	1	2	2	0	0	0	0.00	0.00	0.00
2035610	2024-02-18 22:00:00	26	0	1.54	4.35	5.90	1.54	4.35	5.90	0	0	0	0	1	1	0	1	1	1	0	0	1	3	1	1	1	2	2	0	0	0	0.00	0.00	0.00
2035604	2024-02-04 00:00:00	26	3	1.63	3.80	4.50	1.59	4.10	5.70	3	1	0	0	4	4	3	5	4	3	1	2	6	3	1	2	1	3	2	-1	1	1	-0.04	0.30	1.20
2035603	2024-02-04 22:00:00	26	0	2.25	3.05	3.05	2.25	3.15	3.45	0	0	2	0	2	2	0	2	4	4	2	0	4	3	2	1	1	2	3	0	1	1	0.00	0.10	0.40
2035602	2024-02-05 03:45:00	26	3	2.58	3.25	2.47	2.80	3.45	2.49	3	1	1	4	3	1	7	4	2	2	5	7	9	1	2	3	3	2	1	1	1	1	0.22	0.20	0.02
2035601	2024-01-28 00:00:00	26	3	1.38	4.15	9.00	1.42	4.25	9.20	1	2	4	2	3	7	3	5	11	8	6	0	11	3	2	1	1	2	3	1	1	1	0.04	0.10	0.20
2035600	2024-01-28 20:00:00	26	1	3.35	3.40	2.04	3.60	3.55	2.04	2	0	2	1	3	3	3	3	5	4	4	2	7	2	2	1	1	1	3	1	1	0	0.25	0.15	0.00
2035599	2024-01-28 04:00:00	26	1	2.38	3.50	2.66	2.45	3.65	2.73	11	3	13	9	5	13	20	8	26	9	21	3	29	2	3	1	2	1	3	1	1	1	0.07	0.15	0.07
2035595	2024-01-13 04:00:00	26	1	1.56	4.20	5.90	1.60	4.00	5.80	6	12	8	9	9	13	15	21	21	17	11	11	32	3	1	1	1	2	2	1	-1	-1	0.04	-0.20	-0.10
2230198	2024-08-18 23:00:00	26	0	4.60	3.85	1.66	5.60	3.90	1.63	1	0	1	2	2	0	3	2	1	0	1	2	3	1	2	3	3	2	1	1	1	-1	1.00	0.05	-0.03
2035594	2024-01-14 20:00:00	26	3	1.34	4.80	7.00	1.35	5.10	9.10	3	3	1	2	5	6	5	8	7	4	1	2	9	3	1	2	1	3	2	1	1	1	0.01	0.30	2.10
2230202	2024-08-18 21:00:00	26	3	2.81	3.15	2.47	2.88	3.15	2.59	8	0	7	7	0	8	15	0	15	1	16	1	16	1	3	1	2	1	2	1	0	1	0.07	0.00	0.12
2230203	2024-08-17 02:45:00	26	0	6.50	4.40	1.36	7.10	4.80	1.43	8	7	7	10	8	7	18	15	14	4	7	8	22	1	2	3	3	2	1	1	1	1	0.60	0.40	0.07
2230200	2024-08-17 23:00:00	26	0	2.70	3.40	2.40	2.86	3.50	2.40	1	0	0	2	3	0	3	3	0	0	0	3	3	1	1	3	2	2	1	1	1	0	0.16	0.10	0.00
2035588	2023-08-27 21:00:00	26	3	2.13	3.55	3.35	2.13	3.55	3.35	0	0	0	1	1	1	1	1	1	0	0	0	1	1	1	1	1	1	1	0	0	0	0.00	0.00	0.00
2035587	2024-05-20 03:00:00	26	3	2.75	3.75	2.39	2.74	3.75	2.39	3	0	2	2	1	3	5	1	5	0	4	0	5	1	3	1	2	1	2	-1	0	0	-0.01	0.00	0.00
2035586	2024-05-20 03:00:00	26	3	1.66	4.15	4.85	1.65	4.30	4.75	2	2	8	2	6	8	4	8	16	15	11	3	19	3	2	1	1	2	3	-1	1	-1	-0.01	0.15	-0.10
2230207	2024-08-18 23:00:00	26	1	2.08	3.40	3.30	2.06	3.45	3.65	2	1	0	0	2	2	2	3	2	3	2	3	5	2	1	2	1	3	1	-1	1	1	-0.02	0.05	0.35
2035585	2024-05-20 03:00:00	26	1	1.39	5.00	6.30	1.34	5.50	8.50	5	1	7	1	5	13	6	6	20	14	14	0	20	2	2	1	1	1	3	-1	1	1	-0.05	0.50	2.20
2035584	2024-05-20 03:00:00	26	0	4.25	3.80	1.82	4.05	3.85	1.84	7	3	2	5	5	3	12	8	5	2	6	9	14	1	2	3	3	2	1	-1	1	1	-0.20	0.05	0.02
2230205	2024-08-18 03:00:00	26	3	1.44	4.70	6.00	1.44	4.80	6.90	7	5	13	10	6	11	17	11	24	9	15	2	26	2	3	1	2	1	3	0	1	1	0.00	0.10	0.90
2035647	2024-04-28 19:00:00	26	0	3.85	3.55	1.78	3.85	3.60	1.78	1	0	0	0	1	0	1	1	0	1	1	2	2	1	1	3	2	2	1	0	1	0	0.00	0.05	0.00
2035646	2024-04-29 01:00:00	26	3	2.39	3.70	2.44	2.43	3.95	2.59	7	0	6	6	2	7	13	2	13	0	11	0	13	1	3	1	2	1	2	1	1	1	0.04	0.25	0.15
1837497	2023-06-04 03:00:00	26	0	1.46	5.00	6.10	1.43	5.30	6.10	6	3	8	6	7	9	12	10	17	9	11	4	21	2	3	1	2	1	3	-1	1	0	-0.03	0.30	0.00
1837499	2023-06-04 03:00:00	26	0	5.70	4.15	1.50	5.00	4.20	1.64	4	3	5	6	5	6	10	8	11	3	5	2	13	2	3	1	2	1	3	-1	1	1	-0.70	0.05	0.14
2035639	2024-04-14 03:00:00	26	0	1.84	3.60	3.90	1.85	3.70	4.15	2	0	1	3	1	1	5	1	2	1	5	4	6	1	3	2	3	1	2	1	1	1	0.01	0.10	0.25
1837495	2023-06-04 03:00:00	26	3	2.78	3.40	2.34	2.94	3.50	2.35	5	1	6	6	2	6	11	3	12	1	9	0	12	2	3	1	2	1	3	1	1	1	0.16	0.10	0.01
2035636	2024-04-07 21:00:00	26	1	2.12	3.45	3.15	2.09	3.55	3.45	1	0	0	1	1	2	2	1	2	1	2	1	3	1	3	1	2	1	2	-1	1	1	-0.03	0.10	0.30
2035634	2024-04-07 23:05:00	26	3	1.81	4.10	3.95	1.81	4.10	3.95	0	0	0	0	1	1	0	1	1	1	0	0	1	3	1	1	1	2	2	0	0	0	0.00	0.00	0.00
2035632	2024-04-06 03:00:00	26	3	2.23	3.20	3.15	2.16	3.40	3.40	4	3	4	1	6	7	5	9	11	11	7	5	16	3	2	1	1	2	3	-1	1	1	-0.07	0.20	0.25
2035630	2024-03-31 21:00:00	26	0	1.78	3.45	5.00	1.78	3.45	5.00	0	0	0	0	1	1	0	1	1	1	0	0	1	3	1	1	1	2	2	0	0	0	0.00	0.00	0.00
2035628	2024-03-16 04:00:00	26	0	2.60	3.25	2.45	2.80	3.35	2.55	23	3	24	22	4	25	45	7	49	7	45	3	52	2	3	1	2	1	3	1	1	1	0.20	0.10	0.10
2035625	2024-03-17 22:00:00	26	1	1.33	5.20	6.80	1.35	5.10	8.60	1	1	2	2	1	2	3	2	4	1	2	0	4	2	3	1	2	1	3	1	-1	1	0.02	-0.10	1.80
2035624	2024-03-10 22:00:00	26	0	3.20	3.65	2.02	3.45	3.75	2.03	0	0	1	1	1	1	1	1	2	2	2	1	3	2	2	1	1	1	3	1	1	1	0.25	0.10	0.01
2035617	2024-03-03 22:00:00	26	1	2.02	3.45	3.35	2.03	3.50	3.65	1	1	0	1	2	2	2	3	2	1	0	1	3	2	1	2	1	3	1	1	1	1	0.01	0.05	0.30
2035616	2024-02-25 22:00:00	26	3	3.70	3.40	1.94	4.15	3.50	1.90	0	1	2	3	1	0	3	2	2	1	2	2	4	1	2	2	3	1	1	1	1	-1	0.45	0.10	-0.04
2230242	2024-08-31 02:45:00	26	3	1.75	3.55	4.05	1.81	3.85	4.20	1	4	8	8	4	2	9	8	10	8	9	7	17	2	3	1	2	1	3	1	1	1	0.06	0.30	0.15
2230245	2024-09-01 21:00:00	26	1	1.84	3.65	3.55	1.86	3.85	3.95	0	0	2	3	1	1	3	1	3	1	3	1	4	1	3	1	2	1	2	1	1	1	0.02	0.20	0.40
2230250	2024-09-16 02:45:00	26	1	1.85	3.75	3.70	1.84	4.05	3.85	3	2	5	3	6	4	6	8	9	6	4	3	12	3	2	1	1	2	3	-1	1	1	-0.01	0.30	0.15
2230256	2024-09-14 23:00:00	26	3	1.71	3.90	4.15	1.71	4.05	4.60	0	2	0	0	3	1	0	5	1	5	0	4	5	3	1	2	1	3	2	0	1	1	0.00	0.15	0.45
2035659	2024-05-20 03:00:00	26	3	1.37	4.95	7.00	1.42	5.10	6.80	3	5	9	7	6	8	10	11	17	8	7	1	18	3	2	1	1	2	3	1	1	-1	0.05	0.15	-0.20
2035658	2024-05-20 03:00:00	26	3	1.41	4.95	6.20	1.40	5.10	7.50	6	2	6	4	4	11	10	6	17	9	13	2	19	2	3	1	2	1	3	-1	1	1	-0.01	0.15	1.30
2035657	2024-05-20 03:00:00	26	1	1.60	3.85	5.10	1.48	4.40	6.80	6	1	3	2	6	5	8	7	8	2	3	2	10	1	3	1	2	1	2	-1	1	1	-0.12	0.55	1.70
2035655	2024-05-13 03:00:00	26	0	3.60	3.20	1.96	3.95	3.45	1.97	5	1	5	6	3	4	11	4	9	2	9	4	13	1	3	2	3	1	2	1	1	1	0.35	0.25	0.01
2035654	2024-05-13 03:00:00	26	0	3.80	4.25	1.81	3.75	4.50	1.78	5	4	4	6	8	1	11	12	5	5	4	11	16	2	1	3	2	3	1	-1	1	-1	-0.05	0.25	-0.03
2230264	2024-09-14 02:45:00	26	3	3.80	3.55	1.86	4.55	3.70	1.78	9	2	13	14	4	7	23	6	20	1	18	4	24	1	3	2	3	1	2	1	1	-1	0.75	0.15	-0.08
2035651	2024-04-28 21:00:00	26	0	2.76	3.20	2.35	3.10	3.30	2.35	0	0	0	2	1	0	2	1	0	0	1	2	2	1	2	3	3	2	1	1	1	0	0.34	0.10	0.00
2216957	2024-05-31 02:30:00	26	3	2.16	3.10	3.40	2.12	3.15	3.45	4	2	3	1	2	5	5	4	8	5	6	2	10	2	3	1	2	1	3	-1	1	1	-0.04	0.05	0.05
2035649	2024-05-07 03:00:00	26	0	1.93	3.75	3.40	1.95	3.85	3.60	10	2	10	10	4	10	20	6	20	2	16	2	22	1	3	1	2	1	2	1	1	1	0.02	0.10	0.20
2035648	2024-04-27 03:00:00	26	1	1.97	3.45	3.30	2.02	3.65	3.55	2	4	5	5	4	4	7	8	9	6	5	4	13	3	2	1	1	2	3	1	1	1	0.05	0.20	0.25
2216958	2024-06-02 23:00:00	26	3	2.33	3.30	2.88	2.44	3.30	2.74	1	0	2	1	1	0	2	1	2	0	1	0	2	1	3	1	2	1	2	1	0	-1	0.11	0.00	-0.14
2230210	2024-08-19 02:45:00	26	3	2.36	3.45	2.97	2.40	3.50	2.88	0	0	5	1	1	4	1	1	9	8	8	0	9	2	2	1	1	1	3	1	1	-1	0.04	0.05	-0.09
2230211	2024-08-18 01:00:00	26	0	3.05	3.35	2.21	3.20	3.45	2.23	4	1	4	4	2	4	8	3	8	2	7	2	10	1	3	1	2	1	2	1	1	1	0.15	0.10	0.02
2230212	2024-08-18 23:00:00	26	1	2.12	3.20	3.40	2.13	3.20	3.75	0	0	1	1	1	1	1	1	2	2	2	1	3	2	2	1	1	1	3	1	0	1	0.01	0.00	0.35
2230220	2024-08-24 23:00:00	26	0	2.50	3.70	2.45	2.59	3.70	2.54	2	0	6	7	0	3	9	0	9	0	9	0	9	1	3	1	2	1	2	1	0	1	0.09	0.00	0.09
2230226	2024-08-24 02:45:00	26	3	1.27	5.60	9.00	1.26	6.40	10.00	12	8	17	11	11	20	23	19	37	16	20	2	39	2	3	1	2	1	3	-1	1	1	-0.01	0.80	1.00
2230225	2024-08-25 23:00:00	26	1	1.90	3.45	3.80	1.90	3.55	4.15	0	0	0	1	1	1	1	1	1	1	1	1	2	1	1	1	1	1	1	0	1	1	0.00	0.10	0.35
2230231	2024-08-25 23:00:00	26	3	3.15	3.55	2.23	3.15	3.55	2.23	0	0	0	1	1	0	1	1	0	0	0	1	1	1	1	3	2	2	1	0	0	0	0.00	0.00	0.00
2230232	2024-09-01 23:00:00	26	0	3.30	3.20	2.06	3.85	3.30	2.06	2	0	3	2	1	3	4	1	6	4	7	2	8	2	3	1	2	1	3	1	1	0	0.55	0.10	0.00
2230239	2024-08-31 23:00:00	26	3	1.81	3.40	3.90	1.83	3.55	4.50	1	1	1	1	1	2	2	2	3	2	2	1	4	2	2	1	1	1	3	1	1	1	0.02	0.15	0.60
2230236	2024-09-02 02:45:00	26	0	3.75	3.50	1.82	3.80	3.80	1.92	12	5	16	17	6	12	29	11	28	4	22	5	33	1	3	2	3	1	2	1	1	1	0.05	0.30	0.10
2026622	2023-12-23 23:15:00	27	3	1.52	4.20	5.30	1.53	4.30	6.10	0	1	1	1	1	2	1	2	3	2	1	0	3	3	2	1	1	2	3	1	1	1	0.01	0.10	0.80
2026618	2023-08-27 03:30:00	27	0	2.16	3.40	3.10	2.11	3.50	3.45	4	2	3	2	4	6	6	6	9	4	4	1	10	2	2	1	1	1	3	-1	1	1	-0.05	0.10	0.35
2026616	2023-08-29 03:30:00	27	0	3.65	3.35	1.98	3.85	3.35	2.03	5	4	5	4	3	6	9	7	11	4	6	2	13	2	3	1	2	1	3	1	0	1	0.20	0.00	0.05
2026617	2023-08-27 23:30:00	27	0	3.45	3.35	2.02	3.45	3.70	2.05	2	3	3	2	2	2	4	5	5	4	3	3	8	3	1	1	1	2	2	0	1	1	0.00	0.35	0.03
2026612	2023-08-26 03:30:00	27	0	4.55	3.95	1.65	4.55	3.95	1.73	4	4	4	4	2	4	8	6	8	1	3	1	9	1	3	1	2	1	2	0	0	1	0.00	0.00	0.08
2026605	2023-08-22 01:00:00	27	3	3.35	3.05	2.35	3.40	3.00	2.36	1	1	3	4	1	1	5	2	4	0	3	1	5	1	3	2	3	1	2	1	-1	1	0.05	-0.05	0.01
2026602	2023-08-21 01:30:00	27	3	1.22	5.80	11.00	1.22	6.50	13.00	4	4	3	4	5	4	8	9	7	2	1	3	10	2	1	3	2	3	1	0	1	1	0.00	0.70	2.00
2026603	2023-08-19 01:30:00	27	0	2.96	3.15	2.53	2.90	3.15	2.58	4	1	5	8	2	5	12	3	10	1	10	3	13	1	3	2	3	1	2	-1	0	1	-0.06	0.00	0.05
2026601	2023-08-20 01:30:00	27	0	7.80	5.30	1.36	7.50	5.40	1.36	4	0	1	3	2	2	7	2	3	0	5	4	7	1	3	2	3	1	2	-1	1	0	-0.30	0.10	0.00
2026598	2023-08-14 01:30:00	27	0	1.84	3.50	3.95	1.91	3.75	3.85	0	2	1	3	1	0	3	3	1	1	1	3	4	1	1	3	2	2	1	1	1	-1	0.07	0.25	-0.10
2026597	2023-08-14 03:30:00	27	1	6.30	3.80	1.52	6.70	3.85	1.56	5	5	8	12	7	5	17	12	13	1	6	5	18	1	3	2	3	1	2	1	1	1	0.40	0.05	0.04
2026594	2023-08-13 23:00:00	27	0	2.13	3.20	3.40	2.13	3.20	3.40	0	0	0	0	1	0	0	1	0	1	0	1	1	2	1	2	1	3	1	0	0	0	0.00	0.00	0.00
2026595	2023-08-12 04:00:00	27	0	1.91	3.40	4.30	1.96	3.35	4.15	4	2	5	6	2	4	10	4	9	2	8	3	12	1	3	2	3	1	2	1	-1	-1	0.05	-0.05	-0.15
2026592	2023-08-13 03:30:00	27	0	3.10	3.50	2.11	3.15	3.55	2.21	4	1	1	1	1	5	5	2	6	1	4	0	6	2	3	1	2	1	3	1	1	1	0.05	0.05	0.10
2026593	2023-08-15 03:30:00	27	3	1.33	5.60	8.60	1.31	5.60	9.00	4	2	3	4	3	5	8	5	8	1	4	1	9	1	3	1	2	1	2	-1	0	1	-0.02	0.00	0.40
2026655	2023-09-30 03:00:00	27	3	1.35	4.95	7.40	1.39	5.20	7.70	11	10	15	14	10	14	25	20	29	4	9	0	29	2	3	1	2	1	3	1	1	1	0.04	0.25	0.30
2026652	2023-09-27 03:30:00	27	1	5.70	4.00	1.53	7.10	4.25	1.48	12	9	15	19	15	9	31	24	24	1	8	8	32	1	2	2	3	1	1	1	1	-1	1.40	0.25	-0.05
2026650	2023-09-27 01:00:00	27	3	1.64	4.10	5.10	1.62	4.15	5.20	2	1	2	3	1	3	5	2	5	0	3	0	5	1	3	1	2	1	2	-1	1	1	-0.02	0.05	0.10
2026651	2023-09-29 03:30:00	27	0	3.60	3.45	2.07	3.55	3.45	2.09	4	2	6	4	3	4	8	5	10	3	6	1	11	2	3	1	2	1	3	-1	0	1	-0.05	0.00	0.02
2026642	2023-09-25 03:00:00	27	3	2.69	3.35	2.44	2.66	3.45	2.61	8	3	7	8	4	8	16	7	15	2	11	3	18	1	3	2	3	1	2	-1	1	1	-0.03	0.10	0.17
2026643	2023-09-24 00:30:00	27	3	1.24	5.70	11.00	1.27	5.70	12.00	1	1	0	2	2	2	3	3	2	0	0	1	3	1	1	3	2	2	1	1	0	1	0.03	0.00	1.00
2026640	2023-09-16 03:00:00	27	3	1.95	3.20	3.90	2.00	3.25	4.10	2	4	8	4	5	7	6	9	15	10	7	1	16	3	2	1	1	2	3	1	1	1	0.05	0.05	0.20
2026638	2023-09-16 22:15:00	27	3	3.60	3.25	2.02	3.85	3.30	2.05	2	1	2	3	1	2	5	2	4	0	3	1	5	1	3	2	3	1	2	1	1	1	0.25	0.05	0.03
2026636	2023-09-17 22:15:00	27	3	1.41	4.70	6.50	1.45	4.95	6.20	2	0	4	3	3	3	5	3	7	2	4	0	7	2	3	1	2	1	3	1	1	-1	0.04	0.25	-0.30
2026637	2023-09-19 03:00:00	27	0	2.91	3.35	2.44	2.85	3.40	2.47	8	0	7	8	2	6	16	2	13	0	14	3	16	1	3	2	3	1	2	-1	1	1	-0.06	0.05	0.03
2026634	2023-09-17 20:00:00	27	3	2.51	2.89	2.98	2.69	2.84	3.05	2	3	4	4	1	4	6	4	8	2	4	0	8	2	3	1	2	1	3	1	-1	1	0.18	-0.05	0.07
2026635	2023-09-18 03:00:00	27	3	1.63	3.85	4.80	1.70	3.85	4.95	1	3	4	4	3	2	5	6	6	3	2	2	8	3	1	1	1	2	2	1	0	1	0.07	0.00	0.15
2026632	2023-09-17 03:00:00	27	3	1.38	4.90	6.90	1.37	5.00	8.10	6	4	5	5	5	7	11	9	12	1	3	0	12	2	3	1	2	1	3	-1	1	1	-0.01	0.10	1.20
2026628	2023-09-04 03:00:00	27	0	4.75	3.90	1.63	5.60	4.25	1.57	9	6	7	8	11	6	17	17	13	1	1	5	18	1	1	3	2	2	1	1	1	-1	0.85	0.35	-0.06
2026629	2023-09-02 22:15:00	27	3	1.31	4.75	8.90	1.32	4.95	11.00	1	1	1	2	3	3	3	4	4	2	1	1	5	3	1	1	1	2	2	1	1	1	0.01	0.20	2.10
2026624	2023-09-02 01:30:00	27	3	3.35	3.50	2.13	3.35	3.45	2.16	1	1	2	3	1	1	4	2	3	1	3	2	5	1	3	2	3	1	2	0	-1	1	0.00	-0.05	0.03
2026687	2023-10-22 00:30:00	27	1	3.85	3.80	1.79	4.05	3.85	1.84	4	2	4	5	2	4	9	4	8	1	6	2	10	1	3	2	3	1	2	1	1	1	0.20	0.05	0.05
2026685	2023-10-24 03:00:00	27	3	1.77	3.45	4.45	1.82	3.50	4.65	4	2	7	5	3	5	9	5	12	3	7	0	12	2	3	1	2	1	3	1	1	1	0.05	0.05	0.20
2026682	2023-10-23 03:00:00	27	3	1.66	3.95	5.10	1.66	3.95	5.10	3	1	2	1	2	4	4	3	6	4	5	2	8	2	3	1	2	1	3	0	0	0	0.00	0.00	0.00
2026683	2023-10-22 03:00:00	27	0	3.25	3.45	2.07	3.00	3.45	2.35	10	3	6	6	2	13	16	5	19	5	16	2	21	2	3	1	2	1	3	-1	0	1	-0.25	0.00	0.28
2026681	2023-10-22 22:15:00	27	3	1.41	5.10	7.10	1.41	5.00	7.10	0	1	0	1	1	1	1	2	1	1	0	1	2	2	1	2	1	3	1	0	-1	0	0.00	-0.10	0.00
2026679	2023-10-08 20:00:00	27	0	1.60	3.95	4.90	1.60	4.10	5.60	0	1	1	1	1	1	1	2	2	1	0	0	2	3	1	1	1	2	2	0	1	1	0.00	0.15	0.70
2026676	2023-10-09 03:00:00	27	1	6.50	4.75	1.39	6.80	4.75	1.44	3	4	4	6	5	4	9	9	8	1	1	2	10	1	1	3	2	2	1	1	0	1	0.30	0.00	0.05
2026677	2023-10-07 22:15:00	27	3	1.34	5.10	7.30	1.33	5.10	9.70	2	1	3	3	0	2	5	1	5	0	4	0	5	1	3	1	2	1	2	-1	0	1	-0.01	0.00	2.40
2026675	2023-10-07 03:00:00	27	3	1.34	4.90	7.80	1.40	4.90	7.70	2	3	6	5	2	4	7	5	10	3	5	0	10	2	3	1	2	1	3	1	0	-1	0.06	0.00	-0.10
2026670	2023-10-08 22:15:00	27	3	1.91	3.45	3.75	1.91	3.40	3.80	0	1	1	0	1	1	0	2	2	2	0	0	2	3	1	1	1	2	2	0	-1	1	0.00	-0.05	0.05
2026667	2023-09-28 01:00:00	27	3	1.22	6.80	12.00	1.21	6.80	13.00	2	1	0	2	3	2	4	4	2	1	1	3	5	1	1	3	2	2	1	-1	0	1	-0.01	0.00	1.00
2026665	2023-09-23 03:00:00	27	0	3.40	3.15	2.13	3.65	3.20	2.14	8	4	6	8	3	5	16	7	11	1	10	6	17	1	3	2	3	1	2	1	1	1	0.25	0.05	0.01
2026663	2023-09-24 20:00:00	27	3	1.55	3.70	6.10	1.59	3.60	5.70	1	1	1	1	1	1	2	2	2	0	0	0	2	1	1	1	1	1	1	1	-1	-1	0.04	-0.10	-0.40
2026656	2023-10-01 00:30:00	27	0	3.35	3.75	1.95	3.70	3.85	1.92	3	1	6	8	3	3	11	4	9	0	7	2	11	1	3	2	3	1	2	1	1	-1	0.35	0.10	-0.03
2026657	2023-09-30 20:00:00	27	1	2.74	3.25	2.47	2.74	3.25	2.47	1	0	0	0	1	0	1	1	0	0	0	1	1	1	1	3	2	2	1	0	0	0	0.00	0.00	0.00
2026719	2023-11-12 23:15:00	27	3	1.23	6.00	11.00	1.25	6.00	12.00	0	3	4	3	1	2	3	4	6	3	2	0	6	3	2	1	1	2	3	1	0	1	0.02	0.00	1.00
2026717	2023-11-11 21:00:00	27	0	2.74	3.45	2.35	2.89	3.60	2.35	2	1	1	3	3	0	5	4	1	0	1	4	5	1	2	3	3	2	1	1	1	0	0.15	0.15	0.00
2026715	2023-11-30 04:00:00	27	1	1.97	3.20	3.90	2.07	3.10	4.15	4	4	5	6	3	4	10	7	9	2	5	3	12	1	3	2	3	1	2	1	-1	1	0.10	-0.10	0.25
2026712	2023-11-13 04:00:00	27	3	1.36	5.20	8.20	1.32	5.60	9.10	9	4	9	7	9	13	16	13	22	6	9	0	22	2	3	1	2	1	3	-1	1	1	-0.04	0.40	0.90
2026713	2023-11-12 04:00:00	27	3	1.33	5.20	7.70	1.31	5.40	10.00	4	1	5	2	4	7	6	5	12	6	7	0	12	2	3	1	2	1	3	-1	1	1	-0.02	0.20	2.30
2026711	2023-11-11 04:00:00	27	3	1.55	4.10	5.30	1.58	4.25	5.50	7	11	14	7	13	13	14	24	27	14	4	1	28	3	2	1	1	2	3	1	1	1	0.03	0.15	0.20
2026708	2023-11-06 04:00:00	27	1	1.26	6.10	11.00	1.24	6.30	12.00	4	2	2	4	4	4	8	6	6	2	4	4	10	1	2	2	3	1	1	-1	1	1	-0.02	0.20	1.00
2026709	2023-11-05 23:15:00	27	3	1.59	4.00	5.00	1.59	4.05	5.70	0	0	0	0	1	2	0	1	2	2	1	0	2	3	2	1	1	2	3	0	1	1	0.00	0.05	0.70
2026706	2023-11-07 04:00:00	27	3	1.91	3.15	4.15	1.91	3.20	4.65	4	4	5	4	4	7	8	8	12	5	5	1	13	2	2	1	1	1	3	0	1	1	0.00	0.05	0.50
2026707	2023-11-04 21:00:00	27	0	2.69	3.35	2.44	2.82	3.50	2.44	1	0	0	1	1	0	2	1	0	0	1	2	2	1	2	3	3	2	1	1	1	0	0.13	0.15	0.00
2026704	2023-11-04 04:00:00	27	3	5.00	3.75	1.63	5.50	3.85	1.64	5	3	4	6	3	4	11	6	8	3	8	6	14	1	3	2	3	1	2	1	1	1	0.50	0.10	0.01
2026705	2023-11-05 04:00:00	27	0	3.00	3.40	2.19	3.20	3.50	2.21	11	7	7	9	11	7	20	18	14	7	9	13	27	1	2	3	3	2	1	1	1	1	0.20	0.10	0.02
2026702	2023-11-05 21:00:00	27	3	1.78	3.65	4.05	1.78	3.70	4.60	0	1	2	0	2	2	0	3	4	4	1	0	4	3	2	1	1	2	3	0	1	1	0.00	0.05	0.55
2026699	2023-10-30 04:00:00	27	3	1.38	4.80	8.50	1.43	4.55	7.50	10	11	12	10	10	15	20	21	27	7	6	0	27	3	2	1	1	2	3	1	-1	-1	0.05	-0.25	-1.00
2026696	2023-10-31 04:00:00	27	0	3.00	3.60	2.28	2.83	3.60	2.38	6	1	1	3	2	3	9	3	4	0	6	5	9	1	3	2	3	1	2	-1	0	1	-0.17	0.00	0.10
2026697	2023-10-28 03:00:00	27	3	1.76	3.90	3.95	1.72	4.05	4.50	7	2	2	1	5	9	8	7	11	4	5	1	12	2	3	1	2	1	3	-1	1	1	-0.04	0.15	0.55
2026692	2023-10-28 22:15:00	27	0	2.61	3.60	2.40	2.63	3.70	2.50	1	0	1	1	2	2	2	2	3	1	1	0	3	2	2	1	1	1	3	1	1	1	0.02	0.10	0.10
2026693	2023-10-29 21:00:00	27	3	2.08	3.30	3.40	2.07	3.40	3.70	2	0	2	2	2	3	4	2	5	2	4	1	6	2	3	1	2	1	3	-1	1	1	-0.01	0.10	0.30
2026688	2023-10-21 03:00:00	27	3	1.82	3.70	4.35	1.72	3.75	4.90	9	3	6	6	5	8	15	8	14	1	8	2	16	1	3	2	3	1	2	-1	1	1	-0.10	0.05	0.55
2026689	2023-10-28 20:00:00	27	0	2.28	3.35	2.92	2.33	3.35	2.83	0	0	2	1	0	1	1	0	3	2	3	0	3	2	3	1	2	1	3	1	0	-1	0.05	0.00	-0.09
2026750	2023-12-17 01:30:00	27	0	1.96	3.25	3.80	1.85	3.45	4.55	6	1	4	5	4	7	11	5	11	1	7	1	12	1	3	1	2	1	2	-1	1	1	-0.11	0.20	0.75
2026751	2023-12-19 04:00:00	27	3	1.50	4.15	5.80	1.52	4.40	6.00	13	13	19	16	15	17	29	28	36	7	8	0	36	2	3	1	2	1	3	1	1	1	0.02	0.25	0.20
2026748	2023-12-17 23:15:00	27	1	1.70	3.65	5.30	1.70	3.65	5.30	0	0	0	0	1	1	0	1	1	1	0	0	1	3	1	1	1	2	2	0	0	0	0.00	0.00	0.00
2026746	2023-12-18 04:00:00	27	3	1.22	6.30	10.00	1.24	6.60	11.00	5	5	3	6	7	5	11	12	8	5	4	8	16	2	1	3	2	3	1	1	1	1	0.02	0.30	1.00
2026747	2023-12-17 04:00:00	27	1	5.20	3.95	1.65	4.90	4.10	1.66	5	2	1	2	5	2	7	7	3	2	2	6	9	1	1	3	2	2	1	-1	1	1	-0.30	0.15	0.01
2026744	2023-12-16 21:00:00	27	3	1.64	3.90	4.70	1.65	3.90	5.40	0	0	0	1	0	2	1	0	2	2	3	1	3	2	3	1	2	1	3	1	0	1	0.01	0.00	0.70
2026742	2023-12-17 21:00:00	27	1	2.58	3.15	2.67	2.56	3.25	2.84	2	1	5	2	3	5	4	4	10	6	6	0	10	2	2	1	1	1	3	-1	1	1	-0.02	0.10	0.17
2026743	2023-12-16 23:15:00	27	3	2.38	3.40	2.73	2.38	3.50	2.91	0	0	3	0	2	2	0	2	5	5	3	0	5	3	2	1	1	2	3	0	1	1	0.00	0.10	0.18
2026740	2023-12-12 04:00:00	27	1	2.40	3.35	2.97	2.63	3.30	2.71	4	3	11	11	3	6	15	6	17	3	12	1	18	2	3	1	2	1	3	1	-1	-1	0.23	-0.05	-0.26
2026738	2023-12-10 21:00:00	27	3	1.17	7.10	12.00	1.19	7.40	13.00	1	1	1	1	3	3	2	4	4	3	1	1	5	3	1	1	1	2	2	1	1	1	0.02	0.30	1.00
2026739	2023-12-10 23:15:00	27	1	4.50	4.00	1.65	5.00	4.10	1.65	1	0	0	1	1	1	2	1	1	0	1	1	2	1	2	2	3	1	1	1	1	0	0.50	0.10	0.00
2026736	2023-12-09 21:00:00	27	0	2.05	3.10	3.70	2.05	3.10	4.15	2	1	1	2	1	3	4	2	4	1	3	1	5	1	3	1	2	1	2	0	0	1	0.00	0.00	0.45
2026732	2023-12-11 04:00:00	27	0	1.46	4.55	5.80	1.52	4.65	5.70	8	10	12	12	10	11	20	20	23	10	10	7	30	2	2	1	1	1	3	1	1	-1	0.06	0.10	-0.10
2026733	2023-12-09 23:15:00	27	1	3.75	3.75	1.83	4.15	3.90	1.81	0	0	3	3	2	0	3	2	3	1	2	1	4	1	3	1	2	1	2	1	1	-1	0.40	0.15	-0.02
2026729	2023-11-26 21:00:00	27	3	2.14	3.45	3.10	2.14	3.45	3.10	1	0	0	0	0	1	1	0	1	0	1	0	1	1	3	1	2	1	2	0	0	0	0.00	0.00	0.00
2026727	2023-11-28 04:00:00	27	1	2.23	3.65	2.79	2.25	3.65	3.00	4	1	5	3	1	5	7	2	10	4	9	1	11	2	3	1	2	1	3	1	0	1	0.02	0.00	0.21
2026724	2023-11-25 21:00:00	27	1	4.70	3.90	1.64	5.10	4.10	1.64	1	0	0	1	2	0	2	2	0	0	0	2	2	1	1	3	2	2	1	1	1	0	0.40	0.20	0.00
2026725	2023-11-25 04:00:00	27	3	1.75	3.70	4.85	1.79	3.65	4.55	1	1	4	3	1	2	4	2	6	2	4	0	6	2	3	1	2	1	3	1	-1	-1	0.04	-0.05	-0.30
2026722	2023-11-27 01:30:00	27	0	5.80	4.15	1.50	6.50	4.25	1.51	1	3	0	3	2	1	4	5	1	3	2	6	7	2	1	3	2	3	1	1	1	1	0.70	0.10	0.01
2026720	2023-11-26 04:00:00	27	3	1.37	4.60	7.90	1.37	4.80	9.20	3	6	10	5	6	9	8	12	19	11	7	0	19	3	2	1	1	2	3	0	1	1	0.00	0.20	1.30
2026760	2023-12-21 02:00:00	27	3	1.13	8.30	13.00	1.14	8.60	17.00	4	7	3	4	9	5	8	16	8	10	2	10	18	2	1	2	1	3	1	1	1	1	0.01	0.30	4.00
2026761	2023-12-21 04:30:00	27	3	2.40	3.35	2.75	2.47	3.45	2.80	1	2	5	2	2	8	3	4	13	10	9	0	13	3	2	1	1	2	3	1	1	1	0.07	0.10	0.05
2026759	2023-12-22 04:30:00	27	0	5.20	4.00	1.57	5.30	3.90	1.65	27	21	30	31	19	28	58	40	58	11	29	11	69	1	3	1	2	1	2	1	-1	1	0.10	-0.10	0.08
2026756	2023-12-22 04:30:00	27	3	2.33	2.97	3.50	2.38	2.94	3.45	1	6	3	3	5	4	4	11	7	8	1	5	12	3	1	2	1	3	2	1	-1	-1	0.05	-0.03	-0.05
2026754	2023-12-22 02:00:00	27	1	2.62	3.55	2.40	2.78	3.65	2.40	7	1	10	13	2	6	20	3	16	0	17	4	20	1	3	2	3	1	2	1	1	0	0.16	0.10	0.00
2026755	2023-12-22 02:00:00	27	1	4.55	3.35	1.78	5.20	3.40	1.78	6	5	6	12	5	4	18	10	10	2	10	10	20	1	2	2	3	1	1	1	1	0	0.65	0.05	0.00
2026752	2023-12-21 04:30:00	27	3	1.39	4.80	8.20	1.36	5.00	8.80	9	7	18	8	11	18	17	18	36	23	22	4	40	3	2	1	1	2	3	-1	1	1	-0.03	0.20	0.60
2026753	2023-12-20 04:30:00	27	1	1.44	4.40	7.80	1.46	4.30	7.60	5	6	12	7	4	13	12	10	25	13	15	0	25	2	3	1	2	1	3	1	-1	-1	0.02	-0.10	-0.20
2026812	2024-01-21 04:00:00	27	0	3.05	3.00	2.38	3.05	3.05	2.53	7	2	0	4	1	5	11	3	5	0	8	6	11	1	3	2	3	1	2	0	1	1	0.00	0.05	0.15
2026813	2024-01-22 04:00:00	27	3	1.75	3.85	4.00	1.78	3.95	4.30	3	3	7	4	5	7	7	8	14	10	9	3	17	3	2	1	1	2	3	1	1	1	0.03	0.10	0.30
2026810	2024-01-20 04:00:00	27	3	1.81	3.40	4.90	1.81	3.40	4.95	3	3	6	3	4	8	6	7	14	8	7	0	14	3	2	1	1	2	3	0	0	1	0.00	0.00	0.05
2026811	2024-01-22 01:30:00	27	0	3.95	3.90	1.85	3.90	4.00	1.84	6	4	9	9	7	5	15	11	14	7	11	8	22	1	3	2	3	1	2	-1	1	-1	-0.05	0.10	-0.01
2026808	2024-01-13 23:15:00	27	1	2.51	3.00	2.85	2.51	3.10	3.05	1	0	1	0	2	2	1	2	3	2	1	0	3	3	2	1	1	2	3	0	1	1	0.00	0.10	0.20
2026809	2024-01-13 04:00:00	27	0	2.01	3.15	3.80	2.06	3.20	3.95	5	5	6	7	5	6	12	10	12	7	9	7	19	1	3	1	2	1	2	1	1	1	0.05	0.05	0.15
2026806	2024-02-02 04:00:00	27	0	5.80	3.95	1.53	6.50	4.20	1.52	13	8	10	14	12	9	27	20	19	3	10	11	30	1	2	3	3	2	1	1	1	-1	0.70	0.25	-0.01
2026807	2024-01-13 21:00:00	27	3	2.44	3.30	2.71	2.47	3.40	2.84	1	1	2	2	1	3	3	2	5	2	3	0	5	2	3	1	2	1	3	1	1	1	0.03	0.10	0.13
2026804	2024-01-14 04:00:00	27	3	1.64	3.95	5.40	1.75	3.80	4.65	3	2	6	6	1	5	9	3	11	2	8	0	11	2	3	1	2	1	3	1	-1	-1	0.11	-0.15	-0.75
2026805	2024-01-14 23:15:00	27	0	2.71	2.99	2.66	3.15	3.05	2.47	3	2	2	6	2	2	9	4	4	0	5	5	9	1	2	2	3	1	1	1	1	-1	0.44	0.06	-0.19
2026802	2024-02-01 04:00:00	27	3	1.47	4.20	6.20	1.52	4.15	6.70	5	6	7	7	5	7	12	11	14	4	5	2	16	2	3	1	2	1	3	1	-1	1	0.05	-0.05	0.50
2026803	2024-02-01 02:00:00	27	3	1.33	4.85	8.10	1.37	4.95	8.40	2	2	6	4	3	3	6	5	9	3	4	0	9	2	3	1	2	1	3	1	1	1	0.04	0.10	0.30
2026800	2024-01-14 21:00:00	27	1	4.40	4.20	1.63	4.80	4.35	1.64	1	1	0	1	3	1	2	4	1	3	1	4	5	2	1	3	2	3	1	1	1	1	0.40	0.15	0.01
2026801	2024-01-14 01:30:00	27	3	2.07	3.25	3.50	2.07	3.30	3.80	1	1	1	3	1	3	4	2	4	2	4	2	6	1	3	1	2	1	2	0	1	1	0.00	0.05	0.30
2026846	2024-02-25 23:15:00	27	3	3.40	3.25	2.23	3.15	3.25	2.35	3	0	2	2	1	3	5	1	5	1	5	1	6	1	3	1	2	1	2	-1	0	1	-0.25	0.00	0.12
2026847	2024-02-25 21:00:00	27	1	2.85	3.00	2.53	3.05	3.05	2.53	0	0	0	2	1	0	2	1	0	0	1	2	2	1	2	3	3	2	1	1	1	0	0.20	0.05	0.00
2026844	2024-02-25 04:00:00	27	1	4.00	3.70	1.79	4.50	3.90	1.75	2	1	4	6	3	2	8	4	6	2	6	4	10	1	3	2	3	1	2	1	1	-1	0.50	0.20	-0.04
2026845	2024-02-24 23:15:00	27	3	1.40	4.60	6.60	1.43	4.75	7.10	2	2	4	4	2	3	6	4	7	2	4	1	8	2	3	1	2	1	3	1	1	1	0.03	0.15	0.50
2026843	2024-02-25 01:30:00	27	1	1.97	3.00	4.15	2.00	3.05	4.50	1	1	4	3	1	3	4	2	7	3	5	0	7	2	3	1	2	1	3	1	1	1	0.03	0.05	0.35
2026832	2024-01-29 01:30:00	27	1	2.08	3.30	3.75	2.19	3.20	3.55	3	2	5	6	1	5	9	3	10	4	10	3	13	2	3	1	2	1	3	1	-1	-1	0.11	-0.10	-0.20
2026830	2024-01-28 04:00:00	27	0	2.44	3.10	2.88	2.17	3.15	3.65	6	2	7	4	4	9	10	6	16	6	10	0	16	2	3	1	2	1	3	-1	1	1	-0.27	0.05	0.77
2026831	2024-01-27 21:00:00	27	1	1.63	3.55	5.40	1.63	3.65	6.10	0	2	1	0	2	3	0	4	4	4	0	0	4	3	1	1	1	2	2	0	1	1	0.00	0.10	0.70
2026828	2024-01-28 21:00:00	27	0	2.63	3.50	2.42	2.83	3.55	2.40	1	1	1	3	1	0	4	2	1	0	2	3	4	1	2	3	3	2	1	1	1	-1	0.20	0.05	-0.02
2026829	2024-01-27 23:15:00	27	0	6.60	4.40	1.43	7.30	4.70	1.43	7	3	8	11	7	6	18	10	14	0	8	4	18	1	3	2	3	1	2	1	1	0	0.70	0.30	0.00
2026826	2024-01-28 23:15:00	27	1	4.90	3.55	1.69	5.50	3.60	1.69	0	0	0	2	1	0	2	1	0	0	1	2	2	1	2	3	3	2	1	1	1	0	0.60	0.05	0.00
2026827	2024-01-30 04:00:00	27	3	1.88	3.25	4.15	1.89	3.40	4.45	4	1	4	3	3	5	7	4	9	3	6	1	10	2	3	1	2	1	3	1	1	1	0.01	0.15	0.30
2026824	2024-01-29 04:00:00	27	3	1.50	4.20	6.90	1.49	4.15	7.30	1	3	1	2	3	5	3	6	6	5	2	2	8	3	1	1	1	2	2	-1	-1	1	-0.01	-0.05	0.40
2026825	2024-01-28 01:30:00	27	0	1.34	5.50	6.60	1.31	5.90	8.40	3	2	2	0	6	8	3	8	10	9	4	2	12	3	2	1	1	2	3	-1	1	1	-0.03	0.40	1.80
2026822	2024-01-21 01:30:00	27	3	3.25	3.20	2.19	3.40	3.25	2.23	3	3	0	3	3	2	6	6	2	2	2	6	8	1	1	3	2	2	1	1	1	1	0.15	0.05	0.04
2026820	2024-01-21 23:15:00	27	3	1.16	7.60	12.00	1.17	8.10	14.00	1	2	2	3	3	2	4	5	4	2	1	2	6	2	1	2	1	3	1	1	1	1	0.01	0.50	2.00
2026821	2024-01-20 23:15:00	27	1	2.14	3.30	3.20	2.14	3.40	3.50	0	0	1	1	1	2	1	1	3	2	2	0	3	2	2	1	1	1	3	0	1	1	0.00	0.10	0.30
2026818	2024-01-21 21:00:00	27	3	2.19	3.05	3.35	2.19	3.10	3.70	0	1	2	1	2	2	1	3	4	3	1	0	4	3	2	1	1	2	3	0	1	1	0.00	0.05	0.35
2026819	2024-01-20 21:00:00	27	0	1.89	3.30	4.05	1.93	3.30	4.35	2	2	4	4	2	3	6	4	7	4	6	3	10	2	3	1	2	1	3	1	0	1	0.04	0.00	0.30
2026816	2024-01-23 04:00:00	27	0	4.75	3.95	1.71	4.75	4.00	1.69	6	1	3	7	3	2	13	4	5	0	9	8	13	1	3	2	3	1	2	0	1	-1	0.00	0.05	-0.02
2026878	2024-03-16 04:00:00	27	3	1.46	3.80	7.60	1.48	3.85	8.50	0	2	7	2	2	4	2	4	11	10	8	1	12	3	2	1	1	2	3	1	1	1	0.02	0.05	0.90
2026879	2024-03-17 21:00:00	27	0	1.99	3.40	3.55	1.95	3.50	3.95	2	0	1	1	1	3	3	1	4	1	3	0	4	2	3	1	2	1	3	-1	1	1	-0.04	0.10	0.40
2026876	2024-03-16 23:15:00	27	0	5.30	4.05	1.55	6.30	4.15	1.55	0	0	1	2	2	0	2	2	1	0	0	1	2	1	1	3	2	2	1	1	1	0	1.00	0.10	0.00
2026877	2024-03-18 01:30:00	27	3	2.58	3.05	2.74	2.56	3.10	2.95	1	1	3	1	1	5	2	2	8	6	6	0	8	2	2	1	1	1	3	-1	1	1	-0.02	0.05	0.21
2026874	2024-03-17 23:15:00	27	0	1.90	3.45	3.80	1.87	3.55	4.30	5	0	1	1	2	5	6	2	6	2	6	2	8	1	3	1	2	1	2	-1	1	1	-0.03	0.10	0.50
2026875	2024-03-16 21:00:00	27	3	1.83	3.35	4.25	1.83	3.40	4.75	1	0	0	0	1	2	1	1	2	1	1	0	2	2	2	1	1	1	3	0	1	1	0.00	0.05	0.50
2026872	2024-03-18 04:00:00	27	0	2.36	3.70	2.81	2.21	3.75	3.05	5	0	2	2	2	6	7	2	8	1	6	0	8	2	3	1	2	1	3	-1	1	1	-0.15	0.05	0.24
2026873	2024-03-17 01:30:00	27	3	2.96	3.55	2.33	3.00	3.50	2.31	1	1	2	4	1	1	5	2	3	0	3	2	5	1	3	2	3	1	2	1	-1	-1	0.04	-0.05	-0.02
2026870	2024-03-09 21:00:00	27	3	1.95	3.15	4.00	2.01	3.15	4.25	2	1	2	3	2	3	5	3	5	1	3	1	6	1	3	1	2	1	2	1	0	1	0.06	0.00	0.25
2026871	2024-03-17 04:00:00	27	3	1.52	3.85	6.20	1.57	3.90	6.40	7	5	9	8	6	9	15	11	18	4	8	1	19	2	3	1	2	1	3	1	1	1	0.05	0.05	0.20
2026868	2024-03-10 23:15:00	27	0	3.70	3.25	2.00	4.05	3.35	1.98	0	0	3	3	1	0	3	1	3	1	3	1	4	1	3	1	2	1	2	1	1	-1	0.35	0.10	-0.02
2026869	2024-03-11 01:30:00	27	3	1.30	5.20	8.40	1.31	5.40	10.00	3	2	4	3	4	8	6	6	12	6	6	0	12	2	2	1	1	1	3	1	1	1	0.01	0.20	1.60
2026866	2024-03-10 04:00:00	27	3	1.61	3.85	5.10	1.62	4.15	5.20	6	2	6	6	4	7	12	6	13	3	9	2	15	2	3	1	2	1	3	1	1	1	0.01	0.30	0.10
2026867	2024-03-10 01:30:00	27	0	4.00	3.25	1.91	4.55	3.30	1.90	4	3	6	9	3	3	13	6	9	4	11	8	17	1	3	2	3	1	2	1	1	-1	0.55	0.05	-0.01
2026865	2024-03-09 23:15:00	27	3	5.20	3.65	1.72	5.20	3.65	1.72	0	0	0	1	1	0	1	1	0	0	0	1	1	1	1	3	2	2	1	0	0	0	0.00	0.00	0.00
2026863	2024-03-09 04:00:00	27	3	1.49	4.05	6.30	1.49	4.25	6.90	3	7	5	4	8	10	7	15	15	16	8	8	23	3	1	1	1	2	2	0	1	1	0.00	0.20	0.60
2026860	2024-03-03 21:00:00	27	3	1.64	4.20	4.95	1.64	4.20	4.95	0	0	0	0	1	1	0	1	1	1	0	0	1	3	1	1	1	2	2	0	0	0	0.00	0.00	0.00
2026858	2024-03-02 21:00:00	27	3	2.51	3.05	3.10	2.51	3.05	3.10	0	0	0	0	1	1	0	1	1	1	0	0	1	3	1	1	1	2	2	0	0	0	0.00	0.00	0.00
2026859	2024-03-03 04:00:00	27	1	5.50	3.85	1.65	5.60	3.85	1.64	4	2	1	4	2	3	8	4	4	2	6	6	10	1	2	2	3	1	1	1	0	-1	0.10	0.00	-0.01
2026856	2024-03-05 04:00:00	27	3	2.38	3.10	3.30	2.35	3.05	3.35	2	1	1	1	1	3	3	2	4	2	3	1	5	2	3	1	2	1	3	-1	-1	1	-0.03	-0.05	0.05
2026857	2024-03-02 23:15:00	27	1	1.81	3.35	5.10	1.81	3.35	5.10	0	0	0	0	1	1	0	1	1	1	0	0	1	3	1	1	1	2	2	0	0	0	0.00	0.00	0.00
2026854	2024-03-03 01:30:00	27	1	1.99	3.20	3.80	2.03	3.20	4.10	4	2	4	5	2	6	9	4	10	3	8	2	12	2	3	1	2	1	3	1	0	1	0.04	0.00	0.30
2026855	2024-03-04 01:30:00	27	3	3.25	3.25	2.29	3.20	3.30	2.31	1	2	1	2	3	1	3	5	2	4	2	5	7	2	1	3	2	3	1	-1	1	1	-0.05	0.05	0.02
2026852	2024-03-04 04:00:00	27	1	2.62	3.60	2.56	2.69	3.60	2.49	5	2	3	6	3	2	11	5	5	1	7	7	12	1	2	2	3	1	1	1	0	-1	0.07	0.00	-0.07
2026850	2024-02-26 01:30:00	27	1	2.40	3.05	3.25	2.44	3.05	3.20	0	1	1	1	1	1	1	2	2	2	1	1	3	3	1	1	1	2	2	1	0	-1	0.04	0.00	-0.05
2026851	2024-03-03 23:15:00	27	3	1.57	4.15	5.80	1.57	4.15	5.80	0	0	0	0	1	1	0	1	1	1	0	0	1	3	1	1	1	2	2	0	0	0	0.00	0.00	0.00
2026848	2024-02-27 04:00:00	27	3	1.60	4.15	5.40	1.60	4.20	5.30	5	3	5	5	5	7	10	8	12	4	6	2	14	2	3	1	2	1	3	0	1	-1	0.00	0.05	-0.10
2026849	2024-04-05 02:00:00	27	0	3.10	3.10	2.31	3.05	3.20	2.44	6	2	0	3	3	4	9	5	4	0	4	5	9	1	2	3	3	2	1	-1	1	1	-0.05	0.10	0.13
2026910	2024-04-13 20:00:00	27	3	1.97	3.60	3.40	1.92	3.75	3.80	5	0	2	4	2	5	9	2	7	1	8	3	10	1	3	2	3	1	2	-1	1	1	-0.05	0.15	0.40
2026911	2024-04-13 03:00:00	27	3	2.12	3.40	3.20	2.08	3.45	3.55	6	3	5	3	3	7	9	6	12	6	9	3	15	2	3	1	2	1	3	-1	1	1	-0.04	0.05	0.35
2026908	2024-04-02 03:00:00	27	0	2.85	3.60	2.21	2.99	3.70	2.25	4	2	1	5	2	2	9	4	3	0	5	6	9	1	2	3	3	2	1	1	1	1	0.14	0.10	0.04
2026909	2024-04-15 00:30:00	27	1	1.71	3.90	4.20	1.73	3.95	4.55	1	0	1	1	2	2	2	2	3	1	1	0	3	2	2	1	1	1	3	1	1	1	0.02	0.05	0.35
2026906	2024-04-01 03:00:00	27	3	1.49	4.15	6.00	1.59	4.10	5.60	2	5	7	6	3	3	8	8	10	3	3	1	11	2	2	1	1	1	3	1	-1	-1	0.10	-0.05	-0.40
2026907	2024-03-31 01:30:00	27	1	2.09	2.86	3.95	2.20	2.95	3.90	1	5	5	5	2	2	6	7	7	2	1	1	8	3	1	1	1	2	2	1	1	-1	0.11	0.09	-0.05
2026904	2024-03-30 21:00:00	27	0	2.51	3.15	2.76	2.51	3.20	2.94	0	0	0	0	1	2	0	1	2	2	1	0	2	3	2	1	1	2	3	0	1	1	0.00	0.05	0.18
2026905	2024-03-31 22:15:00	27	3	1.74	3.75	4.20	1.74	3.95	4.50	0	0	1	1	1	1	1	1	2	1	1	0	2	2	2	1	1	1	3	0	1	1	0.00	0.20	0.30
2026902	2024-02-24 04:00:00	27	0	1.78	3.45	4.35	1.83	3.55	4.50	4	3	7	7	2	5	11	5	12	3	9	2	14	2	3	1	2	1	3	1	1	1	0.05	0.10	0.15
2026903	2024-03-10 21:00:00	27	3	2.19	3.10	3.70	2.19	3.10	3.70	0	0	0	0	0	1	0	0	1	1	1	0	1	2	2	1	1	1	3	0	0	0	0.00	0.00	0.00
2026901	2024-02-26 04:00:00	27	3	1.30	5.80	9.20	1.26	6.20	10.00	5	1	4	2	6	7	7	7	11	7	7	3	14	2	2	1	1	1	3	-1	1	1	-0.04	0.40	0.80
2026898	2024-02-18 21:00:00	27	1	4.80	3.90	1.63	6.10	4.15	1.55	2	1	3	5	3	1	7	4	4	0	3	3	7	1	2	2	3	1	1	1	1	-1	1.30	0.25	-0.08
2026896	2024-02-19 01:30:00	27	0	3.10	2.81	2.49	3.25	2.83	2.58	4	6	0	3	6	2	7	12	2	6	1	11	13	2	1	3	2	3	1	1	1	1	0.15	0.02	0.09
2026894	2024-02-19 04:00:00	27	1	2.12	3.15	3.45	2.17	3.25	3.55	3	0	5	6	1	6	9	1	11	4	12	2	13	2	3	1	2	1	3	1	1	1	0.05	0.10	0.10
2026895	2024-02-18 23:15:00	27	1	2.14	3.40	3.15	2.14	3.35	3.50	0	1	0	0	2	2	0	3	2	3	0	1	3	3	1	2	1	3	2	0	-1	1	0.00	-0.05	0.35
2026890	2024-02-04 21:00:00	27	1	1.64	3.85	4.75	1.64	3.95	5.30	1	0	0	0	2	2	1	2	2	1	0	0	2	3	1	1	1	2	2	0	1	1	0.00	0.10	0.55
2026891	2024-02-20 04:00:00	27	3	1.94	3.55	3.55	1.95	3.85	3.60	13	3	10	17	5	8	30	8	18	2	24	14	32	1	3	2	3	1	2	1	1	1	0.01	0.30	0.05
2026888	2024-02-05 04:00:00	27	1	1.76	4.00	4.35	1.73	4.05	4.45	2	4	7	2	6	7	4	10	14	14	8	4	18	3	2	1	1	2	3	-1	1	1	-0.03	0.05	0.10
2026889	2024-02-03 21:00:00	27	3	1.68	3.70	4.70	1.68	3.75	5.30	0	1	0	0	1	3	0	2	3	3	1	0	3	3	2	1	1	2	3	0	1	1	0.00	0.05	0.60
2026886	2024-02-04 23:15:00	27	0	2.28	3.20	3.35	2.28	3.15	3.40	0	1	0	0	1	2	0	2	2	2	0	0	2	3	1	1	1	2	2	0	-1	1	0.00	-0.05	0.05
2026887	2024-02-06 04:00:00	27	0	2.19	3.25	3.50	2.20	3.25	3.45	1	1	2	2	2	2	3	3	4	2	2	1	5	2	2	1	1	1	3	1	0	-1	0.01	0.00	-0.05
2026884	2024-02-04 04:00:00	27	1	2.13	3.35	3.20	2.14	3.45	3.40	5	1	5	4	3	6	9	4	11	4	9	2	13	2	3	1	2	1	3	1	1	1	0.01	0.10	0.20
2026885	2024-02-03 23:15:00	27	1	2.33	3.15	3.00	2.35	3.20	3.20	0	2	3	1	3	2	1	5	5	5	1	1	6	3	1	1	1	2	2	1	1	1	0.02	0.05	0.20
2026882	2024-02-03 04:00:00	27	3	1.52	3.90	7.40	1.56	3.85	6.70	5	5	9	6	6	8	11	11	17	7	7	1	18	2	2	1	1	1	3	1	-1	-1	0.04	-0.05	-0.70
2026883	2024-02-05 01:30:00	27	1	2.02	3.25	3.60	2.03	3.35	3.90	3	2	7	7	4	6	10	6	13	8	12	5	18	2	3	1	2	1	3	1	1	1	0.01	0.10	0.30
2026880	2024-03-17 23:15:00	27	3	2.17	3.40	3.40	2.16	3.40	3.40	1	0	0	0	1	1	1	1	1	1	1	1	2	1	1	1	1	1	1	-1	0	0	-0.01	0.00	0.00
2026881	2024-02-04 01:30:00	27	0	3.45	3.50	1.99	3.75	3.60	1.97	6	1	7	4	2	6	10	3	13	4	11	1	14	2	3	1	2	1	3	1	1	-1	0.30	0.10	-0.02
2026942	2024-05-12 22:15:00	27	3	1.38	4.60	7.20	1.43	4.75	7.20	3	2	4	3	4	3	6	6	7	2	2	1	8	2	2	1	1	1	3	1	1	0	0.05	0.15	0.00
2026943	2024-04-01 00:30:00	27	0	3.05	2.94	2.42	3.40	3.00	2.36	1	0	2	3	3	1	4	3	3	2	3	3	6	1	2	2	3	1	1	1	1	-1	0.35	0.06	-0.06
2026940	2024-05-11 03:00:00	27	1	3.55	3.65	2.02	3.20	3.65	2.16	7	3	8	6	5	9	13	8	17	8	13	4	21	2	3	1	2	1	3	-1	0	1	-0.35	0.00	0.14
2026941	2024-05-12 03:00:00	27	1	1.44	4.05	7.20	1.45	4.40	7.60	6	3	8	7	4	7	13	7	15	2	8	0	15	2	3	1	2	1	3	1	1	1	0.01	0.35	0.40
2026938	2024-05-06 03:00:00	27	3	1.65	3.90	4.65	1.70	3.95	4.80	0	2	3	2	3	2	2	5	5	4	1	1	6	3	1	1	1	2	2	1	1	1	0.05	0.05	0.15
2026939	2024-05-06 00:30:00	27	0	2.11	3.00	3.65	2.09	3.10	4.05	5	1	6	6	3	5	11	4	11	2	9	2	13	1	3	1	2	1	2	-1	1	1	-0.02	0.10	0.40
2026936	2024-05-04 22:15:00	27	3	1.37	4.65	6.90	1.37	4.95	8.60	6	7	6	7	7	9	13	14	15	3	2	1	16	3	2	1	1	2	3	0	1	1	0.00	0.30	1.70
2026937	2024-05-04 20:00:00	27	3	1.36	4.60	8.30	1.37	4.70	9.30	0	6	7	2	5	6	2	11	13	11	2	0	13	3	2	1	1	2	3	1	1	1	0.01	0.10	1.00
2026934	2024-05-05 20:00:00	27	0	3.30	3.25	2.28	3.30	3.25	2.28	0	0	0	1	1	0	1	1	0	0	0	1	1	1	1	3	2	2	1	0	0	0	0.00	0.00	0.00
2026935	2024-05-06 03:00:00	27	0	1.53	4.00	5.50	1.57	4.10	5.80	1	0	3	2	1	2	3	1	5	2	4	0	5	2	3	1	2	1	3	1	1	1	0.04	0.10	0.30
2026932	2024-05-05 00:30:00	27	3	2.53	3.75	2.38	2.63	3.90	2.42	8	1	0	6	2	1	14	3	1	0	11	13	14	1	2	3	3	2	1	1	1	1	0.10	0.15	0.04
2026933	2024-05-05 03:00:00	27	0	3.35	3.10	2.19	3.60	3.15	2.20	2	0	2	5	1	2	7	1	4	0	6	3	7	1	3	2	3	1	2	1	1	1	0.25	0.05	0.01
2026930	2024-05-05 22:15:00	27	3	2.28	3.70	2.93	2.28	3.70	2.93	0	0	0	0	1	1	0	1	1	1	0	0	1	3	1	1	1	2	2	0	0	0	0.00	0.00	0.00
2026931	2024-05-04 03:00:00	27	0	3.50	3.20	2.21	3.60	3.15	2.19	1	1	1	3	1	1	4	2	2	1	3	3	5	1	2	2	3	1	1	1	-1	-1	0.10	-0.05	-0.02
2026928	2024-04-28 03:00:00	27	3	2.00	3.45	3.45	1.94	3.55	3.95	8	1	3	4	1	9	12	2	12	2	12	2	14	1	3	1	2	1	2	-1	1	1	-0.06	0.10	0.50
2026929	2024-04-30 03:00:00	27	3	1.33	4.95	7.90	1.39	4.75	8.60	3	5	12	7	2	11	10	7	23	14	17	1	24	2	3	1	2	1	3	1	-1	1	0.06	-0.20	0.70
2026926	2024-04-28 00:30:00	27	3	2.53	3.15	2.96	2.56	3.15	2.92	0	0	1	1	1	1	1	1	2	1	1	0	2	2	2	1	1	1	3	1	0	-1	0.03	0.00	-0.04
2026927	2024-04-27 22:15:00	27	0	2.63	3.20	2.58	2.74	3.30	2.61	2	1	0	1	1	2	3	2	2	0	1	1	3	1	2	2	3	1	1	1	1	1	0.11	0.10	0.03
2026925	2024-04-20 22:15:00	27	3	2.20	2.99	3.45	2.17	3.05	3.80	1	1	0	0	1	3	1	2	3	2	1	0	3	3	2	1	1	2	3	-1	1	1	-0.03	0.06	0.35
2026922	2024-04-20 20:00:00	27	3	1.80	3.60	4.60	1.80	3.60	4.60	0	0	0	0	1	1	0	1	1	1	0	0	1	3	1	1	1	2	2	0	0	0	0.00	0.00	0.00
2026923	2024-04-21 20:00:00	27	1	3.65	3.10	2.21	3.65	3.10	2.21	0	0	0	1	1	0	1	1	0	0	0	1	1	1	1	3	2	2	1	0	0	0	0.00	0.00	0.00
2026920	2024-04-21 22:15:00	27	0	3.15	3.70	2.02	3.50	3.80	1.99	1	0	1	2	2	0	3	2	1	0	1	2	3	1	2	3	3	2	1	1	1	-1	0.35	0.10	-0.03
2026919	2024-04-22 00:30:00	27	3	3.85	3.25	1.95	4.35	3.35	1.92	5	0	7	7	1	4	12	1	11	1	12	2	13	1	3	2	3	1	2	1	1	-1	0.50	0.10	-0.03
2026917	2024-04-13 22:15:00	27	1	2.29	2.99	3.25	2.29	3.00	3.55	0	2	0	0	2	2	0	4	2	4	0	2	4	3	1	2	1	3	2	0	1	1	0.00	0.01	0.30
2026914	2024-04-14 20:00:00	27	0	2.65	3.15	2.58	2.71	3.15	2.53	1	0	2	2	0	1	3	0	3	0	3	0	3	1	3	1	2	1	2	1	0	-1	0.06	0.00	-0.05
2026915	2024-04-14 00:30:00	27	0	4.45	3.50	1.75	4.85	3.60	1.77	5	3	0	4	4	1	9	7	1	0	2	8	9	1	2	3	3	2	1	1	1	1	0.40	0.10	0.02
2026912	2024-04-14 03:00:00	27	0	3.80	3.45	1.90	4.00	3.45	1.96	9	3	8	9	3	8	18	6	16	0	12	2	18	1	3	2	3	1	2	1	0	1	0.20	0.00	0.06
2026974	2024-05-20 01:00:00	27	0	3.90	3.70	1.91	3.70	3.65	1.97	5	2	3	3	2	5	8	4	8	1	5	1	9	1	3	1	2	1	2	-1	-1	1	-0.20	-0.05	0.06
2026975	2024-05-20 01:00:00	27	1	1.41	4.10	7.60	1.41	4.35	8.80	6	4	5	3	7	18	9	11	23	14	12	0	23	3	2	1	1	2	3	0	1	1	0.00	0.25	1.20
2026972	2024-05-20 01:00:00	27	0	2.69	3.05	2.64	2.69	3.10	2.80	2	4	7	3	3	11	5	7	18	13	11	0	18	3	2	1	1	2	3	0	1	1	0.00	0.05	0.16
2026973	2024-05-20 01:00:00	27	1	1.81	3.35	4.40	1.80	3.45	4.95	3	1	2	1	3	4	4	4	6	3	3	1	7	2	2	1	1	1	3	-1	1	1	-0.01	0.10	0.55
2026970	2024-05-20 01:00:00	27	0	1.32	4.90	8.50	1.37	4.90	8.70	1	1	4	3	1	4	4	2	8	4	6	0	8	2	3	1	2	1	3	1	0	1	0.05	0.00	0.20
2026971	2024-05-20 01:00:00	27	3	1.27	5.80	11.00	1.29	5.60	10.00	1	2	2	3	0	2	4	2	4	1	3	1	5	1	3	1	2	1	2	1	-1	-1	0.02	-0.20	-1.00
2026968	2024-05-19 03:00:00	27	3	2.07	3.15	3.60	2.12	3.25	3.70	6	5	10	9	7	8	15	12	18	7	10	4	22	2	3	1	2	1	3	1	1	1	0.05	0.10	0.10
2026969	2024-05-20 01:00:00	27	3	1.65	3.85	4.70	1.67	3.95	5.10	0	0	1	1	1	2	1	1	3	2	2	0	3	2	2	1	1	1	3	1	1	1	0.02	0.10	0.40
2026966	2024-05-17 04:00:00	27	3	1.60	3.70	6.40	1.60	3.75	6.40	2	1	3	2	3	4	4	4	7	3	3	0	7	2	2	1	1	1	3	0	1	0	0.00	0.05	0.00
2026967	2024-05-16 01:30:00	27	0	1.96	3.45	3.60	2.02	3.50	3.75	12	4	11	14	4	11	26	8	22	3	21	7	29	1	3	2	3	1	2	1	1	1	0.06	0.05	0.15
2026965	2024-05-15 03:30:00	27	3	1.18	6.50	14.00	1.22	6.50	12.00	10	10	5	10	10	4	20	20	9	15	15	26	35	1	1	3	2	2	1	1	0	-1	0.04	0.00	-2.00
2026962	2024-05-15 04:00:00	27	0	1.70	4.25	3.90	1.71	4.50	4.10	4	6	15	6	11	12	10	17	27	18	11	1	28	3	2	1	1	2	3	1	1	1	0.01	0.25	0.20
2026963	2024-05-15 01:30:00	27	1	2.74	2.88	2.72	2.78	2.92	2.88	8	7	7	8	7	11	16	14	18	6	8	4	22	2	3	1	2	1	3	1	1	1	0.04	0.04	0.16
2026960	2024-05-17 01:30:00	27	1	3.60	3.45	1.95	3.80	3.45	2.02	7	5	11	10	5	9	17	10	20	6	13	3	23	2	3	1	2	1	3	1	0	1	0.20	0.00	0.07
2026961	2024-05-11 20:00:00	27	3	1.70	3.15	5.70	1.65	3.55	6.20	2	0	1	0	4	3	2	4	4	2	0	0	4	3	1	1	1	2	2	-1	1	1	-0.05	0.40	0.50
2026958	2024-05-16 04:00:00	27	3	2.44	3.25	2.74	2.49	3.40	2.84	12	1	12	14	3	15	26	4	27	1	23	0	27	2	3	1	2	1	3	1	1	1	0.05	0.15	0.10
2026959	2024-05-16 04:00:00	27	0	4.15	3.35	1.85	4.50	3.60	1.82	11	2	7	12	6	4	23	8	11	1	16	13	24	1	3	2	3	1	2	1	1	-1	0.35	0.25	-0.03
2026956	2024-05-11 22:15:00	27	3	1.87	3.75	3.55	1.87	3.90	3.85	0	1	1	1	2	1	1	3	2	2	0	1	3	3	1	2	1	3	2	0	1	1	0.00	0.15	0.30
2026955	2024-05-13 00:30:00	27	1	2.33	3.00	3.15	2.31	3.10	3.40	1	2	2	1	3	4	2	5	6	6	3	2	8	3	2	1	1	2	3	-1	1	1	-0.02	0.10	0.25
2026953	2024-05-12 20:00:00	27	3	2.14	3.05	3.55	2.14	3.15	3.75	0	0	0	0	1	2	0	1	2	2	1	0	2	3	2	1	1	2	3	0	1	1	0.00	0.10	0.20
2026951	2024-05-14 03:00:00	27	3	1.74	3.80	4.15	1.73	3.90	4.65	2	3	6	1	5	5	3	8	11	9	4	1	12	3	2	1	1	2	3	-1	1	1	-0.01	0.10	0.50
2026948	2024-04-22 03:00:00	27	3	1.83	3.80	3.70	1.80	3.95	4.15	2	0	1	1	2	3	3	2	4	2	3	1	5	2	3	1	2	1	3	-1	1	1	-0.03	0.15	0.45
2026949	2024-04-23 03:00:00	27	3	2.02	3.10	3.80	2.09	3.10	4.05	2	0	6	11	0	3	13	0	9	1	14	5	14	1	3	2	3	1	2	1	0	1	0.07	0.00	0.25
2026947	2024-03-31 20:00:00	27	1	1.97	3.30	3.75	2.00	3.35	4.00	0	1	2	3	1	1	3	2	3	1	2	1	4	1	3	1	2	1	2	1	1	1	0.03	0.05	0.25
2026944	2024-03-30 23:15:00	27	0	2.63	3.20	2.58	2.63	3.30	2.71	0	0	3	0	1	3	0	1	6	6	5	0	6	3	2	1	1	2	3	0	1	1	0.00	0.10	0.13
2026945	2024-03-31 04:00:00	27	3	1.25	5.60	10.00	1.29	5.60	11.00	5	2	2	5	4	4	10	6	6	2	6	6	12	1	2	2	3	1	1	1	0	1	0.04	0.00	1.00
2026992	2024-04-27 03:00:00	27	0	2.56	3.30	2.58	2.47	3.35	2.87	19	5	16	22	4	15	41	9	31	0	32	10	41	1	3	2	3	1	2	-1	1	1	-0.09	0.05	0.29
2026993	2024-04-29 00:30:00	27	3	1.80	3.70	3.90	1.82	3.75	4.25	0	1	2	1	1	2	1	2	4	4	3	1	5	3	2	1	1	2	3	1	1	1	0.02	0.05	0.35
2026990	2024-04-28 22:15:00	27	3	2.51	3.10	3.05	2.51	3.10	3.05	0	0	0	0	1	1	0	1	1	1	0	0	1	3	1	1	1	2	2	0	0	0	0.00	0.00	0.00
2026991	2024-04-27 20:00:00	27	0	3.90	3.75	1.79	4.15	3.90	1.81	1	0	1	1	1	1	2	1	2	1	2	1	3	1	3	1	2	1	2	1	1	1	0.25	0.15	0.02
2026988	2024-04-29 03:00:00	27	1	2.08	3.40	3.65	2.11	3.30	3.65	3	3	5	4	2	6	7	5	11	5	7	1	12	2	3	1	2	1	3	1	-1	0	0.03	-0.10	0.00
2026989	2024-04-28 20:00:00	27	1	2.49	2.82	3.10	2.58	2.85	3.20	1	1	1	1	2	1	2	3	2	1	0	1	3	2	1	2	1	3	1	1	1	1	0.09	0.03	0.10
2026986	2024-05-27 03:00:00	27	0	3.55	3.90	1.85	3.85	4.05	1.84	3	1	6	5	3	3	8	4	9	3	7	2	11	2	3	1	2	1	3	1	1	-1	0.30	0.15	-0.01
2026987	2024-05-25 22:15:00	27	0	2.35	3.30	2.83	2.44	3.45	2.85	0	1	2	1	2	1	1	3	3	3	1	1	4	3	1	1	1	2	2	1	1	1	0.09	0.15	0.02
2026984	2024-05-25 20:00:00	27	1	2.67	3.75	2.28	2.55	3.75	2.38	7	1	1	2	1	4	9	2	5	1	8	5	10	1	3	2	3	1	2	-1	0	1	-0.12	0.00	0.10
2026985	2024-05-26 00:30:00	27	0	2.78	3.40	2.34	2.79	3.50	2.47	4	2	1	6	2	3	10	4	4	0	6	6	10	1	2	2	3	1	1	1	1	1	0.01	0.10	0.13
2026982	2024-05-25 03:00:00	27	3	1.22	6.60	9.80	1.23	7.10	11.00	7	8	3	8	8	4	15	16	7	9	8	17	24	2	1	3	2	3	1	1	1	1	0.01	0.50	1.20
2026983	2024-05-26 22:15:00	27	1	2.39	3.20	2.85	2.46	3.30	2.93	2	0	2	3	1	2	5	1	4	0	4	1	5	1	3	2	3	1	2	1	1	1	0.07	0.10	0.08
2026980	2024-05-26 22:15:00	27	1	1.97	3.50	3.50	1.88	3.65	4.05	4	1	1	1	3	5	5	4	6	4	5	3	9	2	3	1	2	1	3	-1	1	1	-0.09	0.15	0.55
2026981	2024-05-26 20:00:00	27	0	2.28	3.15	3.05	2.28	3.15	3.10	0	0	1	0	0	1	0	0	2	2	2	0	2	2	2	1	1	1	3	0	0	1	0.00	0.00	0.05
2026978	2024-05-26 03:00:00	27	1	1.24	6.00	9.30	1.27	6.50	9.50	9	7	16	7	9	11	16	16	27	12	12	1	28	2	2	1	1	1	3	1	1	1	0.03	0.50	0.20
2026979	2024-05-26 00:30:00	27	3	2.02	3.55	3.30	2.06	3.65	3.45	4	1	3	6	3	3	10	4	6	2	8	6	12	1	3	2	3	1	2	1	1	1	0.04	0.10	0.15
2026976	2024-05-20 01:00:00	27	0	2.73	3.45	2.36	2.95	3.65	2.29	4	0	2	4	2	1	8	2	3	0	6	5	8	1	3	2	3	1	2	1	1	-1	0.22	0.20	-0.07
2026977	2024-05-20 01:00:00	27	1	2.97	3.75	2.09	3.10	3.95	2.11	8	2	7	9	3	3	17	5	10	4	16	11	21	1	3	2	3	1	2	1	1	1	0.13	0.20	0.02
2027038	2023-12-02 21:00:00	27	3	1.69	3.85	4.35	1.73	3.95	4.60	1	1	2	1	4	2	2	5	4	3	0	1	5	3	1	2	1	3	2	1	1	1	0.04	0.10	0.25
2027036	2024-01-03 02:15:00	27	1	1.58	3.65	5.70	1.60	3.75	6.30	6	5	5	5	6	8	11	11	13	4	4	2	15	2	2	1	1	1	3	1	1	1	0.02	0.10	0.60
2027037	2024-01-04 02:15:00	27	3	1.24	5.70	9.50	1.24	5.90	13.00	7	6	4	8	6	6	15	12	10	5	8	10	20	1	2	3	3	2	1	0	1	1	0.00	0.20	3.50
2027034	2024-01-05 02:15:00	27	0	2.88	3.25	2.35	2.97	3.30	2.44	9	3	0	7	3	3	16	6	3	1	11	14	17	1	2	3	3	2	1	1	1	1	0.09	0.05	0.09
2027035	2024-01-04 02:15:00	27	3	2.40	3.25	3.05	2.44	3.25	3.00	0	0	1	1	0	1	1	0	2	1	2	0	2	2	3	1	2	1	3	1	0	-1	0.04	0.00	-0.05
2027032	2023-12-03 21:00:00	27	1	2.31	2.95	3.25	2.42	2.94	3.35	0	1	1	2	1	1	2	2	2	1	1	1	3	1	1	1	1	1	1	1	-1	1	0.11	-0.01	0.10
2027033	2023-12-04 04:00:00	27	3	2.02	3.65	3.55	2.04	3.65	3.50	5	1	5	6	2	5	11	3	10	3	11	4	14	1	3	2	3	1	2	1	0	-1	0.02	0.00	-0.05
2027030	2023-12-02 23:15:00	27	3	1.55	4.10	5.30	1.56	4.20	5.90	3	1	3	3	3	4	6	4	7	1	3	0	7	2	3	1	2	1	3	1	1	1	0.01	0.10	0.60
2027029	2023-12-03 01:30:00	27	3	1.17	7.30	11.00	1.17	7.60	18.00	5	4	2	5	4	5	10	8	7	9	11	12	19	1	2	3	3	2	1	0	1	1	0.00	0.30	7.00
2027046	2024-01-05 00:00:00	27	3	1.70	3.75	4.40	1.71	3.85	4.90	0	1	3	1	3	3	1	4	6	6	3	1	7	3	2	1	1	2	3	1	1	1	0.01	0.10	0.50
2027047	2024-01-05 04:30:00	27	0	5.20	4.20	1.54	5.80	4.40	1.54	3	2	4	4	5	3	7	7	7	6	6	6	13	1	1	1	1	1	1	1	1	0	0.60	0.20	0.00
2027044	2024-01-04 04:30:00	27	3	2.69	3.55	2.34	2.51	3.55	2.70	13	1	12	12	1	17	25	2	29	4	27	0	29	2	3	1	2	1	3	-1	0	1	-0.18	0.00	0.36
2027045	2024-01-04 00:00:00	27	3	2.25	3.10	3.50	2.33	3.10	3.35	0	1	2	2	0	1	2	1	3	1	2	0	3	2	3	1	2	1	3	1	0	-1	0.08	0.00	-0.15
2027042	2024-01-03 04:30:00	27	3	2.29	3.45	3.10	2.12	3.50	3.45	5	1	1	3	3	5	8	4	6	3	7	5	11	1	3	2	3	1	2	-1	1	1	-0.17	0.05	0.35
2027043	2024-01-03 00:00:00	27	0	2.40	2.94	3.10	2.38	3.05	3.30	1	4	1	0	4	3	1	8	4	7	0	4	8	3	1	2	1	3	2	-1	1	1	-0.02	0.11	0.20
2027040	2023-12-05 04:00:00	27	1	1.57	3.80	5.50	1.60	3.90	5.90	6	5	10	7	5	10	13	10	20	7	10	0	20	2	3	1	2	1	3	1	1	1	0.03	0.10	0.40
2226797	2024-08-16 03:30:00	27	1	2.36	3.35	3.05	2.40	3.30	3.00	2	1	3	2	0	4	4	1	7	3	6	0	7	2	3	1	2	1	3	1	-1	-1	0.04	-0.05	-0.05
2226796	2024-08-16 01:00:00	27	1	1.48	3.90	6.30	1.44	4.15	8.80	3	3	2	2	5	6	5	8	8	7	4	4	12	3	1	1	1	2	2	-1	1	1	-0.04	0.25	2.50
2226799	2024-08-17 01:00:00	27	3	2.01	3.25	3.65	2.06	3.30	3.80	3	1	2	3	1	3	6	2	5	1	5	2	7	1	3	2	3	1	2	1	1	1	0.05	0.05	0.15
2226798	2024-08-17 03:30:00	27	1	2.91	3.10	2.42	2.79	3.20	2.63	13	3	2	9	5	6	22	8	8	4	18	18	26	1	2	2	3	1	1	-1	1	1	-0.12	0.10	0.21
2226801	2024-08-18 01:00:00	27	1	1.88	3.25	4.15	1.92	3.25	4.50	2	4	7	6	3	8	8	7	15	8	9	1	16	2	3	1	2	1	3	1	0	1	0.04	0.00	0.35
2226800	2024-08-19 03:30:00	27	1	7.10	4.30	1.43	8.90	4.45	1.40	11	7	12	15	13	7	26	20	19	2	8	9	28	1	2	3	3	2	1	1	1	-1	1.80	0.15	-0.03
2226803	2024-08-20 03:30:00	27	1	3.05	3.60	2.11	3.20	3.80	2.12	4	3	7	5	4	8	9	7	15	10	12	4	19	2	3	1	2	1	3	1	1	1	0.15	0.20	0.01
2226802	2024-08-19 01:00:00	27	0	1.61	3.50	5.80	1.62	3.55	6.70	1	1	1	1	1	3	2	2	4	2	2	0	4	2	2	1	1	1	3	1	1	1	0.01	0.05	0.90
2226805	2024-08-26 03:30:00	27	3	1.50	4.40	5.40	1.50	4.50	6.20	16	7	14	11	12	17	27	19	31	9	17	5	36	2	3	1	2	1	3	0	1	1	0.00	0.10	0.80
2226804	2024-08-26 01:15:00	27	1	2.42	3.10	3.20	2.47	3.10	3.10	0	0	2	1	1	2	1	1	4	3	3	0	4	2	2	1	1	1	3	1	0	-1	0.05	0.00	-0.10
2226807	2024-08-25 03:30:00	27	1	2.44	2.84	3.15	2.51	2.89	3.25	0	3	2	2	2	1	2	5	3	4	1	3	6	3	1	2	1	3	2	1	1	1	0.07	0.05	0.10
2226806	2024-08-24 01:00:00	27	3	2.19	3.20	3.20	2.16	3.30	3.50	4	3	6	3	4	6	7	7	12	7	7	2	14	2	2	1	1	1	3	-1	1	1	-0.03	0.10	0.30
2226809	2024-08-24 23:00:00	27	3	2.38	2.93	3.15	2.42	2.98	3.30	1	3	2	2	3	3	3	6	5	3	0	1	6	3	1	2	1	3	2	1	1	1	0.04	0.05	0.15
2226808	2024-08-26 01:00:00	27	3	2.28	2.95	3.65	2.29	2.95	3.65	1	6	4	1	6	4	2	12	8	11	1	5	13	3	1	2	1	3	2	1	0	0	0.01	0.00	0.00
2226811	2024-08-25 23:00:00	27	3	1.17	7.20	12.00	1.18	7.80	14.00	1	6	2	2	8	3	3	14	5	12	1	10	15	3	1	2	1	3	2	1	1	1	0.01	0.60	2.00
2226810	2024-08-24 03:30:00	27	0	2.33	3.50	2.75	2.42	3.50	2.84	0	1	6	2	2	4	2	3	10	10	9	2	12	3	2	1	1	2	3	1	0	1	0.09	0.00	0.09
2226813	2024-09-19 01:00:00	27	3	1.99	2.86	4.40	1.95	3.10	4.70	5	4	4	3	4	7	8	8	11	4	4	1	12	2	2	1	1	1	3	-1	1	1	-0.04	0.24	0.30
2226812	2024-08-29 01:00:00	27	3	1.60	3.70	5.50	1.62	3.80	5.90	0	3	5	1	4	5	1	7	10	11	5	2	12	3	2	1	1	2	3	1	1	1	0.02	0.10	0.40
2226815	2024-08-30 03:30:00	27	1	8.30	4.75	1.34	9.20	5.70	1.31	27	10	15	41	19	10	68	29	25	6	45	49	74	1	2	3	3	2	1	1	1	-1	0.90	0.95	-0.03
2226814	2024-08-30 01:00:00	27	3	1.76	3.80	4.05	1.81	3.80	4.25	3	6	7	5	5	8	8	11	15	7	4	0	15	3	2	1	1	2	3	1	0	1	0.05	0.00	0.20
2231970	2024-08-29 03:30:00	27	1	1.27	5.30	10.00	1.26	5.60	13.00	6	5	8	6	9	8	12	14	16	15	13	11	27	3	2	1	1	2	3	-1	1	1	-0.01	0.30	3.00
2226849	2024-09-25 03:00:00	27	3	1.18	6.70	12.00	1.19	7.10	14.00	5	13	12	6	13	13	11	26	25	27	12	13	38	3	1	2	1	3	2	1	1	1	0.01	0.40	2.00
2231971	2024-09-01 01:15:00	27	3	2.71	2.88	2.75	2.72	3.00	2.86	4	3	2	2	5	3	6	8	5	3	1	4	9	2	1	3	2	3	1	1	1	1	0.01	0.12	0.11
2226848	2024-09-18 01:00:00	27	3	2.92	2.80	2.63	2.88	2.88	2.81	7	3	5	6	4	6	13	7	11	3	9	5	16	1	3	2	3	1	2	-1	1	1	-0.04	0.08	0.18
2231968	2024-08-20 01:00:00	27	3	2.35	3.10	3.05	2.35	3.20	3.20	3	1	3	1	2	5	4	3	8	4	5	0	8	2	3	1	2	1	3	0	1	1	0.00	0.10	0.15
2226851	2024-09-30 03:00:00	27	1	2.70	3.45	2.38	2.74	3.35	2.58	19	2	12	19	1	17	38	3	29	0	35	9	38	1	3	2	3	1	2	1	-1	1	0.04	-0.10	0.20
2231969	2024-08-25 03:30:00	27	0	3.60	3.00	2.13	3.55	3.10	2.25	8	3	5	5	3	10	13	6	15	4	11	2	17	2	3	1	2	1	3	-1	1	1	-0.05	0.10	0.12
2226850	2024-09-25 01:00:00	27	3	1.79	3.55	4.15	1.67	3.80	5.30	4	1	2	1	4	6	5	5	8	3	3	0	8	2	2	1	1	1	3	-1	1	1	-0.12	0.25	1.15
2231974	2024-09-30 00:30:00	27	3	1.64	3.65	5.10	1.61	3.90	5.80	2	3	5	2	4	6	4	7	11	7	4	0	11	3	2	1	1	2	3	-1	1	1	-0.03	0.25	0.70
2231975	2024-09-27 01:00:00	27	0	3.10	3.45	2.14	3.10	3.55	2.25	5	4	4	5	5	4	10	9	8	6	7	8	16	1	2	3	3	2	1	0	1	1	0.00	0.10	0.11
2231972	2024-09-22 03:00:00	27	3	1.14	7.40	16.00	1.16	8.20	17.00	2	3	4	4	3	3	6	6	7	6	6	5	12	2	2	1	1	1	3	1	1	1	0.02	0.80	1.00
2226854	2024-09-29 22:15:00	27	1	1.72	3.65	4.50	1.71	3.75	5.00	1	1	0	0	3	2	1	4	2	4	1	3	5	3	1	2	1	3	2	-1	1	1	-0.01	0.10	0.50
2226857	2024-09-29 20:00:00	27	1	2.11	3.60	3.05	2.23	3.65	3.05	1	2	4	3	3	3	4	5	7	5	4	2	9	3	2	1	1	2	3	1	1	0	0.12	0.05	0.00
2231978	2024-10-26 03:00:00	27	0	2.99	3.10	2.36	3.00	3.20	2.47	7	5	0	10	4	1	17	9	1	0	8	16	17	1	2	3	3	2	1	1	1	1	0.01	0.10	0.11
2226856	2024-09-29 00:30:00	27	3	1.89	3.15	4.25	1.93	3.15	4.65	2	1	3	4	0	3	6	1	6	1	6	1	7	1	3	1	2	1	2	1	0	1	0.04	0.00	0.40
2231979	2024-11-03 23:15:00	27	3	1.07	12.00	16.00	1.10	11.00	20.00	1	2	2	2	2	4	3	4	6	3	2	0	6	3	2	1	1	2	3	1	-1	1	0.03	-1.00	4.00
2231976	2024-10-05 20:00:00	27	3	2.94	2.93	2.51	3.30	2.90	2.49	2	4	1	5	2	0	7	6	1	0	1	6	7	1	2	3	3	2	1	1	-1	-1	0.36	-0.03	-0.02
2226858	2024-09-28 03:00:00	27	0	2.91	2.89	2.56	2.91	2.95	2.72	9	7	6	11	5	8	20	12	14	1	9	7	21	1	3	2	3	1	2	0	1	1	0.00	0.06	0.16
2231977	2024-10-19 20:00:00	27	3	1.46	4.20	6.40	1.45	4.20	6.50	1	0	2	0	0	2	1	0	4	3	4	0	4	2	3	1	2	1	3	-1	0	1	-0.01	0.00	0.10
2231982	2024-12-01 01:30:00	27	3	3.05	3.20	2.26	3.20	3.40	2.25	5	2	2	4	4	2	9	6	4	1	4	6	10	1	2	3	3	2	1	1	1	-1	0.15	0.20	-0.01
2226860	2024-10-06 20:00:00	27	3	2.38	3.30	2.81	2.38	3.30	3.05	0	1	0	0	1	3	0	2	3	3	1	0	3	3	2	1	1	2	3	0	0	1	0.00	0.00	0.24
2231983	2024-12-10 04:00:00	27	3	1.79	3.10	5.00	1.80	3.15	5.60	3	2	5	5	2	4	8	4	9	2	6	1	10	2	3	1	2	1	3	1	1	1	0.01	0.05	0.60
2231980	2024-12-19 04:30:00	27	1	2.51	2.92	2.95	2.63	2.86	3.10	5	8	6	7	5	8	12	13	14	8	7	6	20	3	2	1	1	2	3	1	-1	1	0.12	-0.06	0.15
2226862	2024-10-01 03:00:00	27	3	1.43	4.60	6.50	1.41	5.00	7.10	7	3	5	6	5	10	13	8	15	5	10	3	18	2	3	1	2	1	3	-1	1	1	-0.02	0.40	0.60
2231981	2024-11-24 01:30:00	27	3	1.66	3.85	4.60	1.66	3.90	5.20	1	1	3	1	3	3	2	4	6	4	2	0	6	3	2	1	1	2	3	0	1	1	0.00	0.05	0.60
2226865	2024-10-07 03:00:00	27	1	2.88	3.15	2.42	2.82	3.10	2.69	6	2	3	6	1	6	12	3	9	1	10	4	13	1	3	2	3	1	2	-1	-1	1	-0.06	-0.05	0.27
2231986	2025-01-12 01:30:00	27	1	2.12	2.83	3.90	2.13	3.00	3.95	3	2	5	2	3	5	5	5	10	6	6	1	11	2	2	1	1	1	3	1	1	1	0.01	0.17	0.05
2226864	2024-10-06 03:00:00	27	3	1.22	6.40	9.70	1.27	6.40	9.60	5	4	9	6	5	7	11	9	16	5	7	0	16	2	3	1	2	1	3	1	0	-1	0.05	0.00	-0.10
2231987	2025-01-18 04:00:00	27	3	1.90	3.20	4.10	1.83	3.35	4.85	11	11	22	16	10	19	27	21	41	15	21	1	42	2	3	1	2	1	3	-1	1	1	-0.07	0.15	0.75
1842830	2023-06-05 00:30:00	27	3	2.14	3.50	3.05	2.16	3.63	3.33	0	0	1	1	2	1	1	2	2	1	0	0	2	3	1	1	1	2	2	1	1	1	0.02	0.13	0.28
2231984	2024-12-14 21:00:00	27	1	2.74	2.99	2.63	2.58	3.15	2.91	4	4	1	4	4	3	8	8	4	2	2	6	10	1	1	3	2	2	1	-1	1	1	-0.16	0.16	0.28
2226866	2024-10-07 00:30:00	27	3	2.53	3.20	2.70	2.56	3.25	2.84	2	0	3	2	2	3	4	2	6	2	4	0	6	2	3	1	2	1	3	1	1	1	0.03	0.05	0.14
2231985	2024-12-23 01:30:00	27	3	1.94	3.30	3.80	2.01	3.40	3.90	6	3	10	10	2	7	16	5	17	1	12	0	17	2	3	1	2	1	3	1	1	1	0.07	0.10	0.10
1842824	2023-06-05 03:00:00	27	1	2.22	3.28	3.18	2.01	3.42	3.98	11	7	10	7	12	13	18	19	23	6	5	1	24	3	2	1	1	2	3	-1	1	1	-0.21	0.14	0.80
2226869	2024-10-20 22:15:00	27	3	1.31	4.60	9.90	1.35	4.65	11.00	1	3	3	3	5	5	4	8	8	4	0	0	8	3	1	1	1	2	2	1	1	1	0.04	0.05	1.10
2226871	2024-10-20 00:30:00	27	0	2.53	3.15	2.73	2.58	3.15	2.92	1	0	1	2	0	2	3	0	3	0	3	0	3	1	3	1	2	1	2	1	0	1	0.05	0.00	0.19
2226870	2024-10-20 03:00:00	27	0	5.40	4.15	1.60	5.30	4.20	1.61	2	0	3	3	1	2	5	1	5	0	4	0	5	1	3	1	2	1	2	-1	1	1	-0.10	0.05	0.01
2231989	2025-02-10 01:30:00	27	3	1.54	3.85	5.90	1.54	3.95	6.80	8	4	8	8	4	9	16	8	17	1	9	0	17	2	3	1	2	1	3	0	1	1	0.00	0.10	0.90
2226873	2024-10-19 22:15:00	27	0	2.57	3.20	2.66	2.51	3.20	2.70	3	1	1	2	1	1	5	2	2	1	4	4	6	1	2	2	3	1	1	-1	0	1	-0.06	0.00	0.04
2226872	2024-10-20 20:00:00	27	3	2.12	3.05	3.60	2.13	3.00	4.05	1	1	1	1	0	3	2	1	4	2	3	0	4	2	3	1	2	1	3	1	-1	1	0.01	-0.05	0.45
1842822	2023-06-05 03:00:00	27	3	2.65	3.45	2.41	2.63	3.45	2.63	15	6	13	17	4	17	32	10	30	0	22	2	32	1	3	2	3	1	2	-1	0	1	-0.02	0.00	0.22
2226875	2024-10-28 01:30:00	27	3	2.94	3.15	2.38	3.30	3.15	2.31	6	2	4	6	2	3	12	4	7	2	10	7	14	1	3	2	3	1	2	1	0	-1	0.36	0.00	-0.07
2226874	2024-10-21 00:30:00	27	1	1.77	3.50	4.35	1.86	3.50	4.45	4	2	5	5	3	5	9	5	10	4	8	3	13	2	3	1	2	1	3	1	0	1	0.09	0.00	0.10
2226877	2024-10-27 23:15:00	27	1	2.19	2.77	3.80	2.20	2.85	4.10	0	1	0	1	2	2	1	3	2	3	1	2	4	3	1	2	1	3	2	1	1	1	0.01	0.08	0.30
1842817	2023-06-05 00:30:00	27	3	1.70	3.95	4.20	1.69	4.09	4.95	3	2	1	3	4	5	6	6	6	0	0	0	6	1	1	1	1	1	1	-1	1	1	-0.01	0.14	0.75
1842818	2023-06-05 00:30:00	27	1	1.88	3.80	3.50	1.88	3.89	3.99	3	0	1	2	2	4	5	2	5	0	3	0	5	1	3	1	2	1	2	0	1	1	0.00	0.09	0.49
2226878	2024-10-29 04:00:00	27	1	2.91	3.10	2.61	2.82	3.10	2.69	11	3	10	13	4	11	24	7	21	2	19	5	26	1	3	2	3	1	2	-1	0	1	-0.09	0.00	0.08
2226817	2024-08-29 03:30:00	27	0	1.62	3.55	5.50	1.70	3.50	5.70	2	4	7	6	3	3	8	7	10	3	4	1	11	2	3	1	2	1	3	1	-1	1	0.08	-0.05	0.20
2226816	2024-08-28 01:00:00	27	1	2.36	3.05	3.05	2.40	3.15	3.20	0	2	5	2	4	3	2	6	8	6	2	0	8	3	2	1	1	2	3	1	1	1	0.04	0.10	0.15
2226819	2024-08-27 03:30:00	27	3	1.98	3.55	3.40	1.95	3.75	3.70	13	1	14	15	3	11	28	4	25	3	27	6	31	1	3	2	3	1	2	-1	1	1	-0.03	0.20	0.30
2226818	2024-08-29 01:00:00	27	1	2.31	3.00	3.20	2.28	2.99	3.60	3	7	3	2	3	4	5	10	7	9	4	7	14	3	1	2	1	3	2	-1	-1	1	-0.03	-0.01	0.40
2226821	2024-09-01 23:00:00	27	3	1.85	3.25	4.30	1.87	3.35	4.60	0	2	1	2	1	1	2	3	2	2	1	2	4	2	1	2	1	3	1	1	1	1	0.02	0.10	0.30
2226820	2024-09-01 01:00:00	27	0	2.84	3.20	2.42	2.76	3.25	2.63	5	1	2	5	1	5	10	2	7	0	8	3	10	1	3	2	3	1	2	-1	1	1	-0.08	0.05	0.21
2226823	2024-09-02 01:15:00	27	1	3.10	2.89	2.42	3.10	2.92	2.61	6	6	1	4	3	6	10	9	7	2	3	5	12	1	2	3	3	2	1	0	1	1	0.00	0.03	0.19
2226822	2024-09-01 03:30:00	27	0	2.58	3.00	3.05	2.81	2.87	2.89	0	12	8	5	5	11	5	17	19	14	2	0	19	3	2	1	1	2	3	1	-1	-1	0.23	-0.13	-0.16
2226825	2024-09-02 01:00:00	27	0	2.28	3.60	2.76	2.53	3.50	2.70	1	2	10	8	1	9	9	3	19	10	16	0	19	2	3	1	2	1	3	1	-1	-1	0.25	-0.10	-0.06
2226824	2024-09-01 23:00:00	27	3	2.42	3.30	2.98	2.49	3.30	2.88	0	1	3	2	2	2	2	3	5	3	2	0	5	3	2	1	1	2	3	1	0	-1	0.07	0.00	-0.10
2226827	2024-09-16 03:00:00	27	3	1.33	4.70	8.90	1.31	5.10	11.00	9	3	4	8	7	7	17	10	11	6	13	12	23	1	3	2	3	1	2	-1	1	1	-0.02	0.40	2.10
2226826	2024-09-01 03:30:00	27	1	2.63	3.30	2.53	2.53	3.40	2.77	5	1	5	3	2	6	8	3	11	6	11	3	14	2	3	1	2	1	3	-1	1	1	-0.10	0.10	0.24
2226829	2024-09-14 03:00:00	27	3	1.72	3.50	5.50	1.65	3.65	5.90	6	3	4	2	7	7	8	10	11	4	2	1	12	3	2	1	1	2	3	-1	1	1	-0.07	0.15	0.40
2226828	2024-09-02 03:30:00	27	3	1.26	5.50	9.60	1.28	5.70	10.00	7	4	6	8	5	5	15	9	11	9	15	13	24	1	3	2	3	1	2	1	1	1	0.02	0.20	0.40
2226833	2024-09-17 03:00:00	27	3	2.13	3.05	3.50	2.13	3.15	3.80	3	1	5	4	3	4	7	4	9	4	7	2	11	2	3	1	2	1	3	0	1	1	0.00	0.10	0.30
2226832	2024-09-14 20:00:00	27	0	2.44	3.20	2.80	2.51	3.20	2.70	0	0	4	1	0	0	1	0	4	3	4	0	4	2	3	1	2	1	3	1	0	-1	0.07	0.00	-0.10
2226835	2024-09-15 00:30:00	27	3	2.20	3.10	3.30	2.17	3.05	3.85	4	1	2	2	0	5	6	1	7	1	6	0	7	2	3	1	2	1	3	-1	-1	1	-0.03	-0.05	0.55
2226834	2024-09-15 03:00:00	27	0	4.50	3.65	1.71	5.40	3.90	1.64	6	2	6	9	6	3	15	8	9	0	7	6	15	1	3	2	3	1	2	1	1	-1	0.90	0.25	-0.07
2226837	2024-09-22 22:15:00	27	3	1.72	3.95	4.65	1.72	3.95	4.65	0	0	0	0	1	1	0	1	1	1	0	0	1	3	1	1	1	2	2	0	0	0	0.00	0.00	0.00
2226836	2024-09-21 03:00:00	27	3	2.17	3.15	3.30	2.21	3.25	3.45	3	3	6	6	3	4	9	6	10	3	6	2	12	2	3	1	2	1	3	1	1	1	0.04	0.10	0.15
2226838	2024-09-24 03:00:00	27	0	1.94	3.15	4.05	1.90	3.25	4.65	9	6	14	8	8	13	17	14	27	16	19	6	33	2	3	1	2	1	3	-1	1	1	-0.04	0.10	0.60
2226841	2024-09-23 03:00:00	27	1	4.30	3.35	1.82	4.55	3.50	1.84	7	0	9	9	2	7	16	2	16	1	15	1	17	1	3	1	2	1	2	1	1	1	0.25	0.15	0.02
2226843	2024-09-21 20:00:00	27	1	3.40	3.10	2.17	3.95	3.10	2.11	0	2	1	3	2	0	3	4	1	3	2	5	6	2	1	3	2	3	1	1	0	-1	0.55	0.00	-0.06
2226842	2024-09-22 00:30:00	27	3	2.71	3.25	2.47	2.80	3.40	2.51	2	1	0	2	2	1	4	3	1	0	1	3	4	1	2	3	3	2	1	1	1	1	0.09	0.15	0.04
2226845	2024-09-26 01:00:00	27	1	1.76	3.65	4.20	1.74	3.75	4.75	4	1	5	3	3	7	7	4	12	5	8	0	12	2	3	1	2	1	3	-1	1	1	-0.02	0.10	0.55
2226844	2024-09-27 03:00:00	27	0	3.50	3.75	1.90	3.85	3.60	1.95	8	7	11	10	5	7	18	12	18	9	15	9	27	1	3	1	2	1	2	1	-1	1	0.35	-0.15	0.05
2226847	2024-09-20 01:00:00	27	0	3.90	3.00	2.03	4.20	3.05	2.06	6	4	5	10	4	4	16	8	9	7	15	14	23	1	3	2	3	1	2	1	1	1	0.30	0.05	0.03
2226913	2024-12-02 04:00:00	27	3	1.76	3.55	5.00	1.77	3.55	4.90	3	0	3	2	1	5	5	1	8	3	7	0	8	2	3	1	2	1	3	1	0	-1	0.01	0.00	-0.10
2226912	2024-12-01 23:15:00	27	3	1.31	4.70	9.50	1.34	4.80	10.00	3	4	4	4	4	2	7	8	6	2	1	3	9	2	1	3	2	3	1	1	1	1	0.03	0.10	0.50
2226915	2024-12-01 21:00:00	27	1	1.88	3.65	3.65	1.88	3.90	3.80	1	0	2	2	1	2	3	1	4	1	3	0	4	2	3	1	2	1	3	0	1	1	0.00	0.25	0.15
2226914	2024-12-03 04:00:00	27	1	2.16	3.30	3.50	2.09	3.35	3.70	5	1	1	2	1	5	7	2	6	1	6	2	8	1	3	2	3	1	2	-1	1	1	-0.07	0.05	0.20
2226917	2024-12-09 04:00:00	27	3	1.36	4.60	8.00	1.39	4.70	8.20	7	10	11	9	10	13	16	20	24	10	6	2	26	3	2	1	1	2	3	1	1	1	0.03	0.10	0.20
2226916	2024-12-08 23:15:00	27	3	1.97	3.55	3.45	1.96	3.70	3.70	7	2	6	8	4	7	15	6	13	2	11	4	17	1	3	2	3	1	2	-1	1	1	-0.01	0.15	0.25
2226919	2024-12-08 04:00:00	27	0	4.65	4.00	1.71	3.85	3.75	1.91	9	7	10	8	4	11	17	11	21	11	17	7	28	2	3	1	2	1	3	-1	-1	1	-0.80	-0.25	0.20
2226918	2024-12-07 04:00:00	27	3	1.87	3.30	4.10	1.90	3.35	4.45	7	2	11	10	3	10	17	5	21	4	16	0	21	2	3	1	2	1	3	1	1	1	0.03	0.05	0.35
2226921	2024-12-08 01:30:00	27	0	2.25	3.00	3.30	2.21	3.00	3.75	3	4	3	2	6	4	5	10	7	8	3	6	13	3	1	2	1	3	2	-1	0	1	-0.04	0.00	0.45
2226920	2024-12-09 01:30:00	27	1	2.11	3.25	3.35	2.17	3.20	3.60	1	1	4	5	0	2	6	1	6	2	7	2	8	1	3	1	2	1	2	1	-1	1	0.06	-0.05	0.25
2226923	2024-12-15 21:00:00	27	3	1.40	4.00	8.90	1.40	4.25	10.00	7	6	9	6	7	9	13	13	18	7	7	2	20	2	2	1	1	1	3	0	1	1	0.00	0.25	1.10
2226922	2024-12-15 23:15:00	27	1	3.30	2.99	2.25	3.70	3.05	2.21	1	0	2	3	2	1	4	2	3	0	2	1	4	1	3	2	3	1	2	1	1	-1	0.40	0.06	-0.04
2226925	2024-12-15 04:00:00	27	1	5.50	3.85	1.57	5.70	4.05	1.60	15	10	13	15	15	11	30	25	24	5	10	11	35	1	2	3	3	2	1	1	1	1	0.20	0.20	0.03
2226924	2024-12-14 23:15:00	27	3	2.35	2.98	3.15	2.35	3.20	3.25	0	0	1	0	4	1	0	4	2	4	0	2	4	3	1	2	1	3	2	0	1	1	0.00	0.22	0.10
2226927	2024-12-15 01:30:00	27	3	2.21	3.30	3.05	2.58	3.20	2.85	2	4	13	8	3	5	10	7	18	8	11	0	18	2	3	1	2	1	3	1	-1	-1	0.37	-0.10	-0.20
2226926	2024-12-16 01:30:00	27	1	1.42	4.10	7.70	1.41	4.35	9.20	6	4	7	5	7	8	11	11	15	4	4	0	15	2	2	1	1	1	3	-1	1	1	-0.01	0.25	1.50
2226929	2024-12-23 04:00:00	27	1	1.76	3.55	4.30	1.80	3.60	4.60	5	2	5	5	2	6	10	4	11	2	8	1	12	2	3	1	2	1	3	1	1	1	0.04	0.05	0.30
2226928	2024-12-16 01:30:00	27	0	1.81	3.70	3.90	1.86	3.80	4.00	5	5	11	10	5	6	15	10	17	5	10	3	20	2	3	1	2	1	3	1	1	1	0.05	0.10	0.10
2226931	2024-12-21 23:15:00	27	3	2.85	3.00	2.53	3.05	3.05	2.53	1	0	0	2	2	0	3	2	0	1	2	4	4	1	2	3	3	2	1	1	1	0	0.20	0.05	0.00
2226930	2024-12-21 21:00:00	27	0	2.35	2.69	3.55	2.35	2.71	3.90	1	3	2	1	3	4	2	6	6	5	1	1	7	3	1	1	1	2	2	0	1	1	0.00	0.02	0.35
2226933	2024-12-01 04:00:00	27	0	6.40	4.10	1.54	7.40	4.40	1.45	6	5	7	8	7	6	14	12	13	1	3	2	15	1	3	2	3	1	2	1	1	-1	1.00	0.30	-0.09
2226932	2024-12-23 01:30:00	27	0	3.55	3.45	1.96	4.25	3.60	1.86	8	3	9	7	4	8	15	7	17	3	11	1	18	2	3	1	2	1	3	1	1	-1	0.70	0.15	-0.10
2226935	2024-12-22 01:30:00	27	0	3.50	3.10	2.11	4.05	3.10	2.09	4	2	6	8	2	4	12	4	10	1	9	3	13	1	3	2	3	1	2	1	0	-1	0.55	0.00	-0.02
2226934	2024-12-07 21:00:00	27	3	1.80	3.50	4.15	1.78	3.65	4.65	3	1	2	2	3	4	5	4	6	1	2	0	6	2	3	1	2	1	3	-1	1	1	-0.02	0.15	0.50
2226937	2024-12-22 23:15:00	27	3	1.28	5.30	8.70	1.29	5.80	10.00	4	1	5	3	4	8	7	5	13	6	8	0	13	2	3	1	2	1	3	1	1	1	0.01	0.50	1.30
2226936	2024-12-08 21:00:00	27	0	4.10	3.05	1.96	5.00	3.15	1.87	3	0	9	10	2	4	13	2	13	1	12	1	14	1	3	1	2	1	2	1	1	-1	0.90	0.10	-0.09
2226939	2025-01-11 21:00:00	27	0	2.69	3.00	2.66	2.99	3.15	2.51	6	1	1	6	3	0	12	4	1	0	8	11	12	1	2	3	3	2	1	1	1	-1	0.30	0.15	-0.15
2226938	2024-12-21 04:00:00	27	3	1.44	4.20	6.60	1.40	4.60	8.60	13	9	14	10	13	20	23	22	34	12	13	1	35	2	3	1	2	1	3	-1	1	1	-0.04	0.40	2.00
2226941	2024-12-14 04:00:00	27	3	3.35	3.00	2.38	3.15	3.00	2.49	3	2	0	2	3	3	5	5	3	2	2	4	7	1	1	3	2	2	1	-1	0	1	-0.20	0.00	0.11
2226940	2025-01-12 23:15:00	27	3	1.28	4.90	9.90	1.32	5.40	9.20	5	4	11	7	3	6	12	7	17	5	10	0	17	2	3	1	2	1	3	1	1	-1	0.04	0.50	-0.70
2226943	2025-01-11 04:00:00	27	3	2.56	3.00	2.81	2.76	3.15	2.69	8	0	11	11	1	7	19	1	18	1	19	2	20	1	3	2	3	1	2	1	1	-1	0.20	0.15	-0.12
2226942	2025-01-12 21:00:00	27	0	2.47	2.83	3.10	2.47	2.87	3.35	0	3	0	0	3	1	0	6	1	6	0	5	6	3	1	2	1	3	2	0	1	1	0.00	0.04	0.25
2226881	2024-10-28 04:00:00	27	0	1.78	3.55	4.85	1.78	3.55	4.80	4	1	3	3	2	5	7	3	8	1	5	0	8	2	3	1	2	1	3	0	0	-1	0.00	0.00	-0.05
2226883	2024-10-27 00:30:00	27	3	2.78	3.25	2.42	2.80	3.40	2.51	2	0	0	2	1	1	4	1	1	0	3	3	4	1	2	2	3	1	1	1	1	1	0.02	0.15	0.09
2226882	2024-10-26 20:00:00	27	0	3.30	3.45	2.05	3.50	3.75	2.01	1	0	2	3	2	2	4	2	4	1	3	1	5	1	3	1	2	1	2	1	1	-1	0.20	0.30	-0.04
2226885	2024-11-04 04:00:00	27	1	1.90	3.40	3.85	1.97	3.45	3.95	4	1	7	7	1	4	11	2	11	2	11	2	13	1	3	1	2	1	2	1	1	1	0.07	0.05	0.10
2226886	2024-11-03 21:00:00	27	3	1.25	5.90	8.90	1.29	5.60	10.00	3	5	8	6	3	6	9	8	14	5	6	0	14	2	3	1	2	1	3	1	-1	1	0.04	-0.30	1.10
2226889	2024-11-02 21:00:00	27	3	1.65	3.75	4.85	1.65	3.80	5.60	0	1	1	0	2	2	0	3	3	3	0	0	3	3	1	1	1	2	2	0	1	1	0.00	0.05	0.75
2226888	2024-11-05 04:00:00	27	3	2.01	3.20	3.70	2.13	3.10	3.90	6	4	9	12	1	6	18	5	15	1	14	4	19	1	3	2	3	1	2	1	-1	1	0.12	-0.10	0.20
2226891	2025-01-04 04:00:00	27	0	8.40	4.70	1.35	7.30	4.50	1.44	31	21	21	24	18	23	55	39	44	8	24	19	63	1	3	2	3	1	2	-1	-1	1	-1.10	-0.20	0.09
2226890	2024-11-04 01:30:00	27	0	2.61	3.10	2.66	3.10	3.05	2.53	5	4	2	7	4	4	12	8	6	5	9	11	17	1	2	3	3	2	1	1	-1	-1	0.49	-0.05	-0.13
2226893	2024-11-11 01:30:00	27	0	2.40	3.05	2.98	2.33	2.97	3.50	2	5	6	2	2	9	4	7	15	15	12	4	19	3	2	1	1	2	3	-1	-1	1	-0.07	-0.08	0.52
2226892	2024-12-19 04:30:00	27	1	1.90	3.55	3.70	1.94	3.55	3.95	8	7	10	9	6	9	17	13	19	10	14	8	27	2	3	1	2	1	3	1	0	1	0.04	0.00	0.25
2226895	2024-11-10 23:15:00	27	0	3.15	3.00	2.33	3.45	3.05	2.33	3	0	1	3	2	1	6	2	2	1	5	5	7	1	2	2	3	1	1	1	1	0	0.30	0.05	0.00
2226894	2024-11-10 21:00:00	27	1	2.01	3.45	3.45	2.11	3.55	3.40	5	2	4	5	3	5	10	5	9	1	6	2	11	1	3	2	3	1	2	1	1	-1	0.10	0.10	-0.05
2226897	2024-11-10 04:00:00	27	3	2.78	3.10	2.53	2.67	3.20	2.75	14	10	3	11	6	8	25	16	11	2	11	16	27	1	2	3	3	2	1	-1	1	1	-0.11	0.10	0.22
2226899	2024-11-11 01:30:00	27	1	3.95	3.35	1.90	4.20	3.30	1.97	6	1	4	5	1	6	11	2	10	0	9	1	11	1	3	2	3	1	2	1	-1	1	0.25	-0.05	0.07
2226898	2024-11-09 21:00:00	27	3	1.19	6.60	11.00	1.24	6.20	12.00	1	5	5	3	5	5	4	10	10	13	7	7	17	3	1	1	1	2	2	1	-1	1	0.05	-0.40	1.00
2226901	2024-11-25 04:00:00	27	3	2.25	2.97	3.35	2.35	2.89	3.60	3	9	5	6	5	6	9	14	11	7	2	5	16	3	1	2	1	3	2	1	-1	1	0.10	-0.08	0.25
2226900	2024-11-09 23:15:00	27	3	1.62	3.90	4.85	1.62	4.15	5.20	0	0	2	0	2	2	0	2	4	4	2	0	4	3	2	1	1	2	3	0	1	1	0.00	0.25	0.35
2226903	2024-11-23 04:00:00	27	3	1.76	3.20	5.80	1.71	3.30	6.20	7	2	5	5	4	8	12	6	13	4	10	3	16	2	3	1	2	1	3	-1	1	1	-0.05	0.10	0.40
2226902	2024-11-23 23:15:00	27	3	1.34	4.50	9.10	1.42	4.35	8.50	1	4	9	6	3	5	7	7	14	8	8	1	15	2	2	1	1	1	3	1	-1	-1	0.08	-0.15	-0.60
2226904	2024-11-24 01:30:00	27	0	2.87	2.87	2.61	2.75	3.10	2.75	5	1	0	2	2	3	7	3	3	0	4	4	7	1	2	2	3	1	1	-1	1	1	-0.12	0.23	0.14
2226907	2024-11-24 23:15:00	27	3	2.25	3.00	3.30	2.25	3.20	3.40	0	1	1	0	2	2	0	3	3	3	0	0	3	3	1	1	1	2	2	0	1	1	0.00	0.20	0.10
2226906	2024-11-24 21:00:00	27	1	2.53	3.45	2.54	2.53	3.45	2.74	0	3	4	0	4	5	0	7	9	9	2	0	9	3	2	1	1	2	3	0	0	1	0.00	0.00	0.20
2226909	2024-11-30 23:15:00	27	1	1.86	3.00	4.80	1.87	3.20	4.95	2	3	5	3	2	4	5	5	9	4	4	0	9	2	2	1	1	1	3	1	1	1	0.01	0.20	0.15
2226908	2024-11-23 21:00:00	27	3	2.94	2.96	2.49	3.00	3.15	2.51	4	3	0	5	4	1	9	7	1	0	2	8	9	1	2	3	3	2	1	1	1	1	0.06	0.19	0.02
2226911	2024-12-02 01:30:00	27	0	2.71	2.98	2.66	2.91	3.10	2.61	1	1	1	3	1	1	4	2	2	1	3	3	5	1	2	2	3	1	1	1	1	-1	0.20	0.12	-0.05
2226910	2024-11-30 04:00:00	27	3	2.13	2.92	4.20	2.07	2.98	4.30	12	13	11	9	17	13	21	30	24	14	5	11	35	3	1	2	1	3	2	-1	1	1	-0.06	0.06	0.10
2226977	2025-02-11 04:00:00	27	1	2.14	2.99	3.60	2.26	2.99	3.65	1	9	8	6	5	3	7	14	11	9	2	5	16	3	1	2	1	3	2	1	0	1	0.12	0.00	0.05
2226976	2025-02-09 01:30:00	27	0	4.20	3.80	1.73	4.85	4.20	1.65	3	0	5	6	5	2	9	5	7	1	5	3	10	1	3	2	3	1	2	1	1	-1	0.65	0.40	-0.08
2226978	2025-02-09 04:00:00	27	1	1.89	3.70	4.00	1.93	3.65	3.85	8	7	14	10	7	11	18	14	25	15	19	8	33	2	3	1	2	1	3	1	-1	-1	0.04	-0.05	-0.15
2226945	2024-12-05 04:00:00	27	3	2.94	3.45	2.23	2.99	3.45	2.36	7	0	4	3	0	7	10	0	11	3	13	2	13	2	3	1	2	1	3	1	0	1	0.05	0.00	0.13
2226944	2024-12-22 21:00:00	27	1	2.23	3.05	3.30	2.29	3.05	3.50	0	2	2	2	3	2	2	5	4	3	0	1	5	3	1	2	1	3	2	1	0	1	0.06	0.00	0.20
2226947	2025-01-11 23:15:00	27	3	4.00	3.35	1.89	4.95	3.55	1.77	3	1	6	7	4	3	10	5	9	1	6	2	11	1	3	2	3	1	2	1	1	-1	0.95	0.20	-0.12
2226946	2025-01-14 04:00:00	27	3	2.00	3.35	3.55	2.11	3.30	3.65	7	4	9	13	3	6	20	7	15	4	17	9	24	1	3	2	3	1	2	1	-1	1	0.11	-0.05	0.10
2226949	2025-01-19 01:30:00	27	0	1.77	3.55	4.30	1.76	3.60	4.90	2	2	3	3	3	3	5	5	6	1	1	0	6	2	2	1	1	1	3	-1	1	1	-0.01	0.05	0.60
2226948	2025-01-12 04:00:00	27	1	2.11	3.15	3.45	2.16	3.30	3.55	6	2	6	7	3	6	13	5	12	4	12	5	17	1	3	2	3	1	2	1	1	1	0.05	0.15	0.10
2226951	2025-01-18 21:00:00	27	0	2.02	3.40	3.45	1.86	3.65	4.20	6	5	4	2	7	10	8	12	14	9	5	3	17	3	2	1	1	2	3	-1	1	1	-0.16	0.25	0.75
2226950	2025-01-19 21:00:00	27	0	2.68	3.00	2.66	2.80	3.15	2.66	3	1	0	2	2	0	5	3	0	0	2	5	5	1	2	3	3	2	1	1	1	0	0.12	0.15	0.00
2226953	2025-01-20 01:30:00	27	1	2.25	3.15	3.10	2.38	3.10	3.25	4	2	5	5	0	5	9	2	10	2	9	1	11	2	3	1	2	1	3	1	-1	1	0.13	-0.05	0.15
2226952	2025-01-18 23:15:00	27	3	6.90	4.00	1.46	7.50	4.00	1.50	0	1	0	3	1	1	3	2	1	0	1	2	3	1	2	3	3	2	1	1	0	1	0.60	0.00	0.04
2226955	2025-01-20 04:00:00	27	3	3.00	2.93	2.47	3.25	2.85	2.56	9	11	6	11	9	8	20	20	14	7	7	13	27	1	1	3	2	2	1	1	-1	1	0.25	-0.08	0.09
2226954	2025-01-19 23:15:00	27	3	1.14	8.10	13.00	1.15	8.20	16.00	1	6	2	2	4	3	3	10	5	9	2	7	12	3	1	2	1	3	2	1	1	1	0.01	0.10	3.00
2226956	2025-01-21 04:00:00	27	3	1.82	3.50	4.10	1.76	3.65	4.80	4	1	8	7	3	6	11	4	14	4	11	1	15	2	3	1	2	1	3	-1	1	1	-0.06	0.15	0.70
2226959	2025-01-25 23:15:00	27	1	1.67	4.15	4.80	1.67	4.10	4.80	1	1	0	0	1	1	1	2	1	1	0	1	2	2	1	2	1	3	1	0	-1	0	0.00	-0.05	0.00
2226961	2025-01-25 21:00:00	27	0	2.25	3.10	3.20	2.23	3.15	3.50	2	0	1	0	1	3	2	1	4	3	4	1	5	2	3	1	2	1	3	-1	1	1	-0.02	0.05	0.30
2226963	2025-01-26 23:15:00	27	0	1.78	3.10	5.10	1.77	3.15	6.00	2	0	0	0	1	1	2	1	1	1	2	2	3	1	2	2	3	1	1	-1	1	1	-0.01	0.05	0.90
2226962	2025-01-26 21:00:00	27	3	2.55	3.15	2.71	2.69	3.10	2.81	1	1	2	2	0	3	3	1	5	2	4	0	5	2	3	1	2	1	3	1	-1	1	0.14	-0.05	0.10
2226964	2025-01-26 04:00:00	27	0	11.00	6.20	1.22	12.00	6.50	1.23	3	4	3	3	6	2	6	10	5	7	3	8	13	2	1	3	2	3	1	1	1	1	1.00	0.30	0.01
2226973	2025-02-09 21:00:00	27	0	2.35	2.80	3.35	2.31	2.79	3.85	1	4	1	2	2	2	3	6	3	3	0	3	6	2	1	2	1	3	1	-1	-1	1	-0.04	-0.01	0.50
2226975	2025-02-08 21:00:00	27	3	2.26	3.25	3.00	2.31	3.40	3.10	1	2	5	2	4	4	3	6	9	7	4	1	10	3	2	1	1	2	3	1	1	1	0.05	0.15	0.10
2226974	2025-02-08 23:15:00	27	3	1.72	3.60	4.55	1.70	3.85	4.90	2	1	1	1	3	2	3	4	3	2	1	2	5	2	1	2	1	3	1	-1	1	1	-0.02	0.25	0.35
2227113	2024-08-18 03:30:00	27	0	4.30	3.75	1.72	4.50	3.85	1.76	4	4	4	6	3	4	10	7	8	3	6	5	13	1	3	2	3	1	2	1	1	1	0.20	0.10	0.04
2227115	2024-08-28 03:30:00	27	0	4.30	3.75	1.72	5.30	3.95	1.65	10	5	7	14	7	2	24	12	9	4	16	19	28	1	2	3	3	2	1	1	1	-1	1.00	0.20	-0.07
2227114	2024-08-25 01:00:00	27	3	1.67	3.95	4.35	1.65	4.05	5.10	3	0	2	2	2	3	5	2	5	2	5	2	7	1	3	1	2	1	2	-1	1	1	-0.02	0.10	0.75
2227117	2024-09-15 22:15:00	27	0	3.65	4.00	1.80	4.10	4.15	1.77	2	0	3	4	2	1	6	2	4	1	5	3	7	1	3	2	3	1	2	1	1	-1	0.45	0.15	-0.03
2227116	2024-08-31 23:00:00	27	3	1.22	6.00	11.00	1.23	6.50	12.00	4	2	1	2	5	2	6	7	3	3	2	6	9	2	1	3	2	3	1	1	1	1	0.01	0.50	1.00
2227119	2024-09-26 03:00:00	27	3	1.19	6.10	13.00	1.21	6.50	14.00	10	11	5	7	13	6	17	24	11	16	9	22	33	2	1	3	2	3	1	1	1	1	0.02	0.40	1.00
2227118	2024-09-23 00:30:00	27	0	3.40	4.00	1.86	3.80	4.20	1.82	4	2	10	7	5	6	11	7	16	6	10	1	17	2	3	1	2	1	3	1	1	-1	0.40	0.20	-0.04
2227121	2024-10-06 22:15:00	27	0	4.95	4.25	1.56	5.70	4.40	1.54	1	0	3	3	2	0	4	2	3	0	2	1	4	1	3	2	3	1	2	1	1	-1	0.75	0.15	-0.02
2227120	2024-09-29 03:00:00	27	3	5.40	4.30	1.51	6.40	4.50	1.49	1	3	4	7	6	3	8	9	7	4	3	5	12	2	1	3	2	3	1	1	1	-1	1.00	0.20	-0.02
2227123	2024-10-27 03:00:00	27	0	2.00	3.80	3.15	1.96	4.05	3.45	10	1	8	13	2	11	23	3	19	2	22	6	25	1	3	2	3	1	2	-1	1	1	-0.04	0.25	0.30
2227122	2024-10-21 03:00:00	27	3	1.31	5.60	9.30	1.31	5.60	9.20	1	1	3	2	2	5	3	3	8	5	5	0	8	2	2	1	1	1	3	0	0	-1	0.00	0.00	-0.10
2227125	2024-11-24 04:00:00	27	1	4.10	4.30	1.65	4.50	4.30	1.68	5	2	1	3	1	4	8	3	5	3	8	6	11	1	3	2	3	1	2	1	0	1	0.40	0.00	0.03
2227124	2024-11-11 04:00:00	27	3	4.05	4.00	1.72	4.20	3.80	1.82	10	6	9	11	4	10	21	10	19	2	13	4	23	1	3	2	3	1	2	1	-1	1	0.15	-0.20	0.10
2227127	2024-12-07 23:15:00	27	1	4.70	4.35	1.57	5.50	4.50	1.55	3	0	1	3	3	0	6	3	1	1	4	6	7	1	2	3	3	2	1	1	1	-1	0.80	0.15	-0.02
2227126	2024-11-30 21:00:00	27	0	1.10	9.00	18.00	1.16	8.60	13.00	2	5	6	3	3	3	5	8	9	9	6	5	14	3	2	1	1	2	3	1	-1	-1	0.06	-0.40	-5.00
2227129	2024-12-22 04:00:00	27	0	1.92	3.75	3.45	2.03	3.85	3.35	7	2	11	11	2	8	18	4	19	3	17	2	21	2	3	1	2	1	3	1	1	-1	0.11	0.10	-0.10
2227128	2024-12-16 04:00:00	27	0	1.14	8.50	12.00	1.15	8.50	17.00	0	4	2	2	4	2	2	8	4	6	0	4	8	3	1	2	1	3	2	1	0	1	0.01	0.00	5.00
2227131	2024-12-04 02:00:00	27	0	5.40	4.15	1.53	6.10	4.30	1.53	16	8	13	14	8	14	30	16	27	0	14	3	30	1	3	2	3	1	2	1	1	0	0.70	0.15	0.00
2227130	2025-01-19 04:00:00	27	1	6.60	4.30	1.50	7.00	4.25	1.49	3	2	1	6	2	2	9	4	3	0	5	6	9	1	2	3	3	2	1	1	-1	-1	0.40	-0.05	-0.01
2227132	2025-01-27 04:00:00	27	3	1.19	6.80	11.00	1.21	7.10	12.00	8	3	3	6	10	4	14	13	7	8	9	15	22	1	2	3	3	2	1	1	1	1	0.02	0.30	1.00
2044446	2024-05-13 01:00:00	28	0	2.51	3.05	2.82	2.52	3.05	2.80	1	2	2	3	1	2	4	3	4	1	2	1	5	1	3	1	2	1	2	1	0	-1	0.01	0.00	-0.02
2244643	2024-12-21 04:15:00	28	3	2.38	3.10	2.95	2.47	3.00	2.91	0	3	4	2	2	4	2	5	8	6	3	0	8	3	2	1	1	2	3	1	-1	-1	0.09	-0.10	-0.04
2244646	2024-12-22 02:00:00	28	1	2.25	3.05	3.05	2.26	3.10	3.20	3	1	3	3	2	4	6	3	7	3	6	2	9	2	3	1	2	1	3	1	1	1	0.01	0.05	0.15
2044442	2024-05-04 22:30:00	28	3	2.73	3.15	2.54	2.70	3.15	2.56	4	0	5	5	0	5	9	0	10	1	10	0	10	2	3	1	2	1	3	-1	0	1	-0.03	0.00	0.02
2044441	2024-05-04 03:15:00	28	3	2.08	3.30	3.40	2.13	3.25	3.30	0	2	3	3	1	0	3	3	3	1	1	1	4	1	1	1	1	1	1	1	-1	-1	0.05	-0.05	-0.10
2044440	2024-05-05 03:30:00	28	0	9.30	5.60	1.26	10.00	6.10	1.22	5	3	7	8	8	3	13	11	10	5	7	8	18	1	2	3	3	2	1	1	1	-1	0.70	0.50	-0.04
2044439	2024-05-06 03:30:00	28	3	6.50	4.70	1.40	6.20	4.85	1.40	10	5	7	10	8	5	20	13	12	5	12	13	25	1	2	3	3	2	1	-1	1	0	-0.30	0.15	0.00
2244649	2024-12-22 04:30:00	28	0	6.30	3.85	1.47	6.70	3.85	1.49	4	3	1	4	3	2	8	6	3	1	3	6	9	1	2	3	3	2	1	1	0	1	0.40	0.00	0.02
2244655	2024-12-24 02:45:00	28	1	1.50	4.00	6.10	1.49	4.05	6.30	2	3	5	4	3	6	6	6	11	6	6	1	12	2	2	1	1	1	3	-1	1	1	-0.01	0.05	0.20
2244652	2024-12-24 04:45:00	28	3	2.33	3.25	2.74	2.38	3.25	2.86	0	1	3	1	1	3	1	2	6	5	4	0	6	3	2	1	1	2	3	1	0	1	0.05	0.00	0.12
2044430	2024-04-28 01:00:00	28	3	1.53	4.30	5.20	1.54	4.25	5.10	1	2	2	2	2	1	3	4	3	4	3	4	7	2	1	2	1	3	1	1	-1	-1	0.01	-0.05	-0.10
2244659	2024-12-24 02:45:00	28	3	1.08	9.00	16.00	1.10	9.60	15.00	1	5	5	3	4	3	4	9	8	7	2	3	11	3	1	2	1	3	2	1	1	-1	0.02	0.60	-1.00
2044429	2024-04-29 03:30:00	28	1	2.49	3.40	2.59	2.51	3.50	2.54	6	2	5	4	3	5	10	5	10	3	8	3	13	1	3	1	2	1	2	1	1	-1	0.02	0.10	-0.05
2244662	2024-12-29 04:30:00	28	3	1.10	8.70	18.00	1.15	7.00	15.00	6	20	14	11	11	11	17	31	25	29	15	21	46	3	1	2	1	3	2	1	-1	-1	0.05	-1.70	-3.00
2044426	2024-04-22 03:30:00	28	3	1.29	5.40	8.60	1.29	5.50	8.30	2	3	12	3	3	6	5	6	18	13	12	0	18	3	2	1	1	2	3	0	1	-1	0.00	0.10	-0.30
2244665	2024-12-29 23:30:00	28	3	2.21	3.30	3.10	2.19	3.30	3.10	1	0	0	1	0	0	2	0	0	0	2	2	2	1	2	2	3	1	1	-1	0	0	-0.02	0.00	0.00
2044419	2024-04-21 03:30:00	28	3	1.26	5.70	9.20	1.26	5.90	9.10	3	2	8	3	5	7	6	7	15	11	10	2	17	3	2	1	1	2	3	0	1	-1	0.00	0.20	-0.10
2244670	2024-12-28 23:30:00	28	1	2.44	3.05	2.90	2.44	3.05	2.91	0	1	0	0	0	2	0	1	2	2	1	0	2	3	2	1	1	2	3	0	0	1	0.00	0.00	0.01
2244668	2024-12-31 04:15:00	28	0	2.59	2.98	2.79	2.79	2.88	2.67	5	9	8	13	4	7	18	13	15	1	6	4	19	1	3	2	3	1	2	1	-1	-1	0.20	-0.10	-0.12
2044416	2024-04-13 22:30:00	28	1	1.53	3.95	5.90	1.53	3.95	5.90	0	1	0	0	0	1	0	1	1	1	0	0	1	3	1	1	1	2	2	0	0	0	0.00	0.00	0.00
2244609	2024-12-08 23:30:00	28	1	2.44	3.20	2.78	2.44	3.20	2.79	0	0	1	0	0	1	0	0	2	2	2	0	2	2	2	1	1	1	3	0	0	1	0.00	0.00	0.01
2244614	2024-12-16 04:30:00	28	0	2.56	3.05	2.78	2.78	2.83	2.72	4	10	5	10	1	9	14	11	14	3	6	3	17	1	3	1	2	1	2	1	-1	-1	0.22	-0.22	-0.06
2244618	2024-12-17 04:15:00	28	3	1.14	7.30	13.00	1.15	7.00	15.00	3	5	5	4	5	4	7	10	9	7	4	5	14	3	1	2	1	3	2	1	-1	1	0.01	-0.30	2.00
2244621	2024-12-15 02:00:00	28	3	2.75	3.10	2.53	2.78	3.10	2.53	7	1	7	6	1	7	13	2	14	1	12	0	14	2	3	1	2	1	3	1	0	0	0.03	0.00	0.00
2244626	2024-12-16 02:00:00	28	1	14.00	6.90	1.15	15.00	7.10	1.15	2	1	1	3	4	0	5	5	1	2	2	6	7	1	1	3	2	2	1	1	1	0	1.00	0.20	0.00
2244625	2024-12-17 04:45:00	28	1	3.25	3.25	2.17	3.60	3.25	2.03	12	8	19	16	10	14	28	18	33	7	17	2	35	2	3	1	2	1	3	1	0	-1	0.35	0.00	-0.14
2244631	2024-12-17 02:45:00	28	1	1.47	4.25	6.20	1.46	4.15	6.60	2	3	6	2	4	8	4	7	14	13	10	3	17	3	2	1	1	2	3	-1	-1	1	-0.01	-0.10	0.40
2244628	2024-12-15 23:30:00	28	3	3.15	3.00	2.31	3.20	3.00	2.31	2	1	0	3	0	0	5	1	0	1	5	6	6	1	2	3	3	2	1	1	0	0	0.05	0.00	0.00
2244634	2024-12-14 23:30:00	28	0	2.75	2.99	2.62	2.75	2.94	2.66	4	4	1	2	2	5	6	6	6	2	2	2	8	1	1	1	1	1	1	0	-1	1	0.00	-0.05	0.04
2244639	2024-12-23 01:00:00	28	0	2.83	3.10	2.36	2.99	3.05	2.38	2	1	2	6	0	1	8	1	3	0	7	5	8	1	3	2	3	1	2	1	-1	1	0.16	-0.05	0.02
2244637	2024-12-21 23:30:00	28	0	1.80	3.40	4.00	1.84	3.30	4.30	1	2	2	2	0	2	3	2	4	2	3	1	5	2	3	1	2	1	3	1	-1	1	0.04	-0.10	0.30
2244704	2025-01-04 23:30:00	28	1	1.86	3.20	4.35	1.88	3.20	4.30	4	1	3	3	1	5	7	2	8	1	6	0	8	2	3	1	2	1	3	1	0	-1	0.02	0.00	-0.05
2244705	2025-01-05 02:00:00	28	0	1.40	4.50	6.90	1.44	4.50	6.20	4	6	8	7	5	4	11	11	12	9	9	8	20	2	2	1	1	1	3	1	0	-1	0.04	0.00	-0.70
2244708	2025-01-20 04:30:00	28	3	7.10	4.35	1.40	7.10	4.30	1.41	12	10	6	12	8	7	24	18	13	4	10	15	28	1	2	3	3	2	1	0	-1	1	0.00	-0.05	0.01
2244716	2025-01-21 04:15:00	28	0	3.15	3.10	2.28	3.15	3.05	2.29	6	2	6	7	2	7	13	4	13	3	12	3	16	1	3	1	2	1	2	0	-1	1	0.00	-0.05	0.01
2244720	2025-01-18 04:15:00	28	3	1.19	6.40	12.00	1.19	6.40	12.00	3	6	4	5	5	4	8	11	8	5	2	5	13	2	1	2	1	3	1	0	0	0	0.00	0.00	0.00
2244674	2024-12-29 23:30:00	28	1	3.85	3.40	1.90	3.85	3.40	1.89	4	2	3	4	2	2	8	4	5	2	6	5	10	1	3	2	3	1	2	0	0	-1	0.00	0.00	-0.01
2244679	2024-12-30 02:00:00	28	0	1.40	4.40	7.00	1.45	4.20	6.40	2	6	6	4	4	4	6	10	10	7	3	3	13	3	1	1	1	2	2	1	-1	-1	0.05	-0.20	-0.60
2244676	2024-12-28 04:15:00	28	1	2.31	3.05	3.10	2.42	3.05	2.96	3	0	2	2	0	2	5	0	4	0	5	1	5	1	3	2	3	1	2	1	0	-1	0.11	0.00	-0.14
2244681	2024-12-29 02:00:00	28	1	2.92	3.10	2.42	2.67	3.00	2.67	9	3	7	9	1	11	18	4	18	1	15	1	19	1	3	1	2	1	2	-1	-1	1	-0.25	-0.10	0.25
2244685	2025-01-05 04:30:00	28	0	2.74	3.10	2.55	3.15	2.88	2.42	7	11	10	15	8	7	22	19	17	7	10	12	29	1	2	3	3	2	1	1	-1	-1	0.41	-0.22	-0.13
2244691	2025-01-07 04:15:00	28	1	2.25	3.15	3.15	2.19	3.05	3.35	7	1	6	4	0	7	11	1	13	3	13	1	14	2	3	1	2	1	3	-1	-1	1	-0.06	-0.10	0.20
2244688	2025-01-06 04:30:00	28	0	2.28	3.10	3.10	2.35	2.93	3.20	4	13	10	4	10	12	8	23	22	25	10	11	33	3	1	2	1	3	2	1	-1	1	0.07	-0.17	0.10
2244694	2025-01-06 02:00:00	28	1	2.36	2.92	3.20	2.20	2.97	3.45	3	3	4	1	7	4	4	10	8	6	0	2	10	3	1	2	1	3	2	-1	1	1	-0.16	0.05	0.25
2244700	2025-01-05 23:30:00	28	1	1.68	3.35	5.40	1.68	3.35	5.40	1	0	0	0	0	1	1	0	1	0	1	0	1	1	3	1	2	1	2	0	0	0	0.00	0.00	0.00
2244790	2025-02-11 04:15:00	28	1	2.01	3.30	3.55	2.07	3.20	3.55	8	5	9	11	4	8	19	9	17	4	14	6	23	1	3	2	3	1	2	1	-1	0	0.06	-0.10	0.00
2215041	2024-06-03 02:45:00	28	3	2.33	3.30	2.58	2.45	3.35	2.55	4	0	8	8	1	5	12	1	13	1	12	0	13	2	3	1	2	1	3	1	1	-1	0.12	0.05	-0.03
2244747	2025-01-26 02:00:00	28	3	6.70	4.65	1.40	6.70	4.50	1.41	6	4	3	3	1	5	9	5	8	1	5	2	10	1	3	2	3	1	2	0	-1	1	0.00	-0.15	0.01
2244745	2025-01-27 02:00:00	28	1	1.43	4.15	7.30	1.50	4.00	6.10	2	6	11	6	4	4	8	10	15	8	6	1	16	3	2	1	1	2	3	1	-1	-1	0.07	-0.15	-1.20
2044155	2023-08-21 01:00:00	28	3	1.11	8.30	19.00	1.13	7.80	16.00	2	3	3	3	3	2	5	6	5	1	0	1	6	2	1	2	1	3	1	1	-1	-1	0.02	-0.50	-3.00
2245319	2024-08-20 03:15:00	28	0	2.47	3.15	2.80	2.54	3.15	2.71	6	0	5	6	0	6	12	0	11	0	12	1	12	1	3	2	3	1	2	1	0	-1	0.07	0.00	-0.09
2044152	2023-08-20 01:00:00	28	0	4.50	3.90	1.65	4.60	3.95	1.64	2	2	3	5	3	2	7	5	5	0	2	2	7	1	2	2	3	1	1	1	1	-1	0.10	0.05	-0.01
2044150	2023-08-20 03:30:00	28	3	1.09	11.00	14.00	1.08	9.50	19.00	1	8	6	2	3	5	3	11	11	10	2	2	13	3	1	1	1	2	2	-1	-1	1	-0.01	-1.50	5.00
2044149	2023-08-13 03:30:00	28	3	1.16	6.80	15.00	1.15	7.10	13.00	4	7	4	3	6	5	7	13	9	6	0	4	13	3	1	2	1	3	2	-1	1	-1	-0.01	0.30	-2.00
2044144	2023-08-14 01:00:00	28	0	2.49	3.10	2.82	2.59	3.10	2.70	4	1	4	4	1	4	8	2	8	0	6	0	8	1	3	1	2	1	2	1	0	-1	0.10	0.00	-0.12
2044142	2023-08-15 03:45:00	28	3	11.00	5.80	1.24	9.60	5.60	1.26	4	4	2	3	2	4	7	6	6	2	3	3	9	1	2	2	3	1	1	-1	-1	1	-1.40	-0.20	0.02
2044141	2023-08-14 03:30:00	28	3	2.16	3.20	3.25	2.19	3.15	3.25	1	2	3	2	1	2	3	3	5	3	3	1	6	2	2	1	1	1	3	1	-1	0	0.03	-0.05	0.00
2044191	2023-09-24 03:30:00	28	3	1.19	6.40	10.00	1.22	6.10	10.00	2	5	3	4	4	2	6	9	5	3	0	4	9	2	1	3	2	3	1	1	-1	0	0.03	-0.30	0.00
2244386	2024-08-17 00:00:00	28	0	6.50	4.35	1.44	6.50	4.35	1.44	1	1	1	2	1	1	3	2	2	0	1	1	3	1	2	2	3	1	1	0	0	0	0.00	0.00	0.00
2244384	2024-08-19 03:30:00	28	0	4.60	4.05	1.63	4.70	4.00	1.62	3	4	3	4	3	2	7	7	5	2	2	4	9	1	1	3	2	2	1	1	-1	-1	0.10	-0.05	-0.01
2244385	2024-08-18 03:30:00	28	3	1.16	6.90	14.00	1.21	5.90	12.00	3	11	5	6	4	4	9	15	9	11	5	11	20	2	1	2	1	3	1	1	-1	-1	0.05	-1.00	-2.00
2244390	2024-08-26 03:30:00	28	3	1.58	3.75	4.95	1.69	3.90	4.35	0	3	6	5	2	2	5	5	8	3	3	0	8	2	2	1	1	1	3	1	1	-1	0.11	0.15	-0.60
2044185	2023-09-17 03:30:00	28	0	7.60	5.30	1.32	6.90	5.10	1.35	2	2	0	1	0	2	3	2	2	0	1	1	3	1	2	2	3	1	1	-1	-1	1	-0.70	-0.20	0.03
2244389	2024-08-25 01:00:00	28	3	1.24	5.70	11.00	1.24	5.70	11.00	2	2	0	2	3	0	4	5	0	1	0	5	5	2	1	3	2	3	1	0	0	0	0.00	0.00	0.00
2044180	2023-09-17 22:30:00	28	3	2.16	3.45	3.05	2.16	3.45	3.05	0	0	1	1	1	0	1	1	1	0	0	0	1	1	1	1	1	1	1	0	0	0	0.00	0.00	0.00
2044176	2023-09-04 01:00:00	28	1	1.27	5.60	8.70	1.24	5.90	9.90	8	6	6	7	7	8	15	13	14	0	2	1	15	1	3	2	3	1	2	-1	1	1	-0.03	0.30	1.20
2244397	2024-09-02 03:30:00	28	1	4.15	3.75	1.75	3.60	3.70	1.88	7	3	0	0	2	6	7	5	6	2	4	3	9	1	3	2	3	1	2	-1	-1	1	-0.55	-0.05	0.13
2244400	2024-08-31 03:15:00	28	1	6.80	4.20	1.44	6.60	4.15	1.45	5	2	3	4	2	3	9	4	6	1	6	4	10	1	3	2	3	1	2	-1	-1	1	-0.20	-0.05	0.01
2044169	2023-09-04 03:30:00	28	1	2.96	3.45	2.21	3.05	3.50	2.16	3	1	1	2	1	1	5	2	2	0	3	3	5	1	2	2	3	1	1	1	1	-1	0.09	0.05	-0.05
2044168	2023-09-03 03:30:00	28	3	1.19	6.50	11.00	1.22	6.10	10.00	2	4	3	3	3	3	5	7	6	4	2	3	9	3	1	2	1	3	2	1	-1	-1	0.03	-0.40	-1.00
2044166	2023-08-28 03:30:00	28	3	1.21	5.80	12.00	1.25	5.70	9.60	1	1	2	3	1	1	4	2	3	2	4	3	6	1	3	2	3	1	2	1	-1	-1	0.04	-0.10	-2.40
2244411	2024-09-16 03:30:00	28	0	2.00	3.25	3.65	2.20	3.20	3.20	2	3	8	6	2	3	8	5	11	5	8	2	13	2	3	1	2	1	3	1	-1	-1	0.20	-0.05	-0.45
2044164	2023-08-29 03:15:00	28	0	7.10	4.40	1.41	7.80	4.50	1.37	10	7	7	10	10	5	20	17	12	0	3	8	20	1	2	3	3	2	1	1	1	-1	0.70	0.10	-0.04
2044163	2023-09-10 01:00:00	28	0	4.00	3.85	1.75	3.80	3.75	1.81	2	2	1	2	1	2	4	3	3	0	1	1	4	1	2	2	3	1	1	-1	-1	1	-0.20	-0.10	0.06
2044162	2023-08-27 03:30:00	28	0	9.50	5.30	1.27	8.10	5.20	1.30	13	7	4	7	5	7	20	12	11	0	8	9	20	1	2	3	3	2	1	-1	-1	1	-1.40	-0.10	0.03
2044221	2023-10-30 04:30:00	28	0	6.90	4.40	1.43	5.90	4.20	1.50	6	5	3	4	3	6	10	8	9	0	2	1	10	1	3	2	3	1	2	-1	-1	1	-1.00	-0.20	0.07
2044217	2023-10-29 03:30:00	28	1	3.70	3.90	1.75	4.15	4.00	1.70	5	2	5	8	5	1	13	7	6	3	9	10	16	1	2	3	3	2	1	1	1	-1	0.45	0.10	-0.05
2044215	2023-10-31 04:15:00	28	0	5.60	4.25	1.47	6.40	4.40	1.44	11	9	9	13	10	8	24	19	17	2	7	9	26	1	2	3	3	2	1	1	1	-1	0.80	0.15	-0.03
2044214	2023-10-29 01:00:00	28	1	1.19	6.00	11.00	1.18	6.50	13.00	1	2	0	2	3	2	3	5	2	2	0	3	5	2	1	3	2	3	1	-1	1	1	-0.01	0.50	2.00
2044208	2023-10-08 22:30:00	28	0	2.46	3.20	2.79	2.46	3.20	2.79	1	0	1	0	1	0	1	1	1	0	0	0	1	1	1	1	1	1	1	0	0	0	0.00	0.00	0.00
2044206	2023-10-08 03:30:00	28	0	9.90	5.60	1.25	8.50	5.50	1.28	11	6	7	11	7	8	22	13	15	0	9	7	22	1	3	2	3	1	2	-1	-1	1	-1.40	-0.10	0.03
2244374	2024-08-11 01:00:00	28	0	1.98	3.35	3.65	2.06	3.25	3.50	2	3	4	6	1	2	8	4	6	2	6	4	10	1	3	2	3	1	2	1	-1	-1	0.08	-0.10	-0.15
2244375	2024-08-12 01:00:00	28	3	6.70	4.50	1.41	6.90	4.50	1.40	2	1	3	4	1	1	6	2	4	0	4	2	6	1	3	2	3	1	2	1	0	-1	0.20	0.00	-0.01
2244372	2024-08-11 03:30:00	28	3	1.18	6.60	14.00	1.20	6.20	12.00	4	7	4	5	5	3	9	12	7	4	1	6	13	2	1	3	2	3	1	1	-1	-1	0.02	-0.40	-2.00
2244373	2024-08-11 22:30:00	28	0	2.26	3.10	3.20	2.31	3.05	3.10	1	2	3	3	1	1	4	3	4	0	1	0	4	1	3	1	2	1	2	1	-1	-1	0.05	-0.05	-0.10
2244378	2024-08-10 22:30:00	28	1	2.26	3.25	3.05	2.26	3.25	3.05	1	0	0	0	0	1	1	0	1	0	1	0	1	1	3	1	2	1	2	0	0	0	0.00	0.00	0.00
2244379	2024-08-12 03:30:00	28	1	1.37	4.70	7.10	1.42	4.45	6.60	3	7	12	7	4	6	10	11	18	10	9	2	20	3	2	1	1	2	3	1	-1	-1	0.05	-0.25	-0.50
2244376	2024-08-13 03:15:00	28	0	2.80	3.35	2.35	2.66	3.35	2.47	6	1	4	5	1	3	11	2	7	0	9	4	11	1	3	2	3	1	2	-1	0	1	-0.14	0.00	0.12
2244377	2024-08-12 01:00:00	28	0	2.85	3.15	2.42	2.81	3.15	2.47	4	0	2	1	0	3	5	0	5	1	6	1	6	1	3	1	2	1	2	-1	0	1	-0.04	0.00	0.05
2044195	2023-09-30 03:15:00	28	3	2.07	3.50	3.20	2.03	3.50	3.30	1	1	3	2	3	1	3	4	4	3	2	2	6	3	1	1	1	2	2	-1	0	1	-0.04	0.00	0.10
2044194	2023-09-26 03:15:00	28	3	1.18	6.60	12.00	1.20	6.30	11.00	3	4	2	5	2	2	8	6	4	0	2	4	8	1	2	3	3	2	1	1	-1	-1	0.02	-0.30	-1.00
2044254	2023-12-12 04:15:00	28	1	2.78	3.40	2.36	2.92	3.35	2.28	9	1	10	10	0	11	19	1	21	2	20	0	21	2	3	1	2	1	3	1	-1	-1	0.14	-0.05	-0.08
2044251	2023-12-10 23:30:00	28	3	2.28	3.30	2.94	2.28	3.30	2.94	0	1	1	1	0	0	1	1	1	0	0	0	1	1	1	1	1	1	1	0	0	0	0.00	0.00	0.00
2044248	2023-12-05 04:15:00	28	3	1.16	7.60	12.00	1.17	7.40	11.00	4	4	3	3	6	4	7	10	7	4	1	4	11	2	1	2	1	3	1	1	-1	-1	0.01	-0.20	-1.00
2044245	2023-12-04 02:00:00	28	1	5.60	4.30	1.48	5.70	4.35	1.47	3	2	4	4	5	2	7	7	6	1	1	2	8	1	1	3	2	2	1	1	1	-1	0.10	0.05	-0.01
2044244	2023-12-03 02:00:00	28	0	4.75	3.75	1.66	4.80	3.80	1.64	5	3	7	7	3	4	12	6	11	1	7	2	13	1	3	2	3	1	2	1	1	-1	0.05	0.05	-0.02
2244462	2024-09-30 03:30:00	28	3	1.41	4.50	6.70	1.49	4.30	5.50	2	8	10	8	3	3	10	11	13	6	5	3	16	3	2	1	1	2	3	1	-1	-1	0.08	-0.20	-1.20
2044241	2023-12-03 23:30:00	28	3	1.34	5.10	7.30	1.34	5.10	7.20	2	0	2	2	0	3	4	0	5	2	6	1	6	2	3	1	2	1	3	0	0	-1	0.00	0.00	-0.10
2044238	2023-11-12 04:30:00	28	0	4.60	3.75	1.68	4.50	3.50	1.74	5	7	1	5	2	4	10	9	5	1	2	6	11	1	2	3	3	2	1	-1	-1	1	-0.10	-0.25	0.06
2244464	2024-09-29 03:30:00	28	3	1.19	6.50	12.00	1.19	6.50	12.00	0	2	0	0	3	0	0	5	0	5	0	5	5	2	1	2	1	3	1	0	0	0	0.00	0.00	0.00
2044235	2023-11-12 02:00:00	28	0	2.52	3.20	2.71	2.68	3.15	2.55	2	1	6	6	0	2	8	1	8	0	7	0	8	1	3	1	2	1	2	1	-1	-1	0.16	-0.05	-0.16
2044232	2023-11-13 04:30:00	28	3	2.20	3.40	3.05	2.46	3.30	2.70	0	2	6	5	1	1	5	3	7	3	5	1	8	2	3	1	2	1	3	1	-1	-1	0.26	-0.10	-0.35
2044231	2023-11-13 02:00:00	28	0	4.70	4.15	1.59	4.70	4.15	1.59	0	0	0	0	0	0	0	0	0	1	1	1	1	1	1	1	1	1	1	0	0	0	0.00	0.00	0.00
2044230	2023-11-06 04:30:00	28	3	1.24	5.90	9.90	1.21	6.20	10.00	6	3	3	3	5	5	9	8	8	4	5	5	13	1	2	2	3	1	1	-1	1	1	-0.03	0.30	0.10
2044226	2023-11-04 04:15:00	28	0	1.15	7.10	13.00	1.18	6.70	12.00	10	12	9	12	12	9	22	24	18	11	9	15	33	2	1	3	2	3	1	1	-1	-1	0.03	-0.40	-1.00
2244476	2024-10-05 22:30:00	28	3	2.45	3.05	2.92	2.47	2.99	2.94	2	3	2	3	2	3	5	5	5	0	0	0	5	1	1	1	1	1	1	1	-1	1	0.02	-0.06	0.02
2044287	2024-01-14 02:00:00	28	0	9.40	5.80	1.24	10.00	6.00	1.23	2	3	2	5	4	1	7	7	3	6	6	10	13	1	1	3	2	2	1	1	1	-1	0.60	0.20	-0.01
2044286	2024-01-13 23:30:00	28	0	2.40	3.10	2.95	2.44	3.05	2.90	0	1	2	2	0	0	2	1	2	0	1	0	2	1	3	1	2	1	2	1	-1	-1	0.04	-0.05	-0.05
2044285	2024-01-15 02:00:00	28	3	1.16	6.80	14.00	1.19	6.30	13.00	3	5	2	5	3	1	8	8	3	1	1	6	9	1	1	3	2	2	1	1	-1	-1	0.03	-0.50	-1.00
2044284	2024-01-06 02:45:00	28	3	1.23	6.20	9.40	1.25	6.00	9.00	10	6	13	8	7	21	18	13	34	20	25	4	38	2	3	1	2	1	3	1	-1	-1	0.02	-0.20	-0.40
2044283	2024-01-06 23:30:00	28	3	2.11	3.55	3.10	2.13	3.50	3.05	3	1	2	2	1	4	5	2	6	2	5	1	7	2	3	1	2	1	3	1	-1	-1	0.02	-0.05	-0.05
2044282	2024-01-08 02:00:00	28	3	1.83	3.50	4.00	1.82	3.50	4.05	3	1	2	2	1	2	5	2	4	0	3	1	5	1	3	2	3	1	2	-1	0	1	-0.01	0.00	0.05
2044281	2024-01-09 04:15:00	28	0	1.95	3.25	3.85	1.81	3.35	4.35	11	3	3	1	5	11	12	8	14	6	10	4	18	2	3	1	2	1	3	-1	1	1	-0.14	0.10	0.50
2044280	2024-01-08 04:30:00	28	1	1.70	3.70	4.55	1.75	3.55	4.40	0	3	3	2	0	4	2	3	7	5	4	0	7	3	2	1	1	2	3	1	-1	-1	0.05	-0.15	-0.15
2044279	2024-01-06 23:30:00	28	1	2.54	3.20	2.67	2.63	3.20	2.58	2	0	3	4	0	1	6	0	4	0	6	2	6	1	3	2	3	1	2	1	0	-1	0.09	0.00	-0.09
2044278	2024-01-07 04:30:00	28	1	1.57	4.15	4.95	1.73	3.85	4.15	0	6	6	4	1	6	4	7	12	13	10	5	17	3	2	1	1	2	3	1	-1	-1	0.16	-0.30	-0.80
2044277	2024-01-06 04:45:00	28	1	6.30	4.45	1.44	6.00	4.20	1.48	12	8	8	12	6	7	24	14	15	2	12	11	26	1	3	2	3	1	2	-1	-1	1	-0.30	-0.25	0.04
2044276	2023-12-23 23:30:00	28	1	2.79	3.15	2.46	2.81	3.15	2.45	0	0	2	2	0	0	2	0	2	0	2	0	2	1	3	1	2	1	2	1	0	-1	0.02	0.00	-0.01
2044275	2024-01-07 02:00:00	28	0	5.80	4.30	1.48	5.80	4.30	1.47	3	4	4	3	3	4	6	7	8	4	3	2	10	3	2	1	1	2	3	0	0	-1	0.00	0.00	-0.01
2044274	2023-12-23 23:30:00	28	3	1.70	3.75	4.45	1.69	3.75	4.50	1	0	1	1	0	1	2	0	2	0	2	0	2	1	3	1	2	1	2	-1	0	1	-0.01	0.00	0.05
2044273	2023-12-31 04:30:00	28	0	8.50	5.30	1.29	8.90	5.40	1.28	6	2	3	9	3	2	15	5	5	1	11	11	16	1	2	2	3	1	1	1	1	-1	0.40	0.10	-0.01
2044272	2023-12-30 23:30:00	28	3	2.23	3.35	2.99	2.23	3.35	2.99	0	1	1	1	0	0	1	1	1	0	0	0	1	1	1	1	1	1	1	0	0	0	0.00	0.00	0.00
2044271	2023-12-30 04:45:00	28	3	1.14	7.90	13.00	1.17	6.80	14.00	8	16	8	10	15	9	18	31	17	17	4	18	35	2	1	3	2	3	1	1	-1	1	0.03	-1.10	1.00
2244434	2024-09-21 03:15:00	28	0	4.30	3.75	1.72	4.40	3.80	1.69	5	4	5	6	5	2	11	9	7	1	3	5	12	1	2	3	3	2	1	1	1	-1	0.10	0.05	-0.03
2044270	2023-12-29 04:15:00	28	0	2.57	3.20	2.65	2.66	3.20	2.56	12	0	9	10	0	11	22	0	20	1	23	3	23	1	3	2	3	1	2	1	0	-1	0.09	0.00	-0.09
2044269	2023-12-30 23:30:00	28	3	2.05	3.60	3.20	1.96	3.70	3.35	5	2	3	3	4	4	8	6	7	3	5	4	11	1	3	2	3	1	2	-1	1	1	-0.09	0.10	0.15
2044268	2023-12-31 02:00:00	28	0	4.95	3.95	1.61	4.85	3.90	1.62	3	1	0	0	0	2	3	1	2	0	2	1	3	1	3	2	3	1	2	-1	-1	1	-0.10	-0.05	0.01
2044267	2023-12-30 02:45:00	28	3	1.29	5.40	8.30	1.25	5.40	10.00	5	4	6	2	4	8	7	8	14	9	8	2	16	3	2	1	1	2	3	-1	0	1	-0.04	0.00	1.70
2044266	2023-12-19 04:15:00	28	3	2.19	3.35	3.05	2.19	3.40	3.05	2	5	8	2	6	7	4	11	15	19	12	8	23	3	2	1	1	2	3	0	1	0	0.00	0.05	0.00
2244443	2024-09-24 03:15:00	28	0	10.00	5.60	1.24	9.40	5.60	1.25	10	5	7	9	5	7	19	10	14	1	10	6	20	1	3	2	3	1	2	-1	0	1	-0.60	0.00	0.01
2044261	2023-12-17 04:30:00	28	1	3.55	3.45	1.96	3.55	3.45	1.97	3	3	3	5	3	4	8	6	7	2	4	3	10	1	3	2	3	1	2	0	0	1	0.00	0.00	0.01
2244441	2024-09-22 01:00:00	28	0	3.15	3.20	2.21	3.65	3.30	1.99	3	1	5	4	3	2	7	4	7	3	6	3	10	1	3	1	2	1	2	1	1	-1	0.50	0.10	-0.22
2044259	2023-12-18 04:30:00	28	0	2.80	3.50	2.29	2.67	3.60	2.35	14	5	1	9	7	1	23	12	2	0	11	21	23	1	2	3	3	2	1	-1	1	1	-0.13	0.10	0.06
2044256	2023-12-10 02:00:00	28	3	4.90	4.05	1.60	4.35	3.90	1.68	8	2	3	4	1	5	12	3	8	0	9	4	12	1	3	2	3	1	2	-1	-1	1	-0.55	-0.15	0.08
2044318	2024-02-04 04:30:00	28	1	1.20	6.20	13.00	1.25	5.50	9.70	5	11	9	10	4	6	15	15	15	5	5	5	20	1	1	1	1	1	1	1	-1	-1	0.05	-0.70	-3.30
2044314	2024-02-06 04:15:00	28	1	2.19	3.30	3.10	2.25	3.30	3.00	2	1	3	3	1	2	5	2	5	2	5	2	7	1	3	1	2	1	2	1	0	-1	0.06	0.00	-0.10
2044313	2024-02-05 04:30:00	28	3	1.43	4.60	6.10	1.48	4.25	5.90	3	6	5	6	3	5	9	9	10	4	4	3	13	2	2	1	1	1	3	1	-1	-1	0.05	-0.35	-0.20
2044312	2024-02-05 02:00:00	28	3	1.15	7.30	15.00	1.14	7.50	15.00	3	3	2	3	3	2	6	6	4	2	2	4	8	1	1	3	2	2	1	-1	1	0	-0.01	0.20	0.00
2044310	2024-01-29 02:00:00	28	0	8.30	4.60	1.35	8.30	4.60	1.35	6	3	5	8	5	3	14	8	8	3	9	9	17	1	2	2	3	1	1	0	0	0	0.00	0.00	0.00
2044309	2024-02-01 02:45:00	28	1	2.16	3.25	3.20	2.25	3.20	3.10	0	2	3	3	0	1	3	2	4	1	2	0	4	2	3	1	2	1	3	1	-1	-1	0.09	-0.05	-0.10
2044308	2024-01-28 23:30:00	28	3	2.31	3.15	3.05	2.31	3.15	3.00	1	3	2	2	2	0	3	5	2	4	2	5	7	2	1	3	2	3	1	0	0	-1	0.00	0.00	-0.05
2044307	2024-01-29 04:30:00	28	3	3.20	3.30	2.17	3.15	3.25	2.20	2	1	0	0	0	2	2	1	2	0	1	0	2	1	3	1	2	1	2	-1	-1	1	-0.05	-0.05	0.03
2044305	2024-02-01 04:45:00	28	1	1.25	5.60	9.30	1.27	5.40	8.80	8	10	17	9	9	15	17	19	32	15	13	0	32	3	2	1	1	2	3	1	-1	-1	0.02	-0.20	-0.50
2044304	2024-01-29 04:30:00	28	3	2.04	3.35	3.45	1.93	3.45	3.65	6	4	4	5	6	5	11	10	9	7	8	9	18	1	2	3	3	2	1	-1	1	1	-0.11	0.10	0.20
2044303	2024-01-28 23:30:00	28	0	1.93	3.40	3.70	1.97	3.35	3.65	2	1	1	4	0	0	6	1	1	0	5	5	6	1	2	2	3	1	1	1	-1	-1	0.04	-0.05	-0.05
2044302	2024-01-19 04:45:00	28	0	8.20	4.85	1.33	9.50	5.20	1.29	11	5	8	16	8	4	27	13	12	0	14	15	27	1	2	3	3	2	1	1	1	-1	1.30	0.35	-0.04
2044301	2024-01-22 04:30:00	28	3	1.59	3.85	5.20	1.60	3.90	5.00	2	2	5	2	3	3	4	5	8	6	5	2	10	3	2	1	1	2	3	1	1	-1	0.01	0.05	-0.20
2044300	2024-01-21 23:30:00	28	0	2.40	3.25	2.79	2.37	3.20	2.89	3	2	0	2	0	5	5	2	5	0	3	0	5	1	3	1	2	1	2	-1	-1	1	-0.03	-0.05	0.10
2044299	2024-01-21 04:30:00	28	3	1.26	5.40	9.60	1.36	4.55	8.00	6	16	25	14	5	19	20	21	44	24	23	0	44	3	2	1	1	2	3	1	-1	-1	0.10	-0.85	-1.60
2044297	2024-01-20 23:30:00	28	0	2.36	3.30	2.84	2.38	3.45	2.71	2	0	11	1	3	4	3	3	15	13	13	1	16	2	2	1	1	1	3	1	1	-1	0.02	0.15	-0.13
2044296	2024-01-22 02:00:00	28	1	2.96	3.25	2.31	2.89	3.20	2.36	7	1	0	4	0	2	11	1	2	0	10	9	11	1	3	2	3	1	2	-1	-1	1	-0.07	-0.05	0.05
2244533	2024-11-04 02:00:00	28	3	1.77	3.30	4.70	1.76	3.25	4.90	3	5	6	3	4	8	6	9	14	10	7	2	16	3	2	1	1	2	3	-1	-1	1	-0.01	-0.05	0.20
2044294	2024-01-21 02:00:00	28	0	2.23	3.25	3.10	2.19	3.25	3.15	3	0	1	1	0	3	4	0	4	0	4	0	4	1	3	1	2	1	2	-1	0	1	-0.04	0.00	0.05
2044291	2024-01-16 04:15:00	28	3	1.96	3.40	3.65	1.96	3.35	3.65	8	2	6	10	1	5	18	3	11	0	15	7	18	1	3	2	3	1	2	0	-1	0	0.00	-0.05	0.00
2044289	2024-01-15 04:30:00	28	3	1.77	3.85	3.90	1.84	3.80	3.65	1	4	7	3	3	4	4	7	11	11	8	4	15	3	2	1	1	2	3	1	-1	-1	0.07	-0.05	-0.25
2019774	2023-06-04 03:00:00	28	3	2.56	2.86	2.64	2.44	2.90	2.90	8	0	3	3	3	8	11	3	11	0	8	0	11	1	3	1	2	1	2	-1	1	1	-0.12	0.04	0.26
2044349	2024-03-03 23:30:00	28	1	2.44	3.10	2.89	2.40	3.05	3.00	1	1	1	1	0	1	2	1	2	0	1	0	2	1	3	1	2	1	2	-1	-1	1	-0.04	-0.05	0.11
2044348	2024-03-03 04:30:00	28	3	1.35	4.90	7.50	1.36	4.85	7.50	2	2	2	2	2	3	4	4	5	1	1	0	5	2	2	1	1	1	3	1	-1	0	0.01	-0.05	0.00
2044347	2024-02-25 23:30:00	28	1	2.42	3.35	2.71	2.41	3.35	2.73	2	1	0	2	0	1	4	1	1	0	3	3	4	1	2	2	3	1	1	-1	0	1	-0.01	0.00	0.02
2044346	2024-02-25 04:30:00	28	0	1.59	3.65	5.70	1.63	3.60	5.30	1	4	6	6	2	2	7	6	8	1	2	0	8	2	3	1	2	1	3	1	-1	-1	0.04	-0.05	-0.40
2044345	2024-02-24 23:30:00	28	0	2.40	3.10	2.95	2.40	3.05	2.96	0	2	3	1	1	2	1	3	5	4	2	0	5	3	2	1	1	2	3	0	-1	1	0.00	-0.05	0.01
2044344	2024-02-26 04:30:00	28	1	9.10	5.00	1.30	9.80	5.20	1.27	9	5	9	12	8	6	21	13	15	0	8	6	21	1	3	2	3	1	2	1	1	-1	0.70	0.20	-0.03
2044343	2024-02-26 02:00:00	28	1	8.00	4.55	1.36	7.80	4.55	1.37	3	3	1	2	1	1	5	4	2	1	2	4	6	1	2	3	3	2	1	-1	0	1	-0.20	0.00	0.01
2044341	2024-02-27 04:15:00	28	0	4.05	3.85	1.75	4.00	3.75	1.78	2	3	2	2	2	2	4	5	4	5	4	5	9	2	1	2	1	3	1	-1	-1	1	-0.05	-0.10	0.03
2044340	2024-02-26 02:00:00	28	3	1.11	8.50	18.00	1.11	8.50	17.00	2	4	4	2	3	4	4	7	8	8	5	4	12	3	2	1	1	2	3	0	0	-1	0.00	0.00	-1.00
2044339	2024-02-24 04:15:00	28	3	2.23	3.25	3.10	2.29	3.35	2.92	2	1	6	5	3	3	7	4	9	2	5	0	9	2	3	1	2	1	3	1	1	-1	0.06	0.10	-0.18
2044337	2024-02-20 04:15:00	28	0	8.00	4.75	1.35	7.90	4.85	1.35	14	6	6	11	8	6	25	14	12	3	14	16	28	1	2	3	3	2	1	-1	1	0	-0.10	0.10	0.00
2244492	2024-10-07 03:30:00	28	3	1.55	4.25	5.10	1.56	4.35	4.85	1	1	2	1	3	1	2	4	3	2	0	1	4	3	1	2	1	3	2	1	1	-1	0.01	0.10	-0.25
2244493	2024-10-29 04:15:00	28	0	8.70	5.10	1.30	8.90	5.10	1.30	14	6	5	16	5	6	30	11	11	2	21	21	32	1	2	2	3	1	1	1	0	0	0.20	0.00	0.00
2044334	2024-02-19 02:00:00	28	0	2.14	3.40	3.10	2.19	3.40	3.05	0	0	2	1	0	1	1	0	3	2	3	0	3	2	3	1	2	1	3	1	0	-1	0.05	0.00	-0.05
2044331	2024-02-19 04:30:00	28	3	1.35	5.00	7.20	1.37	4.85	6.80	3	2	7	5	1	5	8	3	12	4	9	0	12	2	3	1	2	1	3	1	-1	-1	0.02	-0.15	-0.40
2044382	2024-03-17 02:00:00	28	3	1.39	4.55	7.00	1.39	4.50	6.90	1	2	2	1	1	2	2	3	4	3	2	1	5	3	2	1	1	2	3	0	-1	-1	0.00	-0.05	-0.10
2044380	2024-03-10 02:00:00	28	1	3.80	3.70	1.83	4.00	3.70	1.79	2	0	2	2	1	1	4	1	3	0	3	1	4	1	3	2	3	1	2	1	0	-1	0.20	0.00	-0.04
2244582	2024-12-03 02:45:00	28	3	1.67	3.60	4.90	1.70	3.55	4.75	1	1	1	1	1	1	2	2	2	0	0	0	2	1	1	1	1	1	1	1	-1	-1	0.03	-0.05	-0.15
2244587	2024-12-01 23:30:00	28	3	3.10	3.15	2.26	3.10	3.15	2.28	1	0	0	0	0	1	1	0	1	1	2	1	2	1	3	1	2	1	2	0	0	1	0.00	0.00	0.02
2044373	2024-05-19 01:00:00	28	3	2.25	3.35	2.96	2.22	3.35	3.00	4	0	2	1	0	2	5	0	4	0	5	1	5	1	3	2	3	1	2	-1	0	1	-0.03	0.00	0.04
2244584	2024-12-02 02:00:00	28	0	9.50	5.70	1.26	9.50	5.70	1.25	6	2	3	6	2	3	12	4	6	1	9	7	13	1	3	2	3	1	2	0	0	-1	0.00	0.00	-0.01
2044371	2024-05-19 03:30:00	28	0	3.05	3.75	2.06	2.98	3.75	2.09	7	4	7	6	6	8	13	10	15	5	8	3	18	2	3	1	2	1	3	-1	0	1	-0.07	0.00	0.03
2044369	2024-05-18 22:30:00	28	0	2.66	3.50	2.40	2.61	3.50	2.43	4	0	2	1	0	5	5	0	7	2	7	0	7	2	3	1	2	1	3	-1	0	1	-0.05	0.00	0.03
2244588	2024-12-08 04:30:00	28	1	5.90	4.10	1.49	5.90	4.10	1.49	3	5	2	3	5	1	6	10	3	5	1	8	11	2	1	3	2	3	1	0	0	0	0.00	0.00	0.00
2199537	2024-04-17 03:15:00	28	0	8.50	5.00	1.31	8.90	5.00	1.30	8	4	6	10	4	5	18	8	11	4	14	11	22	1	3	2	3	1	2	1	0	-1	0.40	0.00	-0.01
2044367	2024-05-12 03:30:00	28	0	3.05	3.65	2.09	2.78	3.65	2.23	8	5	1	3	4	4	11	9	5	2	4	8	13	1	2	3	3	2	1	-1	0	1	-0.27	0.00	0.14
2244594	2024-12-08 02:00:00	28	3	1.86	3.40	4.05	1.78	3.45	4.40	6	1	4	4	2	6	10	3	10	0	7	0	10	1	3	1	2	1	2	-1	1	1	-0.08	0.05	0.35
2244595	2024-12-10 04:15:00	28	3	2.40	3.20	2.85	2.72	3.20	2.50	27	3	28	29	3	28	56	6	56	5	55	5	61	1	3	1	2	1	2	1	0	-1	0.32	0.00	-0.35
2044365	2024-05-12 22:30:00	28	3	2.17	3.45	3.00	2.06	3.55	3.20	5	1	3	3	3	4	8	4	7	0	4	1	8	1	3	2	3	1	2	-1	1	1	-0.11	0.10	0.20
2044363	2024-05-12 01:00:00	28	0	6.70	4.65	1.40	7.00	4.70	1.38	2	2	4	5	4	1	7	6	5	1	2	3	8	1	2	3	3	2	1	1	1	-1	0.30	0.05	-0.02
2244598	2024-12-09 02:00:00	28	1	1.87	3.40	3.95	1.89	3.40	3.90	1	1	2	1	1	1	2	2	3	2	2	1	4	2	2	1	1	1	3	1	0	-1	0.02	0.00	-0.05
2244602	2024-12-07 23:30:00	28	3	2.06	3.30	3.40	2.03	3.30	3.50	1	1	0	0	0	2	1	1	2	1	1	0	2	2	2	1	1	1	3	-1	0	1	-0.03	0.00	0.10
2044358	2024-03-11 04:30:00	28	3	1.15	7.20	15.00	1.20	6.20	12.00	4	14	6	8	10	3	12	24	9	12	0	15	24	2	1	3	2	3	1	1	-1	-1	0.05	-1.00	-3.00
2019779	2023-06-12 03:15:00	28	3	1.90	3.45	3.55	2.01	3.40	3.25	4	3	6	5	3	4	9	6	10	2	5	1	11	2	3	1	2	1	3	1	-1	-1	0.11	-0.05	-0.30
2044354	2024-03-04 04:30:00	28	3	2.36	3.35	2.78	2.33	3.40	2.80	1	2	6	1	3	7	2	5	13	11	8	0	13	3	2	1	1	2	3	-1	1	1	-0.03	0.05	0.02
2244607	2024-12-08 02:00:00	28	3	1.29	5.20	9.00	1.31	5.00	8.30	3	3	7	3	3	7	6	6	14	9	9	1	15	2	2	1	1	1	3	1	-1	-1	0.02	-0.20	-0.70
2044353	2024-03-02 23:30:00	28	1	2.26	3.05	3.25	2.29	3.05	3.15	1	1	3	3	0	1	4	1	4	0	3	0	4	1	3	1	2	1	2	1	0	-1	0.03	0.00	-0.10
2244604	2024-12-07 04:15:00	28	1	1.26	5.60	9.70	1.24	5.60	11.00	6	5	5	5	5	7	11	10	12	9	10	8	20	2	3	1	2	1	3	-1	0	1	-0.02	0.00	1.30
2253251	2024-08-10 03:15:00	28	3	1.15	7.20	15.00	1.15	7.20	15.00	0	1	0	1	0	0	1	1	0	0	0	1	1	1	1	3	2	2	1	0	0	0	0.00	0.00	0.00
2253254	2024-09-01 03:30:00	28	3	1.77	3.80	3.95	1.95	3.60	3.45	6	11	14	10	6	9	16	17	23	11	10	4	27	3	2	1	1	2	3	1	-1	-1	0.18	-0.20	-0.50
2253255	2024-09-14 03:15:00	28	0	10.00	6.20	1.23	9.40	6.20	1.23	6	2	4	6	3	3	12	5	7	0	7	5	12	1	3	2	3	1	2	-1	0	0	-0.60	0.00	0.00
2253252	2024-08-18 01:00:00	28	0	9.80	5.60	1.25	9.60	5.80	1.24	7	2	2	4	4	1	11	6	3	4	9	12	15	1	2	3	3	2	1	-1	1	-1	-0.20	0.20	-0.01
2044408	2024-04-07 03:30:00	28	3	2.01	3.65	3.25	2.17	3.45	3.00	4	7	9	11	3	6	15	10	15	5	10	5	20	1	3	1	2	1	2	1	-1	-1	0.16	-0.20	-0.25
2253253	2024-08-24 03:15:00	28	0	10.00	6.50	1.18	13.00	7.20	1.16	3	5	8	5	10	6	8	15	14	11	4	5	19	3	1	2	1	3	2	1	1	-1	3.00	0.70	-0.02
2253259	2024-10-27 03:30:00	28	0	7.60	5.10	1.33	8.40	4.85	1.33	8	6	6	16	5	5	24	11	11	2	15	15	26	1	2	2	3	1	1	1	-1	0	0.80	-0.25	0.00
2044404	2024-04-08 03:30:00	28	0	1.34	4.80	7.90	1.35	4.85	7.50	5	4	14	5	4	11	10	8	25	18	20	3	28	2	3	1	2	1	3	1	1	-1	0.01	0.05	-0.40
2253263	2024-12-01 04:30:00	28	0	1.18	6.80	12.00	1.23	5.80	9.70	5	11	7	6	10	5	11	21	12	19	9	18	30	3	1	2	1	3	2	1	-1	-1	0.05	-1.00	-2.30
2044401	2024-04-09 03:15:00	28	1	2.56	2.80	3.00	2.53	2.83	3.00	6	2	4	5	2	6	11	4	10	0	7	1	11	1	3	2	3	1	2	-1	1	0	-0.03	0.03	0.00
2044400	2024-04-07 01:00:00	28	0	1.43	4.50	6.40	1.45	4.55	5.90	4	5	7	5	5	5	9	10	12	8	7	5	17	3	2	1	1	2	3	1	1	-1	0.02	0.05	-0.50
2253261	2024-11-11 02:45:00	28	0	5.20	4.15	1.56	5.70	4.00	1.53	4	7	7	8	6	4	12	13	11	4	3	5	16	2	1	3	2	3	1	1	-1	-1	0.50	-0.15	-0.03
2253266	2024-12-23 04:30:00	28	1	7.50	5.00	1.34	7.10	5.00	1.35	11	6	6	9	8	8	20	14	14	3	9	9	23	1	2	2	3	1	1	-1	0	1	-0.40	0.00	0.01
2044398	2024-03-30 23:30:00	28	3	1.93	3.30	3.90	1.93	3.30	3.90	1	0	0	0	0	1	1	0	1	0	1	0	1	1	3	1	2	1	2	0	0	0	0.00	0.00	0.00
2253267	2024-12-30 04:30:00	28	3	2.35	3.50	2.71	2.40	3.45	2.67	11	2	15	11	1	16	22	3	31	10	29	1	32	2	3	1	2	1	3	1	-1	-1	0.05	-0.05	-0.04
2253264	2024-12-06 04:15:00	28	3	8.20	4.90	1.32	8.20	4.80	1.33	21	12	7	23	11	8	44	23	15	3	24	32	47	1	2	3	3	2	1	0	-1	1	0.00	-0.10	0.01
2244561	2024-11-11 04:45:00	28	3	2.11	3.50	3.15	2.09	3.35	3.30	6	6	6	4	5	8	10	11	14	9	8	5	19	3	2	1	1	2	3	-1	-1	1	-0.02	-0.15	0.15
2253265	2024-12-15 04:30:00	28	3	1.08	11.00	17.00	1.10	9.20	16.00	1	4	4	4	1	2	5	5	6	5	5	4	10	2	2	1	1	1	3	1	-1	-1	0.02	-1.80	-1.00
2044394	2024-03-31 04:30:00	28	3	7.60	4.95	1.35	7.30	4.85	1.36	7	3	2	5	1	3	12	4	5	0	8	7	12	1	3	2	3	1	2	-1	-1	1	-0.30	-0.10	0.01
2244564	2024-12-03 04:45:00	28	3	1.19	6.50	12.00	1.24	5.80	9.40	6	15	8	13	6	4	19	21	12	9	7	16	28	2	1	3	2	3	1	1	-1	-1	0.05	-0.70	-2.60
2253269	2025-01-04 04:15:00	28	1	3.85	3.60	1.84	3.45	3.25	2.07	17	11	16	16	6	23	33	17	39	14	30	8	47	2	3	1	2	1	3	-1	-1	1	-0.40	-0.35	0.23
2044390	2024-03-18 04:30:00	28	3	1.13	7.90	15.00	1.17	6.70	13.00	2	10	6	5	4	4	7	14	10	11	4	8	18	3	1	2	1	3	2	1	-1	-1	0.04	-1.20	-2.00
2244571	2024-11-30 23:30:00	28	3	2.85	3.05	2.48	2.84	3.10	2.47	1	0	2	2	1	1	3	1	3	0	2	0	3	1	3	1	2	1	2	-1	1	-1	-0.01	0.05	-0.01
2244568	2024-11-30 04:15:00	28	3	2.46	3.10	2.86	2.31	3.10	3.10	8	2	6	7	2	9	15	4	15	1	12	1	16	1	3	1	2	1	2	-1	0	1	-0.15	0.00	0.24
2253272	2025-02-08 04:15:00	28	1	2.59	3.40	2.49	2.75	3.10	2.53	15	9	13	23	4	23	38	13	36	0	25	2	38	1	3	2	3	1	2	1	-1	1	0.16	-0.30	0.04
2044388	2024-03-17 23:30:00	28	3	2.40	3.25	2.82	2.38	3.25	2.83	3	0	1	0	0	2	3	0	3	0	3	0	3	1	3	1	2	1	2	-1	0	1	-0.02	0.00	0.01
2044386	2024-03-16 23:30:00	28	1	2.00	3.20	3.75	2.01	3.20	3.70	1	0	1	1	0	1	2	0	2	0	2	0	2	1	3	1	2	1	2	1	0	-1	0.01	0.00	-0.05
2044385	2024-03-16 04:15:00	28	3	1.71	3.95	4.75	1.74	3.80	4.15	0	2	2	1	1	2	1	3	4	3	1	0	4	3	2	1	1	2	3	1	-1	-1	0.03	-0.15	-0.60
2021476	2023-08-13 02:45:00	29	0	1.52	4.35	5.20	1.56	4.45	5.40	1	1	1	2	2	2	3	3	3	0	0	0	3	1	1	1	1	1	1	1	1	1	0.04	0.10	0.20
2219676	2024-08-18 02:30:00	29	1	1.81	3.60	3.70	1.66	4.25	4.70	12	1	3	3	7	11	15	8	14	1	8	2	16	1	3	2	3	1	2	-1	1	1	-0.15	0.65	1.00
2227749	2024-10-06 20:30:00	30	3	1.69	4.10	4.70	1.69	4.10	4.70	0	0	0	0	0	1	0	0	1	1	1	0	1	2	2	1	1	1	3	0	0	0	0.00	0.00	0.00
2227748	2024-10-06 02:00:00	30	3	1.13	7.80	15.00	1.18	7.80	13.00	0	1	1	1	2	0	1	3	1	3	1	3	4	2	1	2	1	3	1	1	0	-1	0.05	0.00	-2.00
2227757	2024-10-20 03:00:00	30	0	4.80	4.05	1.68	4.00	3.85	1.86	5	4	2	4	3	6	9	7	8	2	4	3	11	1	3	2	3	1	2	-1	-1	1	-0.80	-0.20	0.18
2227759	2024-10-20 20:30:00	30	0	5.90	4.60	1.43	6.20	4.60	1.43	0	1	0	1	0	0	1	1	0	1	1	2	2	1	1	3	2	2	1	1	0	0	0.30	0.00	0.00
2227770	2024-10-27 23:45:00	30	3	1.25	5.90	9.30	1.23	6.20	13.00	2	1	3	0	3	4	2	4	7	5	3	0	7	3	2	1	1	2	3	-1	1	1	-0.02	0.30	3.70
2227774	2024-11-03 01:45:00	30	3	2.81	3.65	2.23	3.05	3.75	2.19	3	1	1	4	2	1	7	3	2	1	5	6	8	1	2	3	3	2	1	1	1	-1	0.24	0.10	-0.04
2227713	2024-10-31 01:00:00	30	0	1.87	3.90	3.45	1.96	3.75	3.65	6	5	9	9	3	6	15	8	15	7	14	7	22	1	3	1	2	1	2	1	-1	1	0.09	-0.15	0.20
2227712	2024-09-01 18:15:00	30	3	2.77	3.40	2.36	2.80	3.35	2.36	1	3	0	5	1	0	6	4	0	0	2	6	6	1	2	3	3	2	1	1	-1	0	0.03	-0.05	0.00
2227714	2024-08-31 22:30:00	30	1	3.05	3.40	2.19	3.35	3.60	2.12	1	0	4	3	2	2	4	2	6	4	6	2	8	2	3	1	2	1	3	1	1	-1	0.30	0.20	-0.07
2227716	2024-09-01 22:45:00	30	3	1.08	9.70	19.00	1.12	10.00	17.00	1	1	2	1	3	3	2	4	5	5	3	2	7	3	2	1	1	2	3	1	1	-1	0.04	0.30	-2.00
2227721	2024-09-14 22:30:00	30	3	1.12	9.10	12.00	1.14	9.20	16.00	0	1	0	1	3	2	1	4	2	3	0	2	4	3	1	2	1	3	2	1	1	1	0.02	0.10	4.00
2227723	2024-12-05 03:00:00	30	1	1.43	4.70	6.00	1.45	4.60	6.90	7	7	12	9	6	12	16	13	24	11	14	3	27	2	3	1	2	1	3	1	-1	1	0.02	-0.10	0.90
2227724	2024-09-15 20:30:00	30	3	1.80	3.60	4.05	1.80	3.80	4.30	3	1	4	2	3	5	5	4	9	5	6	1	10	2	3	1	2	1	3	0	1	1	0.00	0.20	0.25
2227726	2024-09-21 02:00:00	30	0	6.10	4.50	1.44	7.00	4.80	1.43	5	3	8	9	7	5	14	10	13	2	6	3	16	1	3	2	3	1	2	1	1	-1	0.90	0.30	-0.01
2227729	2024-09-22 02:00:00	30	1	3.75	3.85	1.81	3.95	4.05	1.81	5	1	5	4	3	3	9	4	8	2	7	3	11	1	3	2	3	1	2	1	1	0	0.20	0.20	0.00
2227734	2024-09-22 22:45:00	30	0	11.00	6.80	1.20	14.00	7.10	1.20	1	0	0	2	3	0	3	3	0	1	1	4	4	1	1	3	2	2	1	1	1	0	3.00	0.30	0.00
2227737	2024-09-29 00:45:00	30	1	5.70	4.30	1.56	5.30	4.20	1.60	3	3	1	1	2	5	4	5	6	2	1	0	6	3	2	1	1	2	3	-1	-1	1	-0.40	-0.10	0.04
2227742	2024-09-29 22:45:00	30	0	7.00	5.00	1.36	8.10	5.10	1.37	2	1	2	4	3	2	6	4	4	1	3	3	7	1	2	2	3	1	1	1	1	1	1.10	0.10	0.01
2227809	2024-12-07 23:30:00	30	3	2.07	3.55	3.15	2.09	3.60	3.40	0	2	2	2	3	2	2	5	4	5	2	3	7	3	1	2	1	3	2	1	1	1	0.02	0.05	0.25
2035038	2024-03-31 18:15:00	30	0	4.20	4.05	1.68	4.15	4.10	1.68	2	0	0	0	2	0	2	2	0	0	0	2	2	1	1	3	2	2	1	-1	1	0	-0.05	0.05	0.00
2227808	2024-12-08 21:30:00	30	3	2.76	3.65	2.26	2.98	3.65	2.28	8	4	2	7	5	4	15	9	6	0	6	9	15	1	2	3	3	2	1	1	0	1	0.22	0.00	0.02
2227811	2024-12-08 04:00:00	30	1	2.33	3.25	3.20	2.40	3.25	3.10	1	0	3	3	0	2	4	0	5	1	5	0	5	2	3	1	2	1	3	1	0	-1	0.07	0.00	-0.10
2227810	2024-12-08 19:15:00	30	1	2.01	3.30	3.55	2.01	3.50	3.75	2	0	0	1	2	3	3	2	3	1	2	1	4	1	3	1	2	1	2	0	1	1	0.00	0.20	0.20
2227813	2024-12-08 01:45:00	30	0	1.98	3.45	3.50	2.01	3.50	3.75	4	2	4	5	4	4	9	6	8	5	8	6	14	1	3	2	3	1	2	1	1	1	0.03	0.05	0.25
2227812	2024-12-07 03:00:00	30	3	1.36	5.30	6.60	1.37	5.50	7.30	6	3	4	4	4	11	10	7	15	8	11	3	18	2	3	1	2	1	3	1	1	1	0.01	0.20	0.70
2227815	2024-12-15 23:45:00	30	3	1.14	7.80	15.00	1.13	8.60	21.00	1	2	2	1	4	3	2	6	5	5	1	2	7	3	1	2	1	3	2	-1	1	1	-0.01	0.80	6.00
2034776	2023-09-17 20:30:00	30	3	2.51	3.60	2.67	2.51	3.60	2.67	0	0	0	1	1	1	1	1	1	0	0	0	1	1	1	1	1	1	1	0	0	0	0.00	0.00	0.00
2035032	2024-03-31 20:30:00	30	3	1.32	5.10	7.70	1.33	5.30	9.10	1	0	1	1	1	2	2	1	3	1	2	0	3	2	3	1	2	1	3	1	1	1	0.01	0.20	1.40
2227814	2024-12-08 21:30:00	30	0	2.38	3.25	3.10	2.38	3.20	3.15	0	1	0	0	1	2	0	2	2	2	0	0	2	3	1	1	1	2	2	0	-1	1	0.00	-0.05	0.05
2228070	2025-02-09 01:45:00	30	1	1.13	9.10	18.00	1.13	9.20	18.00	0	2	1	1	4	2	1	6	3	5	0	3	6	3	1	2	1	3	2	0	1	0	0.00	0.10	0.00
2227817	2024-12-15 04:00:00	30	3	1.17	6.90	13.00	1.19	7.50	14.00	4	2	3	4	7	4	8	9	7	3	2	4	11	2	1	3	2	3	1	1	1	1	0.02	0.60	1.00
2228073	2025-02-09 21:30:00	30	0	5.70	4.25	1.45	6.50	4.55	1.48	1	0	1	2	3	1	3	3	2	0	0	1	3	1	1	3	2	2	1	1	1	1	0.80	0.30	0.03
2227816	2024-12-08 03:00:00	30	0	11.00	6.20	1.22	12.00	6.40	1.23	0	2	2	1	3	3	1	5	5	4	0	0	5	3	1	1	1	2	2	1	1	1	1.00	0.20	0.01
2019412	2023-06-05 00:00:00	30	0	2.47	3.30	2.70	2.58	3.50	2.65	0	1	3	1	1	3	1	2	6	5	4	0	6	3	2	1	1	2	3	1	1	-1	0.11	0.20	-0.05
2034773	2023-09-03 20:30:00	30	1	6.10	4.70	1.42	6.30	4.70	1.41	3	3	2	2	2	3	5	5	5	0	0	0	5	1	1	1	1	1	1	1	0	-1	0.20	0.00	-0.01
2227819	2024-12-16 03:00:00	30	0	3.40	3.45	2.01	3.55	3.55	2.06	7	3	6	8	4	9	15	7	15	2	10	2	17	1	3	1	2	1	2	1	1	1	0.15	0.10	0.05
2019413	2023-06-02 00:45:00	30	0	3.50	3.70	2.02	3.45	3.75	2.02	4	1	5	4	3	3	8	4	8	2	6	2	10	1	3	1	2	1	2	-1	1	0	-0.05	0.05	0.00
2035028	2024-03-17 21:30:00	30	3	1.93	3.50	3.60	1.92	3.75	3.80	3	3	2	4	3	3	7	6	5	1	2	3	8	1	2	3	3	2	1	-1	1	1	-0.01	0.25	0.20
2227818	2024-12-15 01:45:00	30	3	14.00	7.00	1.16	12.00	7.00	1.21	5	5	2	4	3	4	9	8	6	4	5	7	13	1	2	3	3	2	1	-1	0	1	-2.00	0.00	0.05
2228074	2025-02-09 19:15:00	30	0	1.35	4.55	7.20	1.37	5.00	8.20	8	7	11	8	7	13	16	14	24	11	13	3	27	2	3	1	2	1	3	1	1	1	0.02	0.45	1.00
2227821	2024-12-15 03:00:00	30	3	1.58	4.00	5.00	1.68	3.95	5.00	0	4	6	6	2	1	6	6	7	4	4	3	10	2	2	1	1	1	3	1	-1	0	0.10	-0.05	0.00
2019411	2023-06-04 20:30:00	30	3	1.43	4.50	6.30	1.45	4.80	6.60	1	2	2	3	2	3	4	4	5	1	1	0	5	2	2	1	1	1	3	1	1	1	0.02	0.30	0.30
2034770	2023-09-03 02:00:00	30	0	6.80	5.40	1.34	8.20	6.00	1.31	11	8	10	15	12	8	26	20	18	0	6	8	26	1	2	3	3	2	1	1	1	-1	1.40	0.60	-0.03
2227820	2024-12-15 21:30:00	30	1	2.02	3.50	3.35	1.98	3.55	3.80	7	1	3	4	2	5	11	3	8	2	10	5	13	1	3	2	3	1	2	-1	1	1	-0.04	0.05	0.45
2035025	2024-03-18 03:00:00	30	3	1.41	4.55	6.70	1.42	4.75	7.50	5	5	8	7	6	7	12	11	15	7	8	4	19	2	3	1	2	1	3	1	1	1	0.01	0.20	0.80
2227823	2024-12-15 21:30:00	30	3	1.40	4.45	7.00	1.39	4.80	8.10	8	4	6	6	8	10	14	12	16	3	5	1	17	2	3	1	2	1	3	-1	1	1	-0.01	0.35	1.10
2034768	2023-08-27 20:30:00	30	3	1.14	8.10	14.00	1.14	8.10	14.00	1	0	0	0	1	1	1	1	1	0	0	0	1	1	1	1	1	1	1	0	0	0	0.00	0.00	0.00
2227822	2024-12-15 19:15:00	30	1	2.03	3.60	3.20	1.93	3.70	3.45	7	0	2	2	2	6	9	2	8	0	7	1	9	1	3	2	3	1	2	-1	1	1	-0.10	0.10	0.25
2227825	2024-12-22 01:45:00	30	3	2.96	3.35	2.26	3.15	3.35	2.31	3	1	0	2	2	1	5	3	1	0	2	4	5	1	2	3	3	2	1	1	0	1	0.19	0.00	0.05
2227824	2024-12-14 03:00:00	30	0	2.05	3.25	3.50	2.06	3.30	3.85	3	3	4	2	4	5	5	7	9	7	5	3	12	3	2	1	1	2	3	1	1	1	0.01	0.05	0.35
2227827	2024-12-21 23:30:00	30	3	1.65	3.85	4.70	1.60	4.10	5.50	1	0	3	0	4	3	1	4	6	7	4	2	8	3	2	1	1	2	3	-1	1	1	-0.05	0.25	0.80
2034764	2023-08-13 02:00:00	30	3	1.18	7.50	14.00	1.19	7.20	13.00	0	2	2	2	1	2	2	3	4	2	1	0	4	3	2	1	1	2	3	1	-1	-1	0.01	-0.30	-1.00
2227826	2024-12-22 03:00:00	30	3	2.40	3.45	2.68	2.29	3.65	2.95	7	2	8	5	5	8	12	7	16	5	10	1	17	2	3	1	2	1	3	-1	1	1	-0.11	0.20	0.27
2227829	2024-12-22 21:30:00	30	3	1.70	4.10	4.05	1.70	4.30	4.40	0	1	2	0	5	2	0	6	4	7	1	3	7	3	1	2	1	3	2	0	1	1	0.00	0.20	0.35
2035018	2024-03-10 01:45:00	30	3	1.40	4.75	6.40	1.42	4.75	7.30	1	4	6	3	5	3	4	9	9	7	2	2	11	3	1	1	1	2	2	1	0	1	0.02	0.00	0.90
2034761	2023-08-12 22:30:00	30	3	1.33	5.00	8.00	1.34	5.30	8.70	1	0	0	1	2	2	2	2	2	0	0	0	2	1	1	1	1	1	1	1	1	1	0.01	0.30	0.70
2227831	2024-12-22 19:15:00	30	0	4.35	3.95	1.68	4.80	4.05	1.68	1	0	0	1	2	0	2	2	0	1	1	3	3	1	1	3	2	2	1	1	1	0	0.45	0.10	0.00
2035016	2024-03-09 03:00:00	30	0	6.80	5.20	1.34	7.50	5.30	1.37	16	8	9	15	9	11	31	17	20	2	16	13	33	1	3	2	3	1	2	1	1	1	0.70	0.10	0.03
2227830	2024-12-22 21:30:00	30	0	1.67	3.85	4.50	1.67	4.05	4.90	0	2	4	0	4	3	0	6	7	7	1	0	7	3	2	1	1	2	3	0	1	1	0.00	0.20	0.40
2227833	2024-12-22 23:45:00	30	3	2.88	3.20	2.39	2.99	3.30	2.42	3	0	4	4	1	3	7	1	7	1	7	1	8	1	3	1	2	1	2	1	1	1	0.11	0.10	0.03
2227832	2024-12-21 03:00:00	30	1	2.96	3.65	2.29	2.87	3.65	2.35	8	2	4	6	3	7	14	5	11	0	9	3	14	1	3	2	3	1	2	-1	0	1	-0.09	0.00	0.06
2227835	2025-01-12 21:30:00	30	0	1.42	4.45	5.90	1.43	4.80	7.00	8	2	4	4	7	11	12	9	15	5	8	2	17	2	3	1	2	1	3	1	1	1	0.01	0.35	1.10
2227836	2025-01-12 01:45:00	30	3	1.09	8.60	15.00	1.11	9.80	20.00	1	7	3	1	10	5	2	17	8	17	2	11	19	3	1	2	1	3	2	1	1	1	0.02	1.20	5.00
2227777	2024-11-03 21:30:00	30	0	2.60	3.40	2.49	2.73	3.40	2.56	4	0	5	5	0	7	9	0	12	3	12	0	12	2	3	1	2	1	3	1	0	1	0.13	0.00	0.07
2035069	2024-04-28 18:15:00	30	0	3.25	3.65	2.01	3.00	3.65	2.11	5	5	4	3	5	6	8	10	10	12	10	10	20	3	1	1	1	2	2	-1	0	1	-0.25	0.00	0.10
2034812	2023-12-08 01:45:00	30	3	1.18	7.10	11.00	1.18	7.60	15.00	5	9	5	8	7	6	13	16	11	9	6	11	22	2	1	3	2	3	1	0	1	1	0.00	0.50	4.00
2035067	2024-04-26 00:45:00	30	0	7.20	4.80	1.36	8.10	5.50	1.34	14	8	14	16	15	11	30	23	25	5	12	10	35	1	3	2	3	1	2	1	1	-1	0.90	0.70	-0.02
2227781	2024-11-09 03:00:00	30	3	1.42	4.65	6.20	1.46	4.50	6.90	6	6	13	7	4	15	13	10	28	17	20	2	30	2	3	1	2	1	3	1	-1	1	0.04	-0.15	0.70
2021496	2023-06-11 20:30:00	30	3	1.40	4.60	6.90	1.43	4.75	7.20	2	2	2	3	3	3	5	5	5	0	0	0	5	1	1	1	1	1	1	1	1	1	0.03	0.15	0.30
2035065	2024-04-14 20:30:00	30	3	1.78	3.80	3.90	1.78	3.95	4.25	0	2	1	0	2	1	0	4	2	5	1	3	5	3	1	2	1	3	2	0	1	1	0.00	0.15	0.35
2035063	2024-04-14 18:15:00	30	0	2.79	3.60	2.26	2.79	3.60	2.26	0	0	0	0	1	0	0	1	0	1	0	1	1	2	1	2	1	3	1	0	0	0	0.00	0.00	0.00
2021495	2023-06-09 02:00:00	30	1	3.80	3.65	1.94	3.95	3.65	1.91	7	3	7	11	5	8	18	8	15	3	13	6	21	1	3	2	3	1	2	1	0	-1	0.15	0.00	-0.03
2227787	2024-11-10 21:30:00	30	1	2.53	3.50	2.50	2.71	3.55	2.52	2	1	4	6	2	3	8	3	7	1	6	2	9	1	3	2	3	1	2	1	1	1	0.18	0.05	0.02
2227789	2024-11-24 04:00:00	30	3	1.13	7.60	18.00	1.14	8.40	18.00	3	4	3	3	5	3	6	9	6	7	4	7	13	2	1	2	1	3	1	1	1	0	0.01	0.80	0.00
2227791	2024-11-24 01:45:00	30	3	1.25	5.70	9.50	1.27	5.90	11.00	2	1	1	2	3	3	4	4	4	2	2	2	6	1	1	1	1	1	1	1	1	1	0.02	0.20	1.50
2227790	2024-11-23 23:30:00	30	3	1.57	3.90	5.40	1.56	4.15	6.00	2	1	2	2	4	3	4	5	5	1	0	0	5	3	1	1	1	2	2	-1	1	1	-0.01	0.25	0.60
2227793	2024-11-24 04:00:00	30	0	3.95	3.60	1.82	4.20	3.65	1.86	3	2	2	4	2	3	7	4	5	1	4	3	8	1	3	2	3	1	2	1	1	1	0.25	0.05	0.04
2227792	2024-11-24 01:45:00	30	1	1.82	3.80	3.75	1.70	4.05	4.65	6	1	3	2	5	7	8	6	10	3	5	1	11	2	3	1	2	1	3	-1	1	1	-0.12	0.25	0.90
2227795	2024-11-24 21:30:00	30	0	3.15	3.50	2.09	3.50	3.50	2.09	2	1	1	2	1	1	4	2	2	2	4	4	6	1	2	2	3	1	1	1	0	0	0.35	0.00	0.00
2035052	2024-04-07 00:45:00	30	3	1.42	4.60	6.40	1.40	4.85	7.90	4	4	5	2	6	10	6	10	15	12	8	3	18	3	2	1	1	2	3	-1	1	1	-0.02	0.25	1.50
2227794	2024-11-24 19:15:00	30	0	2.52	3.40	2.57	2.56	3.40	2.53	3	1	6	5	2	3	8	3	9	2	7	1	10	2	3	1	2	1	3	1	0	-1	0.04	0.00	-0.04
2034795	2023-10-29 21:30:00	30	3	1.31	5.60	7.20	1.32	5.80	8.30	0	2	2	2	1	2	2	3	4	2	1	0	4	3	2	1	1	2	3	1	1	1	0.01	0.20	1.10
2227797	2024-11-24 23:45:00	30	3	1.15	6.80	16.00	1.16	8.20	17.00	2	0	1	1	7	3	3	7	4	4	0	3	7	3	1	2	1	3	2	1	1	1	0.01	1.40	1.00
2227796	2024-11-24 21:30:00	30	1	2.04	3.25	3.55	2.04	3.25	3.95	4	1	0	3	2	2	7	3	2	1	5	6	8	1	2	3	3	2	1	0	0	1	0.00	0.00	0.40
2227799	2024-11-30 23:30:00	30	3	1.99	3.30	3.65	1.94	3.45	4.10	8	1	4	4	4	8	12	5	12	2	9	2	14	1	3	1	2	1	2	-1	1	1	-0.05	0.15	0.45
2035048	2024-04-07 20:30:00	30	3	1.41	4.80	6.30	1.42	5.00	6.90	0	0	3	1	2	5	1	2	8	7	6	0	8	3	2	1	1	2	3	1	1	1	0.01	0.20	0.60
2227798	2024-11-30 03:00:00	30	1	1.45	4.40	6.20	1.64	4.15	5.00	8	12	12	13	9	8	21	21	20	7	7	8	28	1	1	3	2	2	1	1	-1	-1	0.19	-0.25	-1.20
2034790	2023-10-22 18:15:00	30	3	3.30	3.80	1.95	3.30	3.80	1.95	0	0	1	0	1	0	0	1	1	1	0	0	1	3	1	1	1	2	2	0	0	0	0.00	0.00	0.00
2227802	2024-12-01 03:00:00	30	1	1.22	6.10	12.00	1.24	6.00	13.00	3	3	0	4	3	1	7	6	1	2	3	8	9	1	2	3	3	2	1	1	-1	1	0.02	-0.10	1.00
2227805	2024-12-01 21:30:00	30	3	1.53	4.15	5.50	1.60	4.10	5.50	2	2	2	3	2	3	5	4	5	0	1	0	5	1	3	1	2	1	2	1	-1	0	0.07	-0.05	0.00
2227804	2024-12-01 21:30:00	30	3	1.34	4.95	7.30	1.38	5.00	7.80	0	3	5	3	2	3	3	5	8	6	4	1	9	3	2	1	1	2	3	1	1	1	0.04	0.05	0.50
2227807	2024-12-08 23:45:00	30	0	4.25	3.80	1.72	4.85	4.10	1.67	3	1	3	4	4	3	7	5	6	1	3	2	8	1	3	2	3	1	2	1	1	-1	0.60	0.30	-0.05
2227806	2024-12-01 23:45:00	30	0	4.05	3.80	1.75	4.45	3.95	1.75	2	2	3	4	3	1	6	5	4	3	4	5	9	1	2	3	3	2	1	1	1	0	0.40	0.15	0.00
2035094	2024-05-19 20:30:00	30	1	1.40	4.55	6.90	1.38	4.60	7.20	2	1	1	2	1	3	4	2	4	1	3	1	5	1	3	1	2	1	2	-1	1	1	-0.02	0.05	0.30
2227880	2025-01-26 01:45:00	30	3	1.09	9.50	17.00	1.11	9.30	20.00	8	12	13	8	11	13	16	23	26	15	8	5	31	3	2	1	1	2	3	1	-1	1	0.02	-0.20	3.00
2035093	2024-05-19 20:30:00	30	0	2.89	3.60	2.19	2.82	3.60	2.23	3	0	1	0	1	1	3	1	2	0	2	1	3	1	3	2	3	1	2	-1	0	1	-0.07	0.00	0.04
2227883	2025-01-26 19:15:00	30	0	2.08	3.35	3.30	2.12	3.40	3.50	0	0	2	1	1	1	1	1	3	2	2	0	3	2	2	1	1	1	3	1	1	1	0.04	0.05	0.20
2035090	2024-05-12 20:30:00	30	0	1.77	3.95	4.30	1.77	3.95	4.30	0	0	0	0	0	1	0	0	1	1	1	0	1	2	2	1	1	1	3	0	0	0	0.00	0.00	0.00
2034833	2023-08-20 20:30:00	30	3	1.32	4.85	8.40	1.32	4.85	8.40	0	1	1	0	0	0	0	1	1	1	0	0	1	3	1	1	1	2	2	0	0	0	0.00	0.00	0.00
2034822	2024-01-14 19:15:00	30	0	2.53	3.55	2.48	2.48	3.55	2.53	3	1	2	3	0	4	6	1	6	0	5	0	6	1	3	1	2	1	2	-1	0	1	-0.05	0.00	0.05
2035077	2024-05-05 22:45:00	30	3	2.09	3.50	3.15	2.17	3.50	3.30	1	0	0	1	0	2	2	0	2	0	2	0	2	1	3	1	2	1	2	1	0	1	0.08	0.00	0.15
2227843	2025-01-12 04:00:00	30	1	1.33	5.10	7.00	1.42	5.20	6.40	9	7	18	13	5	14	22	12	32	11	21	1	33	2	3	1	2	1	3	1	1	-1	0.09	0.10	-0.60
2034876	2023-12-17 21:30:00	30	1	3.90	3.55	1.84	4.20	3.70	1.85	1	1	2	3	2	1	4	3	3	0	1	1	4	1	2	2	3	1	1	1	1	1	0.30	0.15	0.01
2227846	2025-01-11 03:00:00	30	0	2.43	3.35	2.58	2.81	3.40	2.51	7	6	7	11	7	4	18	13	11	6	11	13	24	1	2	3	3	2	1	1	1	-1	0.38	0.05	-0.07
2227848	2025-01-12 19:15:00	30	3	1.37	4.65	6.80	1.40	4.65	8.40	0	2	2	2	2	2	2	4	4	2	0	0	4	3	1	1	1	2	2	1	0	1	0.03	0.00	1.60
2034865	2023-11-26 21:30:00	30	1	2.31	3.65	2.90	2.31	3.65	2.90	0	0	0	0	1	1	0	1	1	1	0	0	1	3	1	1	1	2	2	0	0	0	0.00	0.00	0.00
2227855	2025-01-19 21:30:00	30	0	4.90	4.00	1.60	5.40	4.10	1.60	6	5	7	9	6	8	15	11	15	3	7	3	18	1	3	1	2	1	2	1	1	0	0.50	0.10	0.00
2034864	2023-11-26 04:00:00	30	0	1.77	3.95	4.30	1.85	3.90	3.95	0	2	5	4	2	2	4	4	7	3	3	0	7	2	2	1	1	1	3	1	-1	-1	0.08	-0.05	-0.35
2227858	2025-01-19 19:15:00	30	3	4.05	3.85	1.74	4.50	3.95	1.74	2	0	0	1	2	0	3	2	0	1	2	4	4	1	2	3	3	2	1	1	1	0	0.45	0.10	0.00
2018985	2023-06-02 03:00:00	30	0	1.89	3.70	4.00	1.87	3.75	4.05	7	3	3	4	4	6	11	7	9	2	6	4	13	1	3	2	3	1	2	-1	1	1	-0.02	0.05	0.05
2227868	2025-01-18 23:30:00	30	3	12.00	6.90	1.19	12.00	7.00	1.21	2	3	1	3	4	3	5	7	4	5	3	6	10	2	1	3	2	3	1	0	1	1	0.00	0.10	0.02
2227681	2024-08-10 02:00:00	30	3	1.67	4.20	4.70	1.65	4.20	4.90	2	1	1	1	2	4	3	3	5	2	2	0	5	2	2	1	1	1	3	-1	0	1	-0.02	0.00	0.20
2227683	2024-08-10 22:30:00	30	1	1.12	8.40	16.00	1.13	8.90	19.00	1	1	1	1	4	1	2	5	2	3	0	3	5	2	1	2	1	3	1	1	1	1	0.01	0.50	3.00
2227682	2024-08-11 00:45:00	30	0	3.30	3.65	1.98	3.50	3.75	2.01	1	1	2	2	2	3	3	3	5	3	3	1	6	2	2	1	1	1	3	1	1	1	0.20	0.10	0.03
2034907	2023-10-29 19:15:00	30	3	3.10	3.50	2.13	3.15	3.50	2.09	0	0	1	2	0	0	2	0	1	0	2	1	2	1	3	2	3	1	2	1	0	-1	0.05	0.00	-0.04
2227685	2024-08-11 03:00:00	30	3	1.12	10.00	17.00	1.11	11.00	19.00	3	1	3	4	3	5	7	4	8	4	7	3	11	2	3	1	2	1	3	-1	1	1	-0.01	1.00	2.00
2227684	2024-08-11 20:30:00	30	3	1.44	4.55	6.20	1.45	4.70	6.80	1	1	1	2	2	2	3	3	3	1	1	1	4	1	1	1	1	1	1	1	1	1	0.01	0.15	0.60
2227687	2024-08-11 02:00:00	30	0	4.95	4.05	1.58	5.30	4.10	1.63	7	6	4	7	5	5	14	11	9	2	5	7	16	1	2	3	3	2	1	1	1	1	0.35	0.05	0.05
2227686	2024-08-11 18:15:00	30	1	1.50	4.35	5.40	1.48	4.40	5.60	1	0	1	0	1	2	1	1	3	2	2	0	3	2	2	1	1	1	3	-1	1	1	-0.02	0.05	0.20
2227689	2024-08-11 22:45:00	30	3	1.45	4.75	5.70	1.42	5.10	6.70	4	0	2	2	4	6	6	4	8	3	5	1	9	2	3	1	2	1	3	-1	1	1	-0.03	0.35	1.00
2227688	2024-08-11 20:30:00	30	0	2.01	3.55	3.30	2.05	3.50	3.60	3	1	1	3	0	1	6	1	2	1	6	5	7	1	3	2	3	1	2	1	-1	1	0.04	-0.05	0.30
2227691	2024-08-17 22:30:00	30	1	2.68	3.55	2.36	2.73	3.65	2.45	1	0	0	1	1	3	2	1	3	1	2	0	3	2	3	1	2	1	3	1	1	1	0.05	0.10	0.09
2227690	2024-08-17 02:00:00	30	3	1.79	3.80	4.40	1.79	3.80	4.40	3	2	3	2	3	5	5	5	8	4	4	1	9	2	2	1	1	1	3	0	0	0	0.00	0.00	0.00
2034892	2023-09-16 22:30:00	30	3	1.21	6.70	9.40	1.22	7.00	11.00	5	5	6	5	8	6	10	13	12	3	0	1	13	3	1	2	1	3	2	1	1	1	0.01	0.30	1.60
2227698	2024-08-18 22:45:00	30	3	7.00	5.60	1.31	8.00	5.80	1.33	3	2	0	2	1	2	5	3	2	0	2	3	5	1	2	3	3	2	1	1	1	1	1.00	0.20	0.02
2227701	2024-08-25 02:00:00	30	0	10.00	7.20	1.18	14.00	7.50	1.18	1	3	2	1	3	3	2	6	5	4	0	1	6	3	1	2	1	3	2	1	1	0	4.00	0.30	0.00
2034889	2023-09-03 18:15:00	30	0	4.55	4.10	1.62	4.55	4.15	1.62	1	2	0	3	2	0	4	4	0	1	1	5	5	1	1	3	2	2	1	0	1	0	0.00	0.05	0.00
2227703	2024-08-25 20:30:00	30	1	5.90	4.65	1.44	6.60	4.90	1.44	0	0	1	2	2	0	2	2	1	0	0	1	2	1	1	3	2	2	1	1	1	0	0.70	0.25	0.00
2227705	2024-09-19 02:00:00	30	3	1.37	4.80	6.90	1.37	5.00	8.30	9	5	11	8	7	19	17	12	30	14	19	1	31	2	3	1	2	1	3	0	1	1	0.00	0.20	1.40
2227704	2024-08-25 18:15:00	30	1	3.45	3.55	1.97	3.45	3.55	1.97	1	0	0	0	0	1	1	0	1	0	1	0	1	1	3	1	2	1	2	0	0	0	0.00	0.00	0.00
2227709	2024-08-31 02:00:00	30	0	5.10	4.10	1.57	6.20	4.25	1.52	1	3	7	3	5	4	4	8	11	9	5	2	13	3	2	1	1	2	3	1	1	-1	1.10	0.15	-0.05
2034882	2024-01-21 21:30:00	30	0	2.17	3.50	3.00	2.17	3.65	3.15	1	2	2	0	3	4	1	5	6	5	1	0	6	3	2	1	1	2	3	0	1	1	0.00	0.15	0.15
2216131	2024-05-27 00:00:00	30	1	1.78	3.60	3.85	1.81	3.95	4.10	0	2	5	1	3	4	1	5	9	9	5	1	10	3	2	1	1	2	3	1	1	1	0.03	0.35	0.25
2214865	2024-05-24 03:00:00	30	3	1.82	3.80	4.25	1.71	4.00	4.65	7	6	10	3	11	13	10	17	23	19	12	6	29	3	2	1	1	2	3	-1	1	1	-0.11	0.20	0.40
2034924	2024-01-21 03:00:00	30	1	1.33	5.00	7.70	1.38	5.10	7.70	2	3	9	4	4	7	6	7	16	11	10	1	17	3	2	1	1	2	3	1	1	0	0.05	0.10	0.00
2214866	2024-05-24 00:45:00	30	0	2.08	3.45	3.25	1.99	3.80	3.50	11	4	8	5	9	9	16	13	17	12	15	11	28	2	3	1	2	1	3	-1	1	1	-0.09	0.35	0.25
2034917	2023-12-08 04:00:00	30	3	1.07	11.00	20.00	1.06	11.00	25.00	2	0	0	1	0	1	3	0	1	1	4	3	4	1	3	2	3	1	2	-1	0	1	-0.01	0.00	5.00
2228258	2024-10-13 20:30:00	31	3	2.13	3.40	2.79	2.13	3.55	2.87	0	0	1	0	1	1	0	1	2	2	1	0	2	3	2	1	1	2	3	0	1	1	0.00	0.15	0.08
2228256	2024-10-13 02:00:00	31	1	2.08	3.45	2.85	2.21	3.45	2.81	1	1	3	4	1	1	5	2	4	0	3	1	5	1	3	2	3	1	2	1	0	-1	0.13	0.00	-0.04
2036251	2023-10-15 22:45:00	31	0	1.88	3.75	3.30	1.90	3.75	3.25	2	1	2	2	2	2	4	3	4	1	2	1	5	1	3	1	2	1	2	1	0	-1	0.02	0.00	-0.05
2036250	2023-10-15 20:30:00	31	3	1.41	4.45	5.90	1.39	4.55	6.10	1	0	0	0	1	2	1	1	2	1	1	0	2	2	2	1	1	1	3	-1	1	1	-0.02	0.10	0.20
2228391	2025-01-25 03:00:00	31	3	1.32	5.30	5.70	1.33	4.95	6.50	3	4	10	4	1	6	7	5	16	11	13	2	18	2	3	1	2	1	3	1	-1	1	0.01	-0.35	0.80
2036249	2023-10-15 02:00:00	31	3	1.94	3.80	3.10	1.98	3.60	3.15	3	2	3	3	1	3	6	3	6	1	4	1	7	1	3	1	2	1	2	1	-1	1	0.04	-0.20	0.05
2036248	2023-10-14 22:30:00	31	1	2.41	3.60	2.46	2.50	3.50	2.42	2	1	4	5	0	3	7	1	7	0	6	0	7	1	3	1	2	1	2	1	-1	-1	0.09	-0.10	-0.04
2036499	2024-04-14 22:45:00	31	0	4.95	3.65	1.55	4.90	3.90	1.57	1	0	2	2	2	2	3	2	4	1	2	0	4	2	3	1	2	1	3	-1	1	1	-0.05	0.25	0.02
2021388	2023-06-12 00:00:00	31	0	1.84	3.45	3.75	1.84	3.50	3.70	2	2	2	2	1	3	4	3	5	1	2	0	5	2	3	1	2	1	3	0	1	-1	0.00	0.05	-0.05
2021389	2023-06-07 02:00:00	31	3	2.27	3.15	2.77	2.39	3.25	2.69	10	5	13	11	6	9	21	11	22	1	11	0	22	2	3	1	2	1	3	1	1	-1	0.12	0.10	-0.08
2036359	2024-01-30 03:00:00	31	0	1.25	5.60	8.20	1.24	5.70	8.40	3	1	3	1	2	5	4	3	8	4	5	0	8	2	3	1	2	1	3	-1	1	1	-0.01	0.10	0.20
2228410	2025-02-08 03:00:00	31	0	2.00	3.65	3.10	2.01	3.65	3.05	5	0	3	3	1	3	8	1	6	0	7	2	8	1	3	2	3	1	2	1	0	-1	0.01	0.00	-0.05
2228355	2024-12-14 03:00:00	31	0	1.84	3.80	3.40	1.85	3.80	3.35	2	1	1	1	1	1	3	2	2	2	3	3	5	1	2	2	3	1	1	1	0	-1	0.01	0.00	-0.05
2228352	2024-12-14 03:00:00	31	1	1.82	3.90	3.40	1.83	3.95	3.35	6	4	4	4	5	6	10	9	10	3	4	3	13	1	3	1	2	1	2	1	1	-1	0.01	0.05	-0.05
2228359	2024-12-21 03:00:00	31	1	1.73	3.95	3.70	1.77	3.70	3.80	5	9	5	5	6	10	10	15	15	8	3	3	18	3	1	1	1	2	2	1	-1	1	0.04	-0.25	0.10
2036537	2024-05-11 02:00:00	31	3	1.44	4.35	5.60	1.37	4.70	6.60	5	6	7	3	8	9	8	14	16	9	3	1	17	3	2	1	1	2	3	-1	1	1	-0.07	0.35	1.00
2228356	2024-12-14 03:00:00	31	3	1.72	3.85	3.85	1.55	4.20	4.80	14	3	7	7	8	14	21	11	21	3	13	3	24	1	3	1	2	1	2	-1	1	1	-0.17	0.35	0.95
2228362	2024-12-21 23:30:00	31	1	4.40	3.85	1.59	4.70	4.15	1.55	2	1	6	6	3	2	8	4	8	0	4	0	8	1	3	1	2	1	2	1	1	-1	0.30	0.30	-0.04
2228235	2024-09-22 22:45:00	31	0	2.34	3.55	2.44	2.39	3.50	2.54	6	1	4	5	1	7	11	2	11	0	9	0	11	1	3	1	2	1	2	1	-1	1	0.05	-0.05	0.10
2228363	2024-12-22 23:45:00	31	3	1.35	4.45	6.50	1.42	4.45	5.90	0	3	5	4	1	0	4	4	5	1	1	0	5	2	2	1	1	1	3	1	0	-1	0.07	0.00	-0.60
2228360	2024-12-21 03:00:00	31	0	1.75	3.80	3.75	1.72	3.70	4.00	3	4	5	3	4	7	6	8	12	6	4	0	12	3	2	1	1	2	3	-1	-1	1	-0.03	-0.10	0.25
2036532	2024-05-11 02:00:00	31	3	1.65	3.90	4.20	1.65	3.85	4.20	3	3	2	2	2	3	5	5	5	1	1	1	6	1	1	1	1	1	1	0	-1	0	0.00	-0.05	0.00
2228361	2024-12-22 21:30:00	31	3	2.81	3.40	2.13	2.91	3.50	2.13	1	0	0	1	2	0	2	2	0	0	0	2	2	1	1	3	2	2	1	1	1	0	0.10	0.10	0.00
2228239	2024-09-28 02:00:00	31	1	2.39	3.50	2.41	2.51	3.45	2.44	8	2	8	9	1	10	17	3	18	3	17	2	20	2	3	1	2	1	3	1	-1	1	0.12	-0.05	0.03
2228365	2024-12-22 21:30:00	31	3	1.92	3.65	3.10	1.93	3.85	3.10	3	3	2	3	5	3	6	8	5	3	1	4	9	2	1	3	2	3	1	1	1	0	0.01	0.20	0.00
2228369	2025-01-11 03:00:00	31	3	1.49	4.25	4.70	1.52	4.45	4.60	1	7	10	5	6	6	6	13	16	12	5	2	18	3	2	1	1	2	3	1	1	-1	0.03	0.20	-0.10
2036521	2024-05-04 02:00:00	31	1	2.56	3.45	2.23	2.69	3.55	2.24	2	1	3	4	2	5	6	3	8	3	6	1	9	2	3	1	2	1	3	1	1	1	0.13	0.10	0.01
2228373	2025-01-11 03:00:00	31	0	3.10	3.55	1.95	3.05	3.65	2.00	12	4	6	7	5	13	19	9	19	1	11	1	20	1	3	1	2	1	2	-1	1	1	-0.05	0.10	0.05
2228379	2025-01-18 03:00:00	31	3	2.25	3.35	2.65	2.27	3.25	2.84	8	3	5	6	1	10	14	4	15	1	11	0	15	2	3	1	2	1	3	1	-1	1	0.02	-0.10	0.19
2018725	2023-06-04 02:00:00	31	3	1.82	3.60	3.70	1.86	3.50	3.60	0	2	1	1	0	1	1	2	2	3	2	2	4	3	1	1	1	2	2	1	-1	-1	0.04	-0.10	-0.10
2228193	2024-08-25 18:15:00	31	1	2.43	3.45	2.39	2.43	3.45	2.39	1	0	0	0	0	1	1	0	1	0	1	0	1	1	3	1	2	1	2	0	0	0	0.00	0.00	0.00
2018783	2023-05-31 02:00:00	31	1	2.74	3.25	2.33	2.65	3.25	2.41	10	2	7	8	2	11	18	4	18	1	15	1	19	1	3	1	2	1	2	-1	0	1	-0.09	0.00	0.08
2036446	2023-10-29 19:15:00	31	3	2.32	3.45	2.49	2.32	3.45	2.49	0	0	1	0	0	0	0	0	1	1	1	0	1	2	2	1	1	1	3	0	0	0	0.00	0.00	0.00
2228192	2024-08-24 02:00:00	31	3	2.75	3.40	2.16	2.82	3.50	2.17	7	1	1	7	3	1	14	4	2	0	10	12	14	1	2	3	3	2	1	1	1	1	0.07	0.10	0.01
2036185	2023-08-27 20:30:00	31	1	2.04	3.40	3.15	2.04	3.40	3.15	0	0	0	0	1	1	0	1	1	1	0	0	1	3	1	1	1	2	2	0	0	0	0.00	0.00	0.00
2036313	2023-11-19 23:45:00	31	0	3.30	3.75	1.88	3.25	3.75	1.90	2	1	1	2	2	1	4	3	2	0	1	2	4	1	2	3	3	2	1	-1	0	1	-0.05	0.00	0.02
2036441	2024-04-28 18:15:00	31	1	2.35	3.45	2.48	2.35	3.45	2.48	1	0	2	2	0	1	3	0	3	0	3	0	3	1	3	1	2	1	2	0	0	0	0.00	0.00	0.00
2228199	2024-08-31 02:00:00	31	3	2.21	3.65	2.54	2.39	3.60	2.47	12	5	17	19	4	14	31	9	31	5	27	5	36	1	3	1	2	1	2	1	-1	-1	0.18	-0.05	-0.07
2036312	2023-11-18 04:00:00	31	0	3.00	3.40	2.12	2.78	3.40	2.25	18	10	0	13	9	3	31	19	3	1	13	29	32	1	2	3	3	2	1	-1	0	1	-0.22	0.00	0.13
2036183	2023-08-26 02:00:00	31	3	1.56	4.00	4.40	1.61	3.85	4.60	0	2	2	3	1	1	3	3	3	0	0	0	3	1	1	1	1	1	1	1	-1	1	0.05	-0.15	0.20
2036311	2023-11-18 01:45:00	31	0	2.16	3.60	2.80	2.21	3.45	2.79	0	4	4	2	1	4	2	5	8	8	5	2	10	3	2	1	1	2	3	1	-1	-1	0.05	-0.15	-0.01
2036439	2024-04-20 22:30:00	31	1	1.43	4.55	5.50	1.43	4.55	5.50	1	0	0	0	1	1	1	1	1	0	0	0	1	1	1	1	1	1	1	0	0	0	0.00	0.00	0.00
2228328	2024-12-01 19:15:00	31	3	1.37	4.55	5.80	1.35	4.65	6.00	3	0	0	0	3	3	3	3	3	2	2	2	5	1	1	1	1	1	1	-1	1	1	-0.02	0.10	0.20
2228329	2024-11-30 03:00:00	31	3	2.01	3.55	2.95	1.91	3.60	3.35	11	3	6	9	5	10	20	8	16	3	15	7	23	1	3	2	3	1	2	-1	1	1	-0.10	0.05	0.40
2228334	2024-11-30 03:00:00	31	3	2.24	3.45	2.60	2.42	3.55	2.47	6	1	14	13	3	10	19	4	24	5	20	0	24	2	3	1	2	1	3	1	1	-1	0.18	0.10	-0.13
2228207	2024-09-01 22:45:00	31	0	2.03	3.55	2.89	2.01	3.80	2.95	3	0	0	0	1	4	3	1	4	1	3	0	4	2	3	1	2	1	3	-1	1	1	-0.02	0.25	0.06
2228332	2024-11-30 03:00:00	31	1	2.29	3.55	2.49	2.50	3.65	2.35	3	0	10	10	1	4	13	1	14	1	13	0	14	2	3	1	2	1	3	1	1	-1	0.21	0.10	-0.14
2036176	2023-08-19 02:00:00	31	0	2.78	3.30	2.28	2.79	3.25	2.29	1	1	0	1	0	2	2	1	2	0	1	0	2	1	3	1	2	1	2	1	-1	1	0.01	-0.05	0.01
2228333	2024-11-30 03:00:00	31	1	2.35	3.40	2.50	2.80	3.45	2.21	7	1	14	16	2	9	23	3	23	1	21	1	24	1	3	1	2	1	2	1	1	-1	0.45	0.05	-0.29
2036175	2023-08-22 02:00:00	31	0	3.05	3.90	1.93	2.80	3.90	2.06	8	2	7	7	2	8	15	4	15	1	12	1	16	1	3	1	2	1	2	-1	0	1	-0.25	0.00	0.13
2036430	2024-04-06 02:00:00	31	3	2.21	3.55	2.60	2.21	3.65	2.69	6	1	4	4	2	7	10	3	11	1	8	0	11	2	3	1	2	1	3	0	1	1	0.00	0.10	0.09
2228208	2024-09-07 02:00:00	31	3	1.77	3.65	3.55	1.72	3.75	4.00	8	1	5	5	3	9	13	4	14	1	10	0	14	2	3	1	2	1	3	-1	1	1	-0.05	0.10	0.45
2228212	2024-09-17 02:00:00	31	1	2.07	3.45	2.88	2.17	3.55	2.81	0	1	8	2	2	5	2	3	13	11	10	0	13	3	2	1	1	2	3	1	1	-1	0.10	0.10	-0.07
2228343	2024-12-07 23:30:00	31	3	2.05	3.65	2.79	2.05	3.55	3.05	0	2	1	0	0	2	0	2	3	4	2	1	4	3	2	1	1	2	3	0	-1	1	0.00	-0.10	0.26
2228347	2024-12-14 03:00:00	31	0	2.20	3.65	2.68	2.17	3.60	2.75	3	4	3	2	3	4	5	7	7	6	4	4	11	3	1	1	1	2	2	-1	-1	1	-0.03	-0.05	0.07
2036421	2024-03-24 03:00:00	31	3	2.00	3.45	3.05	2.03	3.50	3.10	3	3	6	7	4	4	10	7	10	1	4	1	11	1	3	1	2	1	2	1	1	1	0.03	0.05	0.05
2228344	2024-12-08 23:45:00	31	1	2.50	3.40	2.35	2.54	3.45	2.39	5	0	3	4	1	6	9	1	9	0	8	0	9	1	3	1	2	1	2	1	1	1	0.04	0.05	0.04
2228350	2024-12-14 03:00:00	31	3	1.46	4.25	5.50	1.44	4.30	5.70	5	5	5	6	5	5	11	10	10	1	2	2	12	1	2	2	3	1	1	-1	1	1	-0.02	0.05	0.20
2228351	2024-12-14 03:00:00	31	0	1.89	3.55	3.50	2.03	3.35	3.25	6	8	8	10	5	7	16	13	15	3	6	4	19	1	3	2	3	1	2	1	-1	-1	0.14	-0.20	-0.25
2036346	2024-01-13 23:30:00	31	0	2.22	3.55	2.74	2.22	3.55	2.74	0	0	0	1	1	1	1	1	1	0	0	0	1	1	1	1	1	1	1	0	0	0	0.00	0.00	0.00
2018808	2023-06-03 22:30:00	31	1	1.66	3.65	4.50	1.66	3.65	4.50	2	0	1	1	0	2	3	0	3	0	3	0	3	1	3	1	2	1	2	0	0	0	0.00	0.00	0.00
2036345	2023-12-23 03:00:00	31	3	1.75	3.80	3.75	1.70	3.85	3.95	2	1	2	1	2	2	3	3	4	1	1	0	4	2	2	1	1	1	3	-1	1	1	-0.05	0.05	0.20
2036344	2023-12-23 03:00:00	31	0	2.35	3.25	2.73	2.33	3.20	2.80	13	14	16	13	13	16	26	27	32	14	13	8	40	3	2	1	1	2	3	-1	-1	1	-0.02	-0.05	0.07
2228170	2024-08-10 02:00:00	31	0	2.44	3.50	2.34	2.63	3.60	2.26	6	1	5	7	3	7	13	4	12	0	9	1	13	1	3	2	3	1	2	1	1	-1	0.19	0.10	-0.08
2228172	2024-08-10 02:00:00	31	0	2.03	3.50	2.91	2.06	3.60	2.96	4	2	5	3	4	6	7	6	11	5	6	1	12	2	3	1	2	1	3	1	1	1	0.03	0.10	0.05
2228307	2024-11-16 03:00:00	31	3	1.56	3.80	5.00	1.57	3.90	4.85	0	2	5	2	3	2	2	5	7	6	3	1	8	3	2	1	1	2	3	1	1	-1	0.01	0.10	-0.15
2036205	2023-09-19 02:00:00	31	3	1.39	5.00	5.50	1.39	5.10	5.50	1	1	2	1	2	2	2	3	4	3	2	1	5	3	2	1	1	2	3	0	1	0	0.00	0.10	0.00
2228179	2024-08-17 02:00:00	31	3	2.00	3.55	2.95	2.03	3.65	3.00	8	3	5	10	5	6	18	8	11	2	12	9	20	1	3	2	3	1	2	1	1	1	0.03	0.10	0.05
2228178	2024-08-18 18:15:00	31	0	1.68	3.75	3.90	1.70	3.70	3.80	1	1	2	2	1	1	3	2	3	0	1	0	3	1	3	1	2	1	2	1	-1	-1	0.02	-0.05	-0.10
2228310	2024-11-27 03:00:00	31	0	1.66	4.10	3.65	1.48	4.40	5.10	7	4	2	2	7	8	9	11	10	4	2	3	13	3	1	2	1	3	2	-1	1	1	-0.18	0.30	1.45
2036458	2023-12-09 03:00:00	31	1	2.32	3.40	2.66	2.36	3.35	2.65	13	8	12	12	8	12	25	16	24	5	14	6	30	1	3	2	3	1	2	1	-1	-1	0.04	-0.05	-0.01
2228311	2024-11-26 03:00:00	31	1	1.38	4.45	6.00	1.42	4.50	5.70	2	3	3	3	4	4	5	7	7	4	2	2	9	3	1	1	1	2	2	1	1	-1	0.04	0.05	-0.30
2036201	2023-09-10 03:00:00	31	0	2.04	3.50	2.91	2.06	3.60	2.98	3	0	2	2	2	3	5	2	5	0	3	0	5	1	3	1	2	1	2	1	1	1	0.02	0.10	0.07
2036200	2023-09-10 00:45:00	31	3	1.26	5.50	6.90	1.28	5.40	7.50	5	5	8	6	5	6	11	10	14	3	4	0	14	2	3	1	2	1	3	1	-1	1	0.02	-0.10	0.60
2228309	2024-11-17 21:30:00	31	1	2.17	3.35	2.92	2.17	3.35	2.94	0	1	0	0	0	2	0	1	2	2	1	0	2	3	2	1	1	2	3	0	0	1	0.00	0.00	0.02
2036199	2023-09-09 22:30:00	31	0	2.16	3.40	2.76	2.12	3.50	2.91	3	2	2	3	2	4	6	4	6	0	2	0	6	1	3	1	2	1	2	-1	1	1	-0.04	0.10	0.15
2036455	2023-11-26 19:15:00	31	3	1.51	3.95	4.75	1.51	3.95	4.75	1	0	0	0	1	1	1	1	1	0	0	0	1	1	1	1	1	1	1	0	0	0	0.00	0.00	0.00
2228314	2024-11-26 03:00:00	31	3	2.93	3.45	2.13	3.05	3.55	2.04	3	2	3	5	3	1	8	5	4	0	3	4	8	1	2	3	3	2	1	1	1	-1	0.12	0.10	-0.09
2036326	2023-12-02 03:00:00	31	0	3.80	3.65	1.71	3.90	3.65	1.76	8	8	7	10	8	8	18	16	15	3	5	6	21	1	2	3	3	2	1	1	0	1	0.10	0.00	0.05
2036197	2023-09-03 22:45:00	31	3	1.86	3.55	3.35	1.86	3.65	3.45	0	2	2	0	2	3	0	4	5	5	1	0	5	3	2	1	1	2	3	0	1	1	0.00	0.10	0.10
2228312	2024-11-26 03:00:00	31	3	2.15	3.50	2.69	2.22	3.55	2.71	1	1	1	2	1	1	3	2	2	0	1	1	3	1	2	2	3	1	1	1	1	1	0.07	0.05	0.02
2036452	2023-11-19 21:30:00	31	1	1.92	3.75	3.20	1.97	3.70	3.10	11	4	8	8	2	11	19	6	19	0	13	0	19	1	3	1	2	1	2	1	-1	-1	0.05	-0.05	-0.10
2023079	2023-08-17 03:00:00	32	1	1.34	4.90	7.70	1.37	4.95	8.60	11	11	11	10	11	16	21	22	27	7	6	1	28	3	2	1	1	2	3	1	1	1	0.03	0.05	0.90
2219178	2024-08-15 03:00:00	32	3	1.50	4.35	4.90	1.49	4.50	6.40	5	1	5	5	6	6	10	7	11	3	6	2	13	2	3	1	2	1	3	-1	1	1	-0.01	0.15	1.50
2037791	2024-05-06 01:30:00	33	1	2.84	3.60	2.38	2.83	3.55	2.40	1	1	1	4	1	1	5	2	2	0	3	3	5	1	2	2	3	1	1	-1	-1	1	-0.01	-0.05	0.02
2037790	2024-05-05 00:30:00	33	1	2.40	3.60	2.81	2.44	3.60	2.76	0	0	2	1	1	3	1	1	5	4	4	0	5	2	2	1	1	1	3	1	0	-1	0.04	0.00	-0.05
2037789	2024-04-27 21:30:00	33	3	1.68	4.50	4.30	1.68	4.50	4.30	0	0	0	0	1	1	0	1	1	1	0	0	1	3	1	1	1	2	2	0	0	0	0.00	0.00	0.00
2037788	2024-04-28 23:30:00	33	1	1.53	4.15	5.50	1.54	4.30	6.00	2	1	3	2	3	3	4	4	6	2	2	0	6	2	2	1	1	1	3	1	1	1	0.01	0.15	0.50
2019354	2023-06-06 02:45:00	33	0	2.78	3.90	2.31	2.76	3.90	2.31	4	1	0	3	2	0	7	3	0	1	5	8	8	1	2	3	3	2	1	-1	0	0	-0.02	0.00	0.00
2037787	2024-04-29 01:30:00	33	0	3.15	3.80	2.13	3.10	3.80	2.16	1	0	0	1	1	1	2	1	1	0	1	1	2	1	2	2	3	1	1	-1	0	1	-0.05	0.00	0.03
2037786	2024-04-27 02:30:00	33	3	2.20	3.75	2.79	2.21	4.05	2.86	3	4	11	5	6	10	8	10	21	13	11	0	21	3	2	1	1	2	3	1	1	1	0.01	0.30	0.07
2235943	2025-01-26 22:30:00	33	1	2.93	3.50	2.20	3.15	3.60	2.20	1	0	1	2	2	0	3	2	1	1	2	3	4	1	2	3	3	2	1	1	1	0	0.22	0.10	0.00
2037785	2024-04-28 21:30:00	33	1	2.25	3.40	3.20	2.25	3.40	3.20	0	0	0	0	1	1	0	1	1	1	0	0	1	3	1	1	1	2	2	0	0	0	0.00	0.00	0.00
2037784	2024-04-27 21:30:00	33	3	1.42	4.80	5.90	1.44	5.30	5.90	3	1	4	4	3	3	7	4	7	1	4	1	8	1	3	1	2	1	2	1	1	0	0.02	0.50	0.00
2037783	2024-04-28 00:30:00	33	1	1.76	4.00	3.85	1.76	4.25	4.05	3	1	2	1	3	3	4	4	5	3	3	2	7	2	2	1	1	1	3	0	1	1	0.00	0.25	0.20
2037782	2024-04-27 21:30:00	33	0	1.82	3.85	3.70	1.82	4.10	3.90	0	1	1	0	3	1	0	4	2	4	0	2	4	3	1	2	1	3	2	0	1	1	0.00	0.25	0.20
2235947	2025-02-10 00:30:00	33	3	1.54	4.25	5.10	1.58	4.30	5.40	4	3	6	7	3	4	11	6	10	1	6	2	12	1	3	2	3	1	2	1	1	1	0.04	0.05	0.30
2037781	2024-04-20 21:30:00	33	3	1.77	3.80	3.95	1.77	3.90	4.40	0	2	1	0	2	2	0	4	3	5	1	2	5	3	1	2	1	3	2	0	1	1	0.00	0.10	0.45
2235944	2025-01-25 03:30:00	33	1	1.38	4.75	7.10	1.43	4.85	7.10	5	4	7	6	6	8	11	10	15	10	11	6	21	2	3	1	2	1	3	1	1	0	0.05	0.10	0.00
2037780	2024-04-21 21:30:00	33	3	4.55	4.20	1.61	5.20	4.35	1.60	1	0	1	3	2	0	4	2	1	1	3	4	5	1	2	3	3	2	1	1	1	-1	0.65	0.15	-0.01
2037779	2024-04-21 00:30:00	33	0	5.10	4.20	1.62	4.90	4.15	1.65	2	1	1	1	0	3	3	1	4	2	4	1	5	2	3	1	2	1	3	-1	-1	1	-0.20	-0.05	0.03
2037777	2024-04-20 21:30:00	33	3	2.11	3.85	2.90	2.11	3.95	3.10	0	0	1	0	2	1	0	2	2	3	1	1	3	3	1	1	1	2	2	0	1	1	0.00	0.10	0.20
2037776	2024-04-20 21:30:00	33	0	6.50	4.65	1.41	6.40	4.80	1.46	2	2	2	2	4	2	4	6	4	4	2	4	8	2	1	2	1	3	1	-1	1	1	-0.10	0.15	0.05
2235949	2025-02-08 22:30:00	33	0	1.89	3.85	3.45	1.94	4.00	3.50	5	1	7	4	3	6	9	4	13	7	12	3	16	2	3	1	2	1	3	1	1	1	0.05	0.15	0.05
2037775	2024-04-21 23:30:00	33	1	2.42	3.70	2.53	2.42	3.75	2.71	5	1	6	4	2	8	9	3	14	5	11	0	14	2	3	1	2	1	3	0	1	1	0.00	0.05	0.18
2037774	2024-04-14 00:30:00	33	3	1.49	4.35	5.60	1.48	4.70	6.30	2	0	1	2	4	4	4	4	5	1	1	0	5	2	2	1	1	1	3	-1	1	1	-0.01	0.35	0.70
2037773	2024-04-13 21:30:00	33	3	1.33	5.10	7.40	1.33	5.50	8.60	3	0	3	3	3	7	6	3	10	4	7	0	10	2	3	1	2	1	3	0	1	1	0.00	0.40	1.20
2037772	2024-04-13 21:30:00	33	3	2.03	3.75	3.10	2.00	3.85	3.45	6	3	2	3	4	4	9	7	6	1	3	4	10	1	2	3	3	2	1	-1	1	1	-0.03	0.10	0.35
2037771	2024-04-14 21:30:00	33	0	3.55	3.70	1.89	3.85	3.85	1.89	1	0	0	1	1	0	2	1	0	0	1	2	2	1	2	3	3	2	1	1	1	0	0.30	0.15	0.00
2037769	2024-04-13 21:30:00	33	0	3.00	3.95	2.03	3.50	4.00	1.95	2	1	8	6	2	3	8	3	11	4	9	1	12	2	3	1	2	1	3	1	1	-1	0.50	0.05	-0.08
2037768	2024-04-13 21:30:00	33	3	1.20	6.60	10.00	1.21	7.20	12.00	1	2	2	2	2	3	3	4	5	5	4	3	8	3	2	1	1	2	3	1	1	1	0.01	0.60	2.00
2037767	2024-04-07 23:30:00	33	0	1.86	3.70	3.70	1.86	3.90	3.90	2	0	4	3	2	3	5	2	7	2	5	0	7	2	3	1	2	1	3	0	1	1	0.00	0.20	0.20
2037766	2024-04-14 23:30:00	33	3	1.18	6.70	12.00	1.21	6.80	14.00	6	5	3	7	6	4	13	11	7	2	4	8	15	1	2	3	3	2	1	1	1	1	0.03	0.10	2.00
2037765	2024-04-13 02:30:00	33	3	2.19	3.40	3.05	2.14	3.50	3.40	2	1	2	2	2	4	4	3	6	2	3	0	6	2	3	1	2	1	3	-1	1	1	-0.05	0.10	0.35
2037764	2024-04-06 21:30:00	33	0	5.20	4.00	1.57	5.80	4.10	1.58	1	1	1	2	2	1	3	3	2	1	1	2	4	1	1	3	2	2	1	1	1	1	0.60	0.10	0.01
2235906	2025-01-18 22:30:00	33	1	3.35	3.55	2.01	3.45	3.75	2.03	2	1	1	2	1	3	4	2	4	1	3	1	5	1	3	1	2	1	2	1	1	1	0.10	0.20	0.02
2235907	2025-01-18 22:30:00	33	3	1.17	7.50	11.00	1.17	8.30	13.00	2	1	0	3	4	2	5	5	2	1	1	4	6	1	1	3	2	2	1	0	1	1	0.00	0.80	2.00
2235904	2025-01-15 03:30:00	33	3	2.06	3.50	3.20	2.00	3.75	3.50	12	5	11	15	5	12	27	10	23	5	22	9	32	1	3	2	3	1	2	-1	1	1	-0.06	0.25	0.30
2235905	2025-01-19 01:30:00	33	3	1.27	5.90	8.30	1.28	6.10	9.20	2	4	10	3	4	9	5	8	19	15	12	1	20	3	2	1	1	2	3	1	1	1	0.01	0.20	0.90
2235910	2025-01-19 22:30:00	33	3	2.56	3.20	2.67	2.58	3.15	2.90	7	1	6	9	0	8	16	1	14	1	16	3	17	1	3	2	3	1	2	1	-1	1	0.02	-0.05	0.23
2235911	2025-01-20 00:30:00	33	0	1.91	3.60	3.60	1.92	3.65	3.95	2	0	4	3	1	4	5	1	8	3	7	0	8	2	3	1	2	1	3	1	1	1	0.01	0.05	0.35
2235908	2025-01-18 22:30:00	33	3	1.65	4.05	4.40	1.64	4.25	4.85	11	7	10	8	9	12	19	16	22	4	7	1	23	2	3	1	2	1	3	-1	1	1	-0.01	0.20	0.45
2235909	2025-01-18 03:30:00	33	3	2.28	3.70	2.70	2.53	3.70	2.61	3	4	12	6	3	11	9	7	23	15	17	1	24	2	3	1	2	1	3	1	0	-1	0.25	0.00	-0.09
2235914	2025-01-25 22:30:00	33	1	1.59	4.20	4.65	1.55	4.60	5.30	5	0	1	0	5	7	5	5	8	3	3	0	8	2	2	1	1	1	3	-1	1	1	-0.04	0.40	0.65
2235915	2025-01-25 22:30:00	33	0	8.80	5.40	1.29	9.00	5.90	1.30	10	3	4	11	6	2	21	9	6	2	14	17	23	1	2	3	3	2	1	1	1	1	0.20	0.50	0.01
2235912	2025-01-25 22:30:00	33	3	1.89	3.55	3.75	1.89	3.65	4.05	3	1	2	3	2	4	6	3	6	1	4	1	7	1	3	1	2	1	2	0	1	1	0.00	0.10	0.30
2235917	2025-01-25 22:30:00	33	1	3.40	3.85	1.90	3.60	4.00	1.92	1	2	0	1	2	1	2	4	1	2	0	3	4	2	1	3	2	3	1	1	1	1	0.20	0.15	0.02
2235923	2025-02-08 03:30:00	33	3	1.11	11.00	17.00	1.11	11.00	16.00	2	3	5	3	4	5	5	7	10	9	7	4	14	3	2	1	1	2	3	0	0	-1	0.00	0.00	-1.00
2037801	2024-05-04 21:30:00	33	3	1.85	4.10	3.35	1.82	4.20	3.80	5	6	5	5	6	7	10	12	12	8	6	6	18	3	1	1	1	2	2	-1	1	1	-0.03	0.10	0.45
2235924	2025-02-09 01:30:00	33	1	2.51	3.55	2.49	2.59	3.70	2.53	3	2	0	1	3	1	4	5	1	2	1	5	6	2	1	3	2	3	1	1	1	1	0.08	0.15	0.04
2037800	2024-05-13 01:30:00	33	0	4.25	4.00	1.68	4.25	4.15	1.74	10	5	4	7	5	9	17	10	13	3	10	7	20	1	3	2	3	1	2	0	1	1	0.00	0.15	0.06
2037799	2024-05-11 21:30:00	33	1	2.41	3.60	2.57	2.53	3.75	2.59	1	0	2	1	2	1	2	2	3	2	2	1	4	2	2	1	1	1	3	1	1	1	0.12	0.15	0.02
2235930	2025-01-18 22:30:00	33	0	2.49	3.35	2.63	2.49	3.45	2.79	0	0	2	0	1	1	0	1	3	3	2	0	3	3	2	1	1	2	3	0	1	1	0.00	0.10	0.16
2037798	2024-05-12 23:30:00	33	3	1.40	4.85	6.30	1.36	5.20	6.70	5	2	5	3	4	7	8	6	12	7	9	3	15	2	3	1	2	1	3	-1	1	1	-0.04	0.35	0.40
2235931	2025-01-18 22:30:00	33	0	2.69	3.55	2.35	2.85	3.65	2.35	2	0	0	1	2	0	3	2	0	0	1	3	3	1	2	3	3	2	1	1	1	0	0.16	0.10	0.00
2037797	2024-05-11 02:30:00	33	0	3.45	3.95	1.86	3.70	4.30	1.82	9	4	8	8	9	5	17	13	13	7	11	11	24	1	2	2	3	1	1	1	1	-1	0.25	0.35	-0.04
2235928	2025-02-08 22:30:00	33	1	1.80	3.55	4.10	1.82	3.60	4.50	0	1	2	2	1	1	2	2	3	1	1	0	3	2	2	1	1	1	3	1	1	1	0.02	0.05	0.40
2037796	2024-05-04 21:30:00	33	3	1.37	4.80	7.00	1.39	4.95	7.80	1	2	3	3	3	3	4	5	6	2	1	0	6	3	2	1	1	2	3	1	1	1	0.02	0.15	0.80
2235929	2025-02-08 22:30:00	33	1	3.60	3.90	1.84	3.95	3.95	1.84	3	2	2	4	3	2	7	5	4	2	4	5	9	1	2	3	3	2	1	1	1	0	0.35	0.05	0.00
2037795	2024-05-04 21:30:00	33	1	2.28	3.65	2.73	2.28	3.70	2.93	0	1	1	0	2	2	0	3	3	3	0	0	3	3	1	1	1	2	2	0	1	1	0.00	0.05	0.20
2235934	2025-02-09 22:30:00	33	1	2.31	3.50	2.76	2.25	3.60	3.05	1	0	1	0	1	3	1	1	4	3	3	0	4	2	2	1	1	1	3	-1	1	1	-0.06	0.10	0.29
2037794	2024-05-05 21:30:00	33	0	1.97	3.20	3.85	1.97	3.45	3.95	3	1	3	2	2	5	5	3	8	4	6	1	9	2	3	1	2	1	3	0	1	1	0.00	0.25	0.10
2037793	2024-05-04 21:30:00	33	3	2.14	3.85	2.83	2.19	3.95	2.94	0	0	4	1	1	4	1	1	8	7	7	0	8	2	2	1	1	1	3	1	1	1	0.05	0.10	0.11
2037792	2024-05-04 02:30:00	33	1	5.20	4.85	1.48	5.50	5.20	1.48	7	2	6	10	6	6	17	8	12	8	17	13	25	1	3	2	3	1	2	1	1	0	0.30	0.35	0.00
2037373	2023-09-16 02:30:00	33	1	1.54	4.45	4.85	1.62	4.75	4.50	4	6	7	7	5	7	11	11	14	3	3	0	14	2	2	1	1	1	3	1	1	-1	0.08	0.30	-0.35
2036860	2023-08-20 21:30:00	33	3	1.99	3.45	3.90	1.99	3.50	3.85	1	0	1	0	2	1	1	2	2	1	0	0	2	3	1	1	1	2	2	0	1	-1	0.00	0.05	-0.05
2036856	2023-08-20 00:30:00	33	3	1.39	5.30	7.00	1.39	5.30	6.90	2	1	4	2	2	2	4	3	6	2	3	0	6	2	3	1	2	1	3	0	0	-1	0.00	0.00	-0.10
2036855	2023-08-19 21:30:00	33	3	2.44	3.35	2.68	2.42	3.60	2.78	1	0	1	1	1	2	2	1	3	1	2	0	3	2	3	1	2	1	3	-1	1	1	-0.02	0.25	0.10
2037366	2023-09-03 21:30:00	33	1	2.16	3.35	3.10	2.16	3.45	3.35	1	0	0	0	2	1	1	2	1	2	1	2	3	2	1	2	1	3	1	0	1	1	0.00	0.10	0.25
2036852	2023-08-19 02:30:00	33	0	8.50	6.60	1.28	8.50	6.50	1.28	11	6	6	7	6	7	18	12	13	1	7	6	19	1	3	2	3	1	2	0	-1	0	0.00	-0.10	0.00
2037364	2023-09-02 02:30:00	33	1	1.24	6.50	11.00	1.28	6.10	9.50	7	10	9	10	7	10	17	17	19	5	5	3	22	2	2	1	1	1	3	1	-1	-1	0.04	-0.40	-1.50
2037363	2023-09-03 00:30:00	33	0	7.80	6.00	1.28	7.70	6.30	1.31	7	4	4	7	6	6	14	10	10	0	4	4	14	1	2	2	3	1	1	-1	1	1	-0.10	0.30	0.03
2037361	2023-08-26 02:30:00	33	3	1.45	4.40	6.30	1.48	4.70	6.20	1	3	6	3	5	3	4	8	9	5	1	0	9	3	2	1	1	2	3	1	1	-1	0.03	0.30	-0.10
2037360	2023-08-27 21:30:00	33	1	2.42	3.70	2.73	2.42	3.70	2.73	0	0	0	0	1	1	0	1	1	1	0	0	1	3	1	1	1	2	2	0	0	0	0.00	0.00	0.00
2037356	2023-08-26 21:30:00	33	1	6.20	4.90	1.40	6.40	5.00	1.44	2	2	3	4	4	3	6	6	6	0	0	0	6	1	1	1	1	1	1	1	1	1	0.20	0.10	0.04
2037354	2023-08-27 23:30:00	33	3	1.08	11.00	16.00	1.12	9.90	19.00	0	3	5	4	0	2	4	3	7	4	5	1	8	2	3	1	2	1	3	1	-1	1	0.04	-1.10	3.00
2235554	2024-08-24 21:30:00	33	1	2.12	3.15	3.40	2.11	3.25	3.70	1	1	2	1	2	2	2	3	4	3	2	1	5	3	2	1	1	2	3	-1	1	1	-0.01	0.10	0.30
2037406	2023-10-07 21:30:00	33	1	1.24	6.10	8.60	1.25	6.30	11.00	3	6	6	6	3	4	9	9	10	2	2	1	11	2	2	1	1	1	3	1	1	1	0.01	0.20	2.40
2235555	2024-08-24 21:30:00	33	3	1.65	4.15	4.95	1.65	4.15	4.95	0	0	0	0	1	1	0	1	1	1	0	0	1	3	1	1	1	2	2	0	0	0	0.00	0.00	0.00
2235552	2024-08-24 21:30:00	33	1	2.23	3.60	3.10	2.23	3.60	3.10	0	0	0	0	1	1	0	1	1	1	0	0	1	3	1	1	1	2	2	0	0	0	0.00	0.00	0.00
2037404	2023-10-07 21:30:00	33	3	1.59	4.15	5.60	1.59	4.15	5.60	0	0	0	0	1	1	0	1	1	1	0	0	1	3	1	1	1	2	2	0	0	0	0.00	0.00	0.00
2235553	2024-08-24 21:30:00	33	3	3.05	3.60	2.11	3.40	3.60	2.09	2	1	3	3	1	3	5	2	6	3	6	2	8	2	3	1	2	1	3	1	0	-1	0.35	0.00	-0.02
2037403	2023-10-07 02:30:00	33	1	2.03	3.65	3.20	2.07	3.75	3.30	6	2	6	7	4	7	13	6	13	5	12	5	18	1	3	1	2	1	2	1	1	1	0.04	0.10	0.10
2235558	2024-08-25 21:30:00	33	0	5.90	4.65	1.44	5.60	4.75	1.52	7	6	6	4	5	12	11	11	18	10	10	3	21	2	2	1	1	1	3	-1	1	1	-0.30	0.10	0.08
2037402	2023-10-08 23:30:00	33	3	1.13	8.90	12.00	1.15	8.80	15.00	2	3	2	3	3	3	5	6	5	2	1	2	7	2	1	2	1	3	1	1	-1	1	0.02	-0.10	3.00
2235559	2024-09-01 00:30:00	33	0	1.78	4.00	3.75	1.76	4.30	4.05	5	1	2	2	4	6	7	5	8	1	3	0	8	2	3	1	2	1	3	-1	1	1	-0.02	0.30	0.30
2037401	2023-10-08 21:30:00	33	3	1.27	5.50	9.80	1.30	5.70	9.60	0	1	2	2	1	0	2	2	2	0	0	0	2	1	1	1	1	1	1	1	1	-1	0.03	0.20	-0.20
2235556	2024-08-24 21:30:00	33	3	1.23	6.20	9.90	1.23	6.50	12.00	2	1	2	2	4	5	4	5	7	4	3	1	8	3	2	1	1	2	3	0	1	1	0.00	0.30	2.10
2235557	2024-08-25 23:30:00	33	0	2.17	3.50	2.99	2.07	3.60	3.45	3	1	2	0	3	5	3	4	7	4	3	0	7	3	2	1	1	2	3	-1	1	1	-0.10	0.10	0.46
2037399	2023-09-30 21:30:00	33	3	2.12	3.40	3.20	2.04	3.50	3.65	1	1	0	0	2	3	1	3	3	3	1	1	4	3	1	1	1	2	2	-1	1	1	-0.08	0.10	0.45
2235562	2024-08-31 21:30:00	33	3	1.81	3.95	3.65	1.79	4.05	4.10	4	0	2	1	2	4	5	2	6	2	5	1	7	2	3	1	2	1	3	-1	1	1	-0.02	0.10	0.45
2037398	2023-10-01 00:30:00	33	1	3.60	4.10	1.90	3.55	4.00	1.92	4	4	1	3	2	4	7	6	5	0	1	2	7	1	2	3	3	2	1	-1	-1	1	-0.05	-0.10	0.02
2235563	2024-09-01 21:30:00	33	3	2.36	3.50	2.71	2.36	3.45	2.96	0	1	0	0	0	3	0	1	3	3	2	0	3	3	2	1	1	2	3	0	-1	1	0.00	-0.05	0.25
2235560	2024-09-01 23:30:00	33	3	1.20	7.10	9.70	1.21	7.40	11.00	2	3	2	2	6	6	4	9	8	7	2	3	11	3	1	2	1	3	2	1	1	1	0.01	0.30	1.30
2037396	2023-09-30 02:30:00	33	0	2.97	4.00	2.16	2.95	4.00	2.17	2	0	1	3	1	1	5	1	2	0	4	3	5	1	3	2	3	1	2	-1	0	1	-0.02	0.00	0.01
2235561	2024-08-31 21:30:00	33	0	2.49	3.65	2.46	2.74	3.75	2.38	3	0	3	3	2	2	6	2	5	1	5	2	7	1	3	2	3	1	2	1	1	-1	0.25	0.10	-0.08
2235566	2024-08-31 02:30:00	33	3	2.02	3.45	3.40	1.96	3.55	3.85	13	4	5	7	5	12	20	9	17	2	13	5	22	1	3	2	3	1	2	-1	1	1	-0.06	0.10	0.45
2235567	2024-08-31 21:30:00	33	1	3.45	4.00	1.85	3.80	4.00	1.86	2	1	2	3	1	2	5	2	4	0	3	1	5	1	3	2	3	1	2	1	0	1	0.35	0.00	0.01
2235564	2024-08-31 21:30:00	33	0	2.80	3.55	2.26	3.10	3.60	2.23	2	2	3	5	2	2	7	4	5	0	3	2	7	1	3	2	3	1	2	1	1	-1	0.30	0.05	-0.03
2235565	2024-08-31 21:30:00	33	1	1.66	4.10	4.90	1.63	4.15	5.10	1	0	0	0	2	2	1	2	2	1	0	0	2	3	1	1	1	2	2	-1	1	1	-0.03	0.05	0.20
2235570	2024-09-14 02:30:00	33	3	1.37	4.80	6.90	1.40	4.95	7.70	7	9	15	10	7	10	17	16	25	10	11	2	27	2	3	1	2	1	3	1	1	1	0.03	0.15	0.80
2235568	2024-09-14 21:30:00	33	0	2.59	3.70	2.35	2.72	3.90	2.35	1	0	0	1	1	1	2	1	1	0	1	1	2	1	2	2	3	1	1	1	1	0	0.13	0.20	0.00
2235574	2024-09-14 21:30:00	33	1	1.45	4.20	6.60	1.43	4.65	7.40	3	0	0	1	3	5	4	3	5	1	2	0	5	2	3	1	2	1	3	-1	1	1	-0.02	0.45	0.80
2037386	2023-09-23 21:30:00	33	3	1.69	4.20	4.00	1.69	4.30	4.40	0	0	1	0	2	1	0	2	2	2	0	0	2	3	1	1	1	2	2	0	1	1	0.00	0.10	0.40
2235575	2024-09-15 23:30:00	33	0	2.07	3.35	3.35	2.08	3.60	3.40	2	0	2	2	1	2	4	1	4	1	4	1	5	1	3	1	2	1	2	1	1	1	0.01	0.25	0.05
2235572	2024-09-14 21:30:00	33	0	5.50	4.70	1.47	5.80	5.20	1.46	2	1	3	3	3	2	5	4	5	0	1	0	5	1	3	1	2	1	2	1	1	-1	0.30	0.50	-0.01
2037384	2023-09-23 21:30:00	33	3	1.09	10.00	16.00	1.10	11.00	20.00	0	0	0	1	1	2	1	1	2	1	1	0	2	2	2	1	1	1	3	1	1	1	0.01	1.00	4.00
2235573	2024-09-15 00:30:00	33	0	9.70	6.50	1.23	12.00	7.30	1.20	2	2	3	5	3	1	7	5	4	3	5	6	10	1	2	3	3	2	1	1	1	-1	2.30	0.80	-0.03
2037383	2023-09-24 21:30:00	33	3	1.23	6.20	9.80	1.23	7.10	10.00	2	1	3	1	3	4	3	4	7	4	3	0	7	3	2	1	1	2	3	0	1	1	0.00	0.90	0.20
2235578	2024-09-22 21:30:00	33	3	1.28	5.60	8.80	1.30	5.90	9.30	2	0	2	2	3	6	4	3	8	5	6	1	9	2	3	1	2	1	3	1	1	1	0.02	0.30	0.50
2235579	2024-09-22 00:30:00	33	3	1.79	3.95	3.75	1.79	4.15	4.00	2	2	5	3	5	5	5	7	10	10	8	5	15	3	2	1	1	2	3	0	1	1	0.00	0.20	0.25
2235576	2024-09-21 02:30:00	33	0	2.40	3.55	2.63	2.44	3.45	2.87	4	5	15	5	6	12	9	11	27	18	16	0	27	3	2	1	1	2	3	1	-1	1	0.04	-0.10	0.24
2235577	2024-09-14 21:30:00	33	0	2.64	3.35	2.49	2.73	3.55	2.49	2	1	2	4	1	2	6	2	4	0	4	2	6	1	3	2	3	1	2	1	1	0	0.09	0.20	0.00
2235582	2024-09-23 01:30:00	33	1	5.30	4.20	1.61	5.10	4.15	1.63	4	2	7	7	3	4	11	5	11	2	8	2	13	1	3	1	2	1	2	-1	-1	1	-0.20	-0.05	0.02
2037378	2023-09-17 21:30:00	33	3	2.31	3.65	2.67	2.38	3.70	2.79	0	0	1	2	1	2	2	1	3	1	2	0	3	2	3	1	2	1	3	1	1	1	0.07	0.05	0.12
2235583	2024-09-22 23:30:00	33	3	2.29	3.85	2.62	2.29	4.00	2.76	0	5	8	0	7	8	0	12	16	17	5	1	17	3	2	1	1	2	3	0	1	1	0.00	0.15	0.14
2037377	2023-09-16 21:30:00	33	0	2.90	3.75	2.14	3.10	3.80	2.16	1	0	0	2	1	1	3	1	1	0	2	2	3	1	2	2	3	1	1	1	1	1	0.20	0.05	0.02
2037439	2023-11-11 22:30:00	33	3	2.43	3.75	2.49	2.42	3.95	2.60	3	1	4	3	2	6	6	3	10	5	8	1	11	2	3	1	2	1	3	-1	1	1	-0.01	0.20	0.11
2037438	2023-11-13 02:30:00	33	3	1.42	4.65	6.40	1.43	4.85	7.00	4	3	4	4	5	5	8	8	9	2	2	1	10	2	2	1	1	1	3	1	1	1	0.01	0.20	0.60
2037435	2023-11-11 03:30:00	33	3	2.33	3.75	2.61	2.38	3.85	2.71	2	4	8	2	4	11	4	8	19	15	11	0	19	3	2	1	1	2	3	1	1	1	0.05	0.10	0.10
2037434	2023-11-11 22:30:00	33	3	1.07	14.00	14.00	1.07	14.00	24.00	2	2	7	3	2	8	5	4	15	11	12	1	16	2	3	1	2	1	3	0	0	1	0.00	0.00	10.00
2037433	2023-11-12 22:30:00	33	3	1.27	5.60	9.10	1.28	5.70	10.00	8	6	10	8	7	8	16	13	18	6	9	4	22	2	3	1	2	1	3	1	1	1	0.01	0.10	0.90
2037432	2023-11-05 22:30:00	33	1	1.71	4.10	3.95	1.68	4.25	4.55	2	0	1	0	1	4	2	1	5	3	4	0	5	2	3	1	2	1	3	-1	1	1	-0.03	0.15	0.60
2037428	2023-11-05 01:30:00	33	0	3.45	4.10	1.83	3.40	4.25	1.93	8	5	5	7	3	7	15	8	12	2	9	5	17	1	3	2	3	1	2	-1	1	1	-0.05	0.15	0.10
2037425	2023-10-28 21:30:00	33	0	1.85	3.90	3.50	1.81	4.05	4.00	1	1	0	0	3	2	1	4	2	3	0	2	4	3	1	2	1	3	2	-1	1	1	-0.04	0.15	0.50
2037424	2023-10-29 00:30:00	33	3	1.45	4.65	7.00	1.46	4.55	6.80	6	5	6	6	5	7	12	10	13	3	5	2	15	2	3	1	2	1	3	1	-1	-1	0.01	-0.10	-0.20
2037423	2023-10-29 22:30:00	33	1	2.91	3.60	2.19	3.20	3.75	2.13	1	0	1	2	2	0	3	2	1	0	1	2	3	1	2	3	3	2	1	1	1	-1	0.29	0.15	-0.06
2037422	2023-10-28 02:30:00	33	1	2.45	3.45	2.62	2.68	3.55	2.53	2	3	12	7	4	8	9	7	20	11	13	0	20	2	3	1	2	1	3	1	1	-1	0.23	0.10	-0.09
2037420	2023-10-28 21:30:00	33	3	1.07	11.00	17.00	1.08	13.00	21.00	0	1	1	2	1	2	2	2	3	1	1	0	3	2	2	1	1	1	3	1	1	1	0.01	2.00	4.00
2037418	2023-10-30 00:30:00	33	3	1.24	5.90	9.80	1.29	5.90	9.80	4	4	7	6	5	6	10	9	13	4	5	1	14	2	3	1	2	1	3	1	0	0	0.05	0.00	0.00
2037417	2023-10-21 21:30:00	33	0	4.50	4.10	1.71	4.55	4.10	1.71	0	0	0	2	1	1	2	1	1	0	1	1	2	1	2	2	3	1	1	1	0	0	0.05	0.00	0.00
2037415	2023-10-22 00:30:00	33	0	11.00	5.90	1.24	9.30	6.00	1.29	9	8	4	11	5	8	20	13	12	1	8	9	21	1	2	3	3	2	1	-1	1	1	-1.70	0.10	0.05
2037413	2023-10-21 21:30:00	33	0	6.20	4.30	1.46	6.20	4.60	1.49	2	2	1	1	2	3	3	4	4	2	1	1	5	3	1	1	1	2	2	0	1	1	0.00	0.30	0.03
2037412	2023-10-22 23:30:00	33	0	2.29	3.65	2.95	2.29	3.65	2.95	0	0	0	0	1	1	0	1	1	1	0	0	1	3	1	1	1	2	2	0	0	0	0.00	0.00	0.00
2037411	2023-10-21 02:30:00	33	3	1.28	5.40	8.90	1.33	5.90	7.70	13	10	18	13	11	18	26	21	36	11	16	1	37	2	3	1	2	1	3	1	1	-1	0.05	0.50	-1.20
2235550	2024-08-24 02:30:00	33	0	4.75	4.25	1.58	5.30	4.50	1.56	7	4	8	8	8	7	15	12	15	2	5	2	17	1	3	1	2	1	2	1	1	-1	0.55	0.25	-0.02
2235551	2024-08-25 00:30:00	33	3	1.75	4.00	3.85	1.77	4.05	4.20	2	1	3	2	2	3	4	3	6	2	3	0	6	2	3	1	2	1	3	1	1	1	0.02	0.05	0.35
2037409	2023-10-22 21:30:00	33	3	2.31	3.75	2.85	2.31	3.75	2.85	0	0	0	0	1	1	0	1	1	1	0	0	1	3	1	1	1	2	2	0	0	0	0.00	0.00	0.00
2235618	2024-10-26 21:30:00	33	1	2.49	3.35	2.62	2.49	3.50	2.77	0	2	1	0	2	3	0	4	4	4	0	0	4	3	1	1	1	2	2	0	1	1	0.00	0.15	0.15
2235616	2024-10-26 02:30:00	33	1	2.29	3.70	2.68	2.35	3.70	2.84	0	4	7	2	4	5	2	8	12	11	5	1	13	3	2	1	1	2	3	1	0	1	0.06	0.00	0.16
2037468	2023-12-18 02:30:00	33	3	1.44	4.75	5.60	1.39	5.30	7.00	11	6	11	8	9	13	19	15	24	11	15	6	30	2	3	1	2	1	3	-1	1	1	-0.05	0.55	1.40
2235617	2024-10-26 21:30:00	33	3	1.74	3.90	4.00	1.79	3.90	4.25	1	2	4	4	1	2	5	3	6	3	5	2	8	2	3	1	2	1	3	1	0	1	0.05	0.00	0.25
2037467	2023-12-18 00:30:00	33	3	1.31	5.20	8.40	1.33	5.50	8.70	5	3	8	6	6	6	11	9	14	3	5	0	14	2	3	1	2	1	3	1	1	1	0.02	0.30	0.30
2235622	2024-11-02 03:30:00	33	1	1.54	4.45	4.85	1.58	4.65	5.00	0	0	5	2	1	6	2	1	11	9	10	0	11	2	3	1	2	1	3	1	1	1	0.04	0.20	0.15
2037466	2023-12-16 22:30:00	33	1	3.35	3.90	1.91	3.25	4.05	2.01	4	4	5	3	3	6	7	7	11	7	7	3	14	2	2	1	1	1	3	-1	1	1	-0.10	0.15	0.10
2235623	2024-11-04 00:30:00	33	3	2.12	3.85	2.88	2.16	3.80	3.10	4	3	4	3	2	6	7	5	10	6	8	3	13	2	3	1	2	1	3	1	-1	1	0.04	-0.05	0.22
2235620	2024-10-28 00:30:00	33	1	2.51	3.35	2.60	2.66	3.45	2.60	1	0	6	4	1	4	5	1	10	5	9	0	10	2	3	1	2	1	3	1	1	0	0.15	0.10	0.00
2235621	2024-10-27 00:30:00	33	1	5.60	4.65	1.46	5.90	4.75	1.49	3	5	3	5	3	4	8	8	7	1	1	2	9	1	1	3	2	2	1	1	1	1	0.30	0.10	0.03
2037463	2023-12-09 22:30:00	33	3	2.14	3.55	3.00	2.14	3.60	3.30	0	1	0	0	1	3	0	2	3	3	1	0	3	3	2	1	1	2	3	0	1	1	0.00	0.05	0.30
2235626	2024-11-02 22:30:00	33	3	1.31	5.50	7.40	1.32	5.60	8.80	5	5	4	5	5	8	10	10	12	2	2	0	12	2	2	1	1	1	3	1	1	1	0.01	0.10	1.40
2037462	2024-01-25 03:30:00	33	3	1.15	7.60	13.00	1.12	9.20	21.00	8	10	8	5	16	13	13	26	21	17	4	9	30	3	1	2	1	3	2	-1	1	1	-0.03	1.60	8.00
2037461	2023-11-25 22:30:00	33	3	3.50	3.70	1.90	3.85	3.80	1.89	2	0	3	4	1	2	6	1	5	0	5	1	6	1	3	2	3	1	2	1	1	-1	0.35	0.10	-0.01
2235624	2024-11-02 22:30:00	33	3	1.15	7.00	14.00	1.19	7.20	16.00	3	3	3	6	3	3	9	6	6	2	5	5	11	1	2	2	3	1	1	1	1	1	0.04	0.20	2.00
2037460	2023-12-10 22:30:00	33	1	2.88	3.75	2.29	2.87	3.80	2.29	1	0	0	1	2	0	2	2	0	1	1	3	3	1	1	3	2	2	1	-1	1	0	-0.01	0.05	0.00
2235625	2024-11-03 01:30:00	33	3	2.25	3.95	2.62	2.25	3.75	2.96	2	6	8	2	5	14	4	11	22	18	11	0	22	3	2	1	1	2	3	0	-1	1	0.00	-0.20	0.34
2235630	2024-11-02 22:30:00	33	1	2.01	3.75	3.15	1.99	3.75	3.55	7	1	5	5	1	5	12	2	10	2	12	4	14	1	3	2	3	1	2	-1	0	1	-0.02	0.00	0.40
2235631	2024-11-10 22:30:00	33	1	2.09	3.70	3.00	2.12	3.80	3.15	1	0	1	1	2	3	2	2	4	2	2	0	4	2	2	1	1	1	3	1	1	1	0.03	0.10	0.15
2235628	2024-11-02 22:30:00	33	0	1.89	3.85	3.45	1.84	3.90	4.00	3	1	0	0	3	2	3	4	2	3	2	4	6	2	1	3	2	3	1	-1	1	1	-0.05	0.05	0.55
2037456	2023-12-09 22:30:00	33	3	7.60	5.40	1.31	9.40	5.90	1.30	1	1	5	9	5	2	10	6	7	1	5	4	11	1	3	2	3	1	2	1	1	-1	1.80	0.50	-0.01
2037455	2023-12-10 01:30:00	33	0	2.53	3.80	2.38	2.62	3.85	2.44	7	3	4	6	3	5	13	6	9	0	7	4	13	1	3	2	3	1	2	1	1	1	0.09	0.05	0.06
2235634	2024-11-09 22:30:00	33	3	3.10	3.65	2.07	3.35	3.80	2.05	1	0	5	1	2	5	2	2	10	9	9	1	11	2	2	1	1	1	3	1	1	-1	0.25	0.15	-0.02
2235635	2024-11-09 22:30:00	33	0	8.50	6.20	1.25	13.00	6.70	1.21	2	1	4	6	4	0	8	5	4	4	7	8	12	1	2	3	3	2	1	1	1	-1	4.50	0.50	-0.04
2037453	2023-12-02 22:30:00	33	3	1.22	6.20	10.00	1.24	6.50	11.00	1	0	0	1	3	1	2	3	1	1	0	2	3	2	1	3	2	3	1	1	1	1	0.02	0.30	1.00
2235632	2024-11-09 22:30:00	33	1	8.00	6.20	1.26	11.00	6.60	1.25	4	2	3	5	4	2	9	6	5	2	5	6	11	1	2	3	3	2	1	1	1	-1	3.00	0.40	-0.01
2037452	2023-12-03 22:30:00	33	0	2.28	3.45	2.86	2.51	3.50	2.74	1	2	5	3	3	3	4	5	8	5	4	1	9	3	2	1	1	2	3	1	1	-1	0.23	0.05	-0.12
2037451	2023-12-02 03:30:00	33	0	2.65	3.40	2.44	2.60	3.55	2.61	9	2	1	6	2	5	15	4	6	0	11	9	15	1	3	2	3	1	2	-1	1	1	-0.05	0.15	0.17
2235639	2024-11-09 03:30:00	33	1	2.40	3.05	3.00	2.47	3.25	2.97	0	6	7	2	8	6	2	14	13	17	5	6	19	3	1	2	1	3	2	1	1	-1	0.07	0.20	-0.03
2037449	2023-12-02 22:30:00	33	3	2.29	3.85	2.60	2.29	4.10	2.71	0	0	2	0	2	1	0	2	3	3	1	0	3	3	2	1	1	2	3	0	1	1	0.00	0.25	0.11
2235636	2024-11-10 01:30:00	33	1	1.60	4.25	4.55	1.60	4.50	4.95	3	0	3	2	2	5	5	2	8	3	6	0	8	2	3	1	2	1	3	0	1	1	0.00	0.25	0.40
2037448	2023-12-04 00:30:00	33	1	1.65	4.00	4.45	1.66	4.55	4.40	5	3	8	6	4	6	11	7	14	4	8	1	15	2	3	1	2	1	3	1	1	-1	0.01	0.55	-0.05
2235637	2024-11-11 00:30:00	33	0	1.95	3.90	3.20	1.97	3.90	3.50	5	1	3	5	1	4	10	2	7	1	9	4	11	1	3	2	3	1	2	1	0	1	0.02	0.00	0.30
2037447	2023-11-25 22:30:00	33	0	4.95	4.85	1.48	6.40	5.20	1.43	4	2	8	10	6	3	14	8	11	1	7	4	15	1	3	2	3	1	2	1	1	-1	1.45	0.35	-0.05
2235642	2024-11-23 22:30:00	33	3	1.67	4.00	4.30	1.66	4.15	4.85	1	0	1	0	3	2	1	3	3	3	1	1	4	3	1	1	1	2	2	-1	1	1	-0.01	0.15	0.55
2235643	2024-11-24 01:30:00	33	3	1.69	4.20	4.55	1.73	4.15	4.30	0	1	3	3	0	2	3	1	5	2	4	0	5	2	3	1	2	1	3	1	-1	-1	0.04	-0.05	-0.25
2037445	2023-11-27 00:30:00	33	1	1.81	3.85	3.75	1.87	3.85	3.90	4	4	7	7	2	5	11	6	12	1	6	0	12	2	3	1	2	1	3	1	0	1	0.06	0.00	0.15
2235640	2024-11-23 22:30:00	33	3	1.18	6.80	12.00	1.19	7.10	14.00	2	2	0	2	4	1	4	6	1	3	1	6	7	2	1	3	2	3	1	1	1	1	0.01	0.30	2.00
2037444	2023-11-26 22:30:00	33	1	2.14	3.65	2.94	2.14	3.70	3.20	0	0	2	0	1	1	0	1	3	3	2	0	3	3	2	1	1	2	3	0	1	1	0.00	0.05	0.26
2235641	2024-11-23 03:30:00	33	3	1.11	9.00	14.00	1.11	9.40	22.00	2	9	6	2	10	8	4	19	14	20	5	10	24	3	1	2	1	3	2	0	1	1	0.00	0.40	8.00
2235646	2024-11-24 22:30:00	33	0	2.79	3.45	2.31	3.10	3.50	2.26	1	1	1	3	2	0	4	3	1	0	1	3	4	1	2	3	3	2	1	1	1	-1	0.31	0.05	-0.05
2235644	2024-11-25 00:30:00	33	3	1.81	3.70	3.90	1.80	3.80	4.35	5	1	2	2	3	5	7	4	7	3	6	3	10	1	3	1	2	1	2	-1	1	1	-0.01	0.10	0.45
2037440	2023-11-25 22:30:00	33	3	1.47	4.75	5.20	1.49	5.00	5.70	1	2	3	2	3	5	3	5	8	6	4	1	9	3	2	1	1	2	3	1	1	1	0.02	0.25	0.50
2235645	2024-11-23 22:30:00	33	3	3.15	3.55	2.08	3.10	3.75	2.16	4	1	4	3	1	4	7	2	8	2	7	1	9	2	3	1	2	1	3	-1	1	1	-0.05	0.20	0.08
2037503	2024-01-20 22:30:00	33	0	4.00	3.95	1.74	4.40	4.05	1.74	0	1	1	2	3	0	2	4	1	2	0	3	4	2	1	3	2	3	1	1	1	0	0.40	0.10	0.00
2235586	2024-09-28 21:30:00	33	3	2.20	3.40	3.00	2.13	3.50	3.40	2	1	1	1	2	3	3	3	4	3	3	2	6	2	2	1	1	1	3	-1	1	1	-0.07	0.10	0.40
2037502	2024-01-20 22:30:00	33	1	3.55	3.40	1.99	3.75	3.55	1.99	2	1	2	4	1	3	6	2	5	1	5	2	7	1	3	2	3	1	2	1	1	0	0.20	0.15	0.00
2235587	2024-09-29 00:30:00	33	1	1.72	4.25	3.80	1.73	4.20	4.30	7	4	4	4	4	9	11	8	13	5	8	3	16	2	3	1	2	1	3	1	-1	1	0.01	-0.05	0.50
2037501	2024-01-20 22:30:00	33	3	3.30	3.65	2.00	3.55	3.80	1.98	2	1	4	4	1	3	6	2	7	2	6	1	8	2	3	1	2	1	3	1	1	-1	0.25	0.15	-0.02
2235584	2024-09-21 21:30:00	33	3	2.07	3.55	3.20	2.01	3.70	3.55	7	2	1	1	4	5	8	6	6	3	5	5	11	1	2	2	3	1	1	-1	1	1	-0.06	0.15	0.35
2037500	2024-01-22 00:30:00	33	0	1.96	3.75	3.30	1.96	3.80	3.60	4	3	4	5	3	5	9	6	9	3	6	3	12	1	3	1	2	1	2	0	1	1	0.00	0.05	0.30
2235585	2024-09-21 21:30:00	33	0	7.30	5.20	1.34	7.70	5.60	1.34	7	1	5	11	2	5	18	3	10	3	18	11	21	1	3	2	3	1	2	1	1	0	0.40	0.40	0.00
2037499	2024-01-13 22:30:00	33	0	1.46	4.50	5.90	1.44	4.80	6.80	3	1	1	2	4	5	5	5	6	2	2	1	7	2	2	1	1	1	3	-1	1	1	-0.02	0.30	0.90
2235590	2024-09-29 23:30:00	33	0	2.33	3.60	2.68	2.31	3.75	2.87	5	0	3	2	2	6	7	2	9	3	8	1	10	2	3	1	2	1	3	-1	1	1	-0.02	0.15	0.19
2037498	2024-01-21 22:30:00	33	0	1.09	12.00	20.00	1.09	12.00	20.00	2	1	1	1	2	2	3	3	3	0	0	0	3	1	1	1	1	1	1	0	0	0	0.00	0.00	0.00
2235591	2024-09-29 21:30:00	33	0	4.45	4.30	1.69	4.45	4.30	1.69	0	0	0	1	1	0	1	1	0	0	0	1	1	1	1	3	2	2	1	0	0	0	0.00	0.00	0.00
2037497	2024-01-13 22:30:00	33	1	2.20	3.40	3.05	2.20	3.50	3.25	0	0	0	0	2	1	0	2	1	2	0	1	2	3	1	2	1	3	2	0	1	1	0.00	0.10	0.20
2235588	2024-09-28 02:30:00	33	3	1.22	6.40	9.60	1.26	6.50	10.00	6	9	7	7	8	6	13	17	13	8	4	8	21	2	1	2	1	3	1	1	1	1	0.04	0.10	0.40
2037496	2024-01-13 22:30:00	33	1	2.13	3.40	3.20	2.13	3.45	3.45	0	0	0	0	2	1	0	2	1	2	0	1	2	3	1	2	1	3	2	0	1	1	0.00	0.05	0.25
2037495	2024-01-13 22:30:00	33	1	2.11	3.55	3.10	2.07	3.65	3.40	2	0	1	2	2	3	4	2	4	2	4	2	6	1	3	1	2	1	2	-1	1	1	-0.04	0.10	0.30
2235594	2024-09-28 21:30:00	33	1	2.81	3.75	2.19	3.15	3.80	2.13	7	6	4	13	6	3	20	12	7	1	9	14	21	1	2	3	3	2	1	1	1	-1	0.34	0.05	-0.06
2037494	2024-01-14 01:30:00	33	0	5.00	4.35	1.55	5.70	4.50	1.54	3	1	2	6	3	1	9	4	3	0	5	6	9	1	2	3	3	2	1	1	1	-1	0.70	0.15	-0.01
2037493	2024-01-14 22:30:00	33	1	2.21	3.55	2.88	2.21	3.60	3.10	0	1	1	1	1	1	1	2	2	1	0	0	2	3	1	1	1	2	2	0	1	1	0.00	0.05	0.22
2037492	2024-01-13 03:30:00	33	3	1.16	8.20	11.00	1.15	8.70	15.00	4	13	8	5	10	9	9	23	17	23	9	15	32	3	1	2	1	3	2	-1	1	1	-0.01	0.50	4.00
2235593	2024-09-28 21:30:00	33	3	1.41	4.70	6.20	1.40	5.00	7.40	2	0	1	1	3	2	3	3	3	1	1	1	4	1	1	1	1	1	1	-1	1	1	-0.01	0.30	1.20
2037491	2024-01-15 00:30:00	33	3	3.45	3.80	1.90	3.80	4.00	1.86	8	2	6	8	6	8	16	8	14	3	11	5	19	1	3	2	3	1	2	1	1	-1	0.35	0.20	-0.04
2235598	2024-10-06 23:30:00	33	1	5.20	4.60	1.49	5.80	4.75	1.50	0	1	1	2	2	1	2	3	2	2	1	2	4	2	1	2	1	3	1	1	1	1	0.60	0.15	0.01
2037490	2023-12-21 03:30:00	33	0	7.90	5.20	1.32	7.50	5.40	1.36	14	3	7	15	4	7	29	7	14	2	24	17	31	1	3	2	3	1	2	-1	1	1	-0.40	0.20	0.04
2235599	2024-10-06 21:30:00	33	0	4.80	4.10	1.67	4.80	4.10	1.67	0	0	0	1	1	0	1	1	0	0	0	1	1	1	1	3	2	2	1	0	0	0	0.00	0.00	0.00
2037489	2024-01-13 22:30:00	33	0	5.30	4.30	1.52	6.50	4.60	1.47	2	0	2	3	4	0	5	4	2	0	1	3	5	1	2	3	3	2	1	1	1	-1	1.20	0.30	-0.05
2235596	2024-10-05 21:30:00	33	1	1.07	11.00	17.00	1.09	12.00	20.00	0	0	1	1	1	2	1	1	3	2	2	0	3	2	2	1	1	1	3	1	1	1	0.02	1.00	3.00
2037488	2023-12-21 01:30:00	33	3	1.89	3.50	3.75	1.87	3.60	4.25	6	1	3	3	2	8	9	3	11	2	8	0	11	2	3	1	2	1	3	-1	1	1	-0.02	0.10	0.50
2037487	2023-12-20 01:30:00	33	1	5.20	4.45	1.58	5.50	4.50	1.55	1	1	3	4	3	1	5	4	4	0	1	1	5	1	2	2	3	1	1	1	1	-1	0.30	0.05	-0.03
2235602	2024-10-05 21:30:00	33	0	2.47	3.60	2.53	2.64	3.70	2.49	1	0	4	5	1	1	6	1	5	0	5	1	6	1	3	2	3	1	2	1	1	-1	0.17	0.10	-0.04
2037486	2023-12-21 03:30:00	33	3	1.34	5.00	7.50	1.37	5.10	7.90	5	4	8	6	5	7	11	9	15	6	8	2	17	2	3	1	2	1	3	1	1	1	0.03	0.10	0.40
2235603	2024-10-05 21:30:00	33	3	3.20	3.40	2.13	3.30	3.55	2.14	3	2	4	5	4	2	8	6	6	0	2	2	8	1	2	2	3	1	1	1	1	1	0.10	0.15	0.01
2037485	2023-12-21 03:30:00	33	3	2.85	3.55	2.40	2.75	3.45	2.51	8	5	4	10	4	6	18	9	10	1	10	9	19	1	3	2	3	1	2	-1	-1	1	-0.10	-0.10	0.11
2235601	2024-10-07 01:30:00	33	1	1.29	6.10	7.10	1.29	6.20	8.60	2	1	1	1	3	5	3	4	6	3	2	0	6	3	2	1	1	2	3	0	1	1	0.00	0.10	1.50
2037483	2023-12-21 03:30:00	33	3	1.82	3.75	3.80	1.89	3.75	3.90	3	6	10	8	4	8	11	10	18	10	11	3	21	2	3	1	2	1	3	1	0	1	0.07	0.00	0.10
2235606	2024-10-19 02:30:00	33	3	1.27	5.90	7.70	1.30	5.70	9.40	6	9	13	8	6	17	14	15	30	18	17	2	32	3	2	1	1	2	3	1	-1	1	0.03	-0.20	1.70
2037482	2023-12-17 01:30:00	33	3	1.40	4.95	6.20	1.38	5.30	7.40	8	3	8	5	8	10	13	11	18	6	8	1	19	2	3	1	2	1	3	-1	1	1	-0.02	0.35	1.20
2235604	2024-10-19 21:30:00	33	3	1.43	4.80	5.90	1.44	4.80	5.70	0	1	2	2	1	0	2	2	2	2	2	2	4	1	1	1	1	1	1	1	0	-1	0.01	0.00	-0.20
2037480	2023-11-04 22:30:00	33	0	4.70	4.60	1.54	5.30	4.85	1.52	4	2	2	6	4	0	10	6	2	0	4	8	10	1	2	3	3	2	1	1	1	-1	0.60	0.25	-0.02
2235610	2024-10-20 21:30:00	33	0	3.15	3.35	2.16	3.40	3.40	2.16	0	0	1	1	1	0	1	1	1	1	1	1	2	1	1	1	1	1	1	1	1	0	0.25	0.05	0.00
2037478	2023-11-04 22:30:00	33	3	5.10	4.15	1.55	5.30	4.30	1.59	2	2	1	3	3	1	5	5	2	1	1	4	6	1	1	3	2	2	1	1	1	1	0.20	0.15	0.04
2235608	2024-10-19 21:30:00	33	3	1.68	4.25	4.00	1.68	4.30	3.95	0	1	2	0	2	0	0	3	2	4	1	2	4	3	1	2	1	3	2	0	1	-1	0.00	0.05	-0.05
2037476	2023-12-20 03:30:00	33	1	1.52	4.50	5.00	1.53	4.55	5.50	9	7	10	10	8	9	19	15	19	9	13	9	28	1	3	1	2	1	2	1	1	1	0.01	0.05	0.50
2235609	2024-10-20 00:30:00	33	3	1.33	5.40	7.20	1.35	5.60	7.80	1	0	2	1	3	3	2	3	5	3	2	0	5	3	2	1	1	2	3	1	1	1	0.02	0.20	0.60
2037475	2023-12-21 03:30:00	33	3	1.18	7.60	14.00	1.19	7.40	13.00	2	4	2	4	3	2	6	7	4	2	1	4	8	2	1	3	2	3	1	1	-1	-1	0.01	-0.20	-1.00
2235614	2024-10-27 22:30:00	33	0	13.00	8.50	1.13	15.00	8.80	1.15	3	4	1	3	5	2	6	9	3	6	3	9	12	2	1	3	2	3	1	1	1	1	2.00	0.30	0.02
2037473	2023-12-17 22:30:00	33	3	1.88	3.50	3.85	1.86	3.65	4.20	3	0	3	3	1	4	6	1	7	1	6	0	7	2	3	1	2	1	3	-1	1	1	-0.02	0.15	0.35
2235612	2024-10-20 23:30:00	33	0	2.09	3.70	3.05	2.05	3.65	3.45	4	1	2	4	1	3	8	2	5	1	7	4	9	1	3	2	3	1	2	-1	-1	1	-0.04	-0.05	0.40
2037472	2023-12-16 22:30:00	33	0	2.96	3.40	2.23	3.15	3.55	2.23	1	1	0	3	2	0	4	3	0	1	2	5	5	1	2	3	3	2	1	1	1	0	0.19	0.15	0.00
2235613	2024-10-26 21:30:00	33	3	3.30	3.85	1.92	3.80	4.00	1.86	2	0	3	4	2	0	6	2	3	0	4	3	6	1	3	2	3	1	2	1	1	-1	0.50	0.15	-0.06
2037534	2024-02-19 00:30:00	33	3	7.00	5.20	1.33	8.70	5.70	1.32	6	4	5	12	7	3	18	11	8	2	9	12	20	1	2	3	3	2	1	1	1	-1	1.70	0.50	-0.01
2037525	2024-02-04 22:30:00	33	1	2.12	3.60	3.05	2.12	3.70	3.25	0	1	1	0	2	3	0	3	4	4	1	0	4	3	2	1	1	2	3	0	1	1	0.00	0.10	0.20
2037524	2024-02-05 00:30:00	33	3	1.36	4.70	7.60	1.39	4.90	7.80	4	4	7	6	4	7	10	8	14	5	7	1	15	2	3	1	2	1	3	1	1	1	0.03	0.20	0.20
2037523	2024-02-03 22:30:00	33	0	2.09	3.30	3.35	2.11	3.45	3.50	0	2	2	1	2	3	1	4	5	4	1	0	5	3	2	1	1	2	3	1	1	1	0.02	0.15	0.15
2037522	2024-02-03 03:30:00	33	1	4.20	4.15	1.75	4.00	4.15	1.79	5	2	1	3	3	4	8	5	5	1	4	4	9	1	2	2	3	1	1	-1	0	1	-0.20	0.00	0.04
2037521	2024-02-03 22:30:00	33	0	2.84	3.55	2.25	3.15	3.65	2.20	1	0	1	2	2	0	3	2	1	0	1	2	3	1	2	3	3	2	1	1	1	-1	0.31	0.10	-0.05
2037520	2024-02-04 01:30:00	33	3	2.99	3.30	2.25	3.35	3.25	2.25	2	1	1	4	0	1	6	1	2	0	5	4	6	1	3	2	3	1	2	1	-1	0	0.36	-0.05	0.00
2037519	2024-02-03 22:30:00	33	0	9.80	5.60	1.25	10.00	6.00	1.27	1	2	1	2	4	1	3	6	2	4	1	5	7	2	1	3	2	3	1	1	1	1	0.20	0.40	0.02
2037518	2024-02-03 22:30:00	33	1	2.14	3.55	3.35	2.14	3.55	3.35	0	1	0	0	1	1	0	2	1	3	1	2	3	3	1	2	1	3	2	0	0	0	0.00	0.00	0.00
2037517	2024-02-03 22:30:00	33	3	1.16	7.60	12.00	1.17	8.10	13.00	1	3	1	3	3	1	4	6	2	2	0	4	6	2	1	3	2	3	1	1	1	1	0.01	0.50	1.00
2037516	2024-01-27 22:30:00	33	1	1.81	3.50	4.15	1.81	3.75	4.35	0	0	0	0	1	2	0	1	2	2	1	0	2	3	2	1	1	2	3	0	1	1	0.00	0.25	0.20
2037515	2024-01-28 22:30:00	33	3	1.60	3.95	5.80	1.60	3.95	5.80	0	0	0	0	1	1	0	1	1	1	0	0	1	3	1	1	1	2	2	0	0	0	0.00	0.00	0.00
2037514	2024-01-27 22:30:00	33	3	2.42	3.30	2.74	2.42	3.55	2.81	0	2	1	0	2	3	0	4	4	4	0	0	4	3	1	1	1	2	2	0	1	1	0.00	0.25	0.07
2037513	2024-01-27 22:30:00	33	3	2.78	3.45	2.33	2.68	3.70	2.47	5	1	2	4	2	4	9	3	6	0	6	3	9	1	3	2	3	1	2	-1	1	1	-0.10	0.25	0.14
2037512	2024-01-27 22:30:00	33	1	1.70	3.95	4.20	1.70	4.20	4.50	0	1	2	0	4	2	0	5	4	5	0	1	5	3	1	2	1	3	2	0	1	1	0.00	0.25	0.30
2037510	2024-01-29 00:30:00	33	3	1.35	5.00	7.40	1.36	5.40	7.80	2	1	6	3	4	7	5	5	13	9	9	1	14	2	2	1	1	1	3	1	1	1	0.01	0.40	0.40
2037509	2024-01-28 01:30:00	33	1	1.30	5.30	8.20	1.24	6.40	11.00	14	9	11	8	15	17	22	24	28	18	16	12	40	3	2	1	1	2	3	-1	1	1	-0.06	1.10	2.80
2037508	2024-01-27 22:30:00	33	0	8.30	4.90	1.33	7.90	5.50	1.34	8	3	3	5	2	5	13	5	8	2	10	7	15	1	3	2	3	1	2	-1	1	1	-0.40	0.60	0.01
2037507	2024-01-21 01:30:00	33	0	2.47	3.65	2.50	2.40	3.65	2.77	4	0	7	4	0	9	8	0	16	8	16	0	16	2	3	1	2	1	3	-1	0	1	-0.07	0.00	0.27
2037506	2024-01-20 22:30:00	33	1	2.56	3.50	2.49	2.74	3.55	2.49	1	1	1	5	1	1	6	2	2	1	5	5	7	1	2	2	3	1	1	1	1	0	0.18	0.05	0.00
2037505	2024-02-08 01:30:00	33	1	2.14	3.15	3.40	2.17	3.25	3.60	1	8	5	1	7	8	2	15	13	18	5	7	20	3	1	2	1	3	2	1	1	1	0.03	0.10	0.20
2037504	2024-01-20 22:30:00	33	3	2.08	3.70	3.05	2.08	3.70	3.35	2	0	2	4	0	2	6	0	4	0	6	2	6	1	3	2	3	1	2	0	0	1	0.00	0.00	0.30
2037567	2024-02-24 22:30:00	33	1	1.30	5.20	8.90	1.29	5.80	9.90	4	0	4	3	3	9	7	3	13	6	10	0	13	2	3	1	2	1	3	-1	1	1	-0.01	0.60	1.00
2037566	2024-02-25 22:30:00	33	1	2.21	3.45	3.25	2.21	3.45	3.25	0	0	0	0	1	1	0	1	1	1	0	0	1	3	1	1	1	2	2	0	0	0	0.00	0.00	0.00
2037565	2024-02-26 00:30:00	33	0	1.50	4.60	5.20	1.49	4.95	5.80	2	2	0	1	3	3	3	5	3	3	1	3	6	2	1	2	1	3	1	-1	1	1	-0.01	0.35	0.60
2037564	2024-02-24 22:30:00	33	3	2.04	3.55	3.25	2.02	3.75	3.50	2	0	0	1	2	2	3	2	2	2	3	3	5	1	2	2	3	1	1	-1	1	1	-0.02	0.20	0.25
2037563	2024-02-25 01:30:00	33	3	1.72	4.20	4.30	1.70	4.30	4.35	2	1	2	2	4	3	4	5	5	2	1	1	6	3	1	1	1	2	2	-1	1	1	-0.02	0.10	0.05
2037562	2024-02-24 03:30:00	33	3	1.22	5.80	11.00	1.24	5.80	13.00	12	8	6	11	9	8	23	17	14	11	17	20	34	1	2	3	3	2	1	1	0	1	0.02	0.00	2.00
2037561	2024-02-26 02:30:00	33	3	2.28	3.50	2.81	2.26	3.60	3.05	1	0	2	1	1	2	2	1	4	2	3	0	4	2	3	1	2	1	3	-1	1	1	-0.02	0.10	0.24
2038065	2024-05-05 23:30:00	33	0	2.89	3.45	2.25	3.15	3.70	2.16	1	0	4	5	2	0	6	2	4	1	5	3	7	1	3	2	3	1	2	1	1	-1	0.26	0.25	-0.09
2038064	2024-04-27 21:30:00	33	0	2.25	3.45	2.88	2.29	3.50	3.05	0	2	2	1	2	2	1	4	4	3	0	0	4	3	1	1	1	2	2	1	1	1	0.04	0.05	0.17
2235666	2024-11-23 22:30:00	33	3	1.27	5.60	8.40	1.32	5.90	8.20	2	2	6	4	4	5	6	6	11	6	6	1	12	2	2	1	1	1	3	1	1	-1	0.05	0.30	-0.20
2038062	2024-04-20 02:30:00	33	3	2.06	3.65	3.15	2.08	3.80	3.25	3	0	4	3	2	3	6	2	7	3	7	2	9	2	3	1	2	1	3	1	1	1	0.02	0.15	0.10
2037537	2024-02-18 22:30:00	33	1	2.29	3.40	3.15	2.29	3.35	3.15	0	1	0	0	1	1	0	2	1	2	0	1	2	3	1	2	1	3	2	0	-1	0	0.00	-0.05	0.00
2037599	2024-03-31 01:30:00	33	0	1.41	5.20	5.80	1.41	5.40	6.40	2	2	4	3	1	4	5	3	8	3	5	0	8	2	3	1	2	1	3	0	1	1	0.00	0.20	0.60
2037598	2024-03-30 22:30:00	33	3	1.22	6.70	9.50	1.20	6.90	14.00	2	1	3	1	2	2	3	3	5	2	2	0	5	2	2	1	1	1	3	-1	1	1	-0.02	0.20	4.50
2037597	2024-03-31 21:30:00	33	1	1.80	3.85	4.30	1.80	3.85	4.30	0	0	0	0	1	1	0	1	1	1	0	0	1	3	1	1	1	2	2	0	0	0	0.00	0.00	0.00
2037596	2024-03-16 22:30:00	33	0	2.07	3.55	3.15	2.08	3.65	3.40	2	0	0	2	1	2	4	1	2	1	4	3	5	1	3	2	3	1	2	1	1	1	0.01	0.10	0.25
2037595	2024-03-16 22:30:00	33	3	2.03	3.45	3.35	2.04	3.55	3.60	1	0	0	3	1	1	4	1	1	1	4	4	5	1	2	2	3	1	1	1	1	1	0.01	0.10	0.25
2037594	2024-03-16 22:30:00	33	3	1.83	3.65	3.85	1.83	3.75	4.20	0	1	0	1	1	1	1	2	1	1	0	1	2	2	1	2	1	3	1	0	1	1	0.00	0.10	0.35
2037593	2024-03-11 02:30:00	33	3	1.34	5.20	9.00	1.34	5.10	9.10	3	2	7	4	1	9	7	3	16	9	13	0	16	2	3	1	2	1	3	0	-1	1	0.00	-0.10	0.10
2037592	2024-03-17 01:30:00	33	0	3.45	3.95	1.86	3.90	4.15	1.81	3	1	6	7	4	2	10	5	8	0	5	2	10	1	3	2	3	1	2	1	1	-1	0.45	0.20	-0.05
2037591	2024-03-16 22:30:00	33	1	2.42	3.50	2.62	2.42	3.70	2.74	0	0	3	0	1	3	0	1	6	6	5	0	6	3	2	1	1	2	3	0	1	1	0.00	0.20	0.12
2037590	2024-03-17 22:30:00	33	0	5.20	4.00	1.57	5.90	4.25	1.55	2	0	3	4	4	0	6	4	3	0	2	3	6	1	2	3	3	2	1	1	1	-1	0.70	0.25	-0.02
2037589	2024-03-16 03:30:00	33	0	5.70	4.35	1.49	6.40	4.35	1.50	3	2	3	5	3	4	8	5	7	3	6	4	11	1	3	2	3	1	2	1	0	1	0.70	0.00	0.01
2037588	2024-03-18 00:30:00	33	3	1.61	4.20	4.55	1.60	4.35	5.10	2	1	1	1	2	3	3	3	4	1	1	0	4	2	2	1	1	1	3	-1	1	1	-0.01	0.15	0.55
2037587	2024-03-16 22:30:00	33	0	13.00	8.20	1.14	18.00	9.20	1.13	0	2	1	2	6	0	2	8	1	6	0	7	8	2	1	3	2	3	1	1	1	-1	5.00	1.00	-0.01
2037586	2024-03-10 01:30:00	33	0	3.50	3.85	1.87	3.75	4.05	1.87	3	1	4	5	2	3	8	3	7	2	7	3	10	1	3	2	3	1	2	1	1	0	0.25	0.20	0.00
2037585	2024-03-09 03:30:00	33	3	1.49	4.25	5.80	1.50	4.35	6.50	1	3	4	2	4	6	3	7	10	9	5	2	12	3	2	1	1	2	3	1	1	1	0.01	0.10	0.70
2037584	2024-03-09 22:30:00	33	3	1.12	8.00	15.00	1.15	8.20	17.00	1	1	1	2	2	2	3	3	3	3	3	3	6	1	1	1	1	1	1	1	1	1	0.03	0.20	2.00
2037583	2024-03-11 00:30:00	33	3	2.08	3.75	3.30	2.06	3.75	3.35	2	0	2	2	1	3	4	1	5	1	4	0	5	2	3	1	2	1	3	-1	0	1	-0.02	0.00	0.05
2037581	2024-03-09 22:30:00	33	1	1.86	3.60	3.80	1.86	3.80	4.05	0	0	0	0	2	2	0	2	2	3	1	1	3	3	1	1	1	2	2	0	1	1	0.00	0.20	0.25
2037580	2024-03-09 22:30:00	33	3	1.20	6.20	12.00	1.23	6.50	12.00	1	2	1	1	4	2	2	6	3	5	1	4	7	3	1	2	1	3	2	1	1	0	0.03	0.30	0.00
2037579	2024-03-09 22:30:00	33	3	1.86	3.75	3.60	1.86	3.90	3.90	2	1	1	1	3	3	3	4	4	2	1	1	5	3	1	1	1	2	2	0	1	1	0.00	0.15	0.30
2037578	2024-03-03 01:30:00	33	0	3.20	3.65	2.14	3.20	3.65	2.17	1	0	0	2	1	1	3	1	1	0	2	2	3	1	2	2	3	1	1	0	0	1	0.00	0.00	0.03
2037577	2024-03-02 22:30:00	33	0	3.20	3.40	2.11	3.30	3.65	2.11	0	1	1	2	2	0	2	3	1	1	0	2	3	2	1	3	2	3	1	1	1	0	0.10	0.25	0.00
2037576	2024-03-02 22:30:00	33	1	2.00	3.45	3.45	2.00	3.70	3.60	2	0	3	3	1	3	5	1	6	1	5	0	6	2	3	1	2	1	3	0	1	1	0.00	0.25	0.15
2037575	2024-03-04 00:30:00	33	3	1.95	3.70	3.40	1.98	3.85	3.50	0	0	2	3	1	1	3	1	3	1	3	1	4	1	3	1	2	1	2	1	1	1	0.03	0.15	0.10
2037574	2024-03-02 22:30:00	33	0	2.67	3.25	2.51	2.75	3.45	2.53	1	0	1	3	1	1	4	1	2	0	3	2	4	1	3	2	3	1	2	1	1	1	0.08	0.20	0.02
2037573	2024-03-02 03:30:00	33	1	5.60	4.55	1.46	6.20	4.50	1.50	10	8	7	13	9	9	23	17	16	6	12	13	29	1	2	3	3	2	1	1	-1	1	0.60	-0.05	0.04
2037572	2024-03-03 22:30:00	33	0	8.30	4.70	1.34	8.90	4.95	1.36	4	1	2	6	3	2	10	4	4	0	6	6	10	1	2	2	3	1	1	1	1	1	0.60	0.25	0.02
2037570	2024-03-02 22:30:00	33	0	4.90	4.20	1.64	4.90	4.20	1.64	0	0	0	1	1	0	1	1	0	0	0	1	1	1	1	3	2	2	1	0	0	0	0.00	0.00	0.00
2037569	2024-02-24 22:30:00	33	1	1.64	4.00	5.20	1.64	4.00	5.20	0	0	0	0	1	1	0	1	1	1	0	0	1	3	1	1	1	2	2	0	0	0	0.00	0.00	0.00
2235772	2024-11-30 22:30:00	33	3	1.72	3.75	4.30	1.72	4.00	4.55	1	4	3	1	5	4	2	9	7	10	3	5	12	3	1	2	1	3	2	0	1	1	0.00	0.25	0.25
2037568	2024-02-24 22:30:00	33	1	2.00	3.35	3.55	2.01	3.35	3.95	4	2	4	4	2	6	8	4	10	5	9	3	13	2	3	1	2	1	3	1	0	1	0.01	0.00	0.40
2037626	2024-05-18 21:30:00	33	0	3.00	3.55	2.16	3.35	3.55	2.12	2	2	3	6	2	4	8	4	7	3	7	4	11	1	3	2	3	1	2	1	0	-1	0.35	0.00	-0.04
2037625	2024-05-18 21:30:00	33	3	2.14	3.40	3.10	2.20	3.50	3.25	0	0	6	2	2	4	2	2	10	10	10	2	12	2	2	1	1	1	3	1	1	1	0.06	0.10	0.15
2037624	2024-05-18 21:30:00	33	3	2.32	3.60	2.70	2.36	3.70	2.81	1	0	2	1	1	4	2	1	6	4	5	0	6	2	3	1	2	1	3	1	1	1	0.04	0.10	0.11
2037623	2024-05-18 21:30:00	33	3	1.26	6.20	8.00	1.25	7.00	9.30	8	4	8	6	8	13	14	12	21	8	10	1	22	2	3	1	2	1	3	-1	1	1	-0.01	0.80	1.30
2235722	2024-11-23 22:30:00	33	3	2.23	3.15	3.20	2.33	3.25	3.20	0	1	2	2	1	2	2	2	4	2	2	0	4	2	2	1	1	1	3	1	1	0	0.10	0.10	0.00
2037622	2024-05-18 21:30:00	33	3	2.71	4.15	2.13	3.00	4.30	2.06	5	3	8	10	4	5	15	7	13	1	9	3	16	1	3	2	3	1	2	1	1	-1	0.29	0.15	-0.07
2037621	2024-05-18 21:30:00	33	1	2.66	3.70	2.31	2.55	3.80	2.53	9	1	7	8	2	10	17	3	17	2	16	2	19	1	3	1	2	1	2	-1	1	1	-0.11	0.10	0.22
2037620	2024-05-18 21:30:00	33	3	2.27	3.75	2.67	2.40	3.80	2.70	2	0	2	1	1	2	3	1	4	2	4	1	5	2	3	1	2	1	3	1	1	1	0.13	0.05	0.03
2037619	2024-05-18 21:30:00	33	3	1.16	8.20	11.00	1.15	8.90	15.00	7	8	5	5	10	7	12	18	12	8	2	8	20	2	1	2	1	3	1	-1	1	1	-0.01	0.70	4.00
2037618	2024-05-11 21:30:00	33	1	1.28	5.80	8.00	1.31	6.00	8.40	0	1	2	2	1	3	2	2	5	3	3	0	5	2	2	1	1	1	3	1	1	1	0.03	0.20	0.40
2037617	2024-05-18 21:30:00	33	3	1.26	6.20	8.10	1.27	6.60	9.00	6	4	5	6	5	8	12	9	13	2	5	1	14	2	3	1	2	1	3	1	1	1	0.01	0.40	0.90
2037616	2024-05-12 00:30:00	33	3	2.23	3.70	2.76	2.26	3.90	2.85	0	1	5	1	3	3	1	4	8	7	4	0	8	3	2	1	1	2	3	1	1	1	0.03	0.20	0.09
2037615	2024-05-11 21:30:00	33	1	1.74	3.80	4.10	1.74	3.95	4.50	0	0	2	0	2	2	0	2	4	4	2	0	4	3	2	1	1	2	3	0	1	1	0.00	0.15	0.40
2037614	2024-05-11 21:30:00	33	3	2.68	3.25	2.50	2.83	3.35	2.51	3	1	1	3	1	3	6	2	4	0	4	2	6	1	3	2	3	1	2	1	1	1	0.15	0.10	0.01
2037611	2024-04-07 21:30:00	33	3	2.21	3.80	2.74	2.21	4.00	2.88	0	1	1	0	1	3	0	2	4	4	2	0	4	3	2	1	1	2	3	0	1	1	0.00	0.20	0.14
2037610	2024-04-06 21:30:00	33	3	6.50	5.00	1.37	6.90	5.30	1.40	3	3	3	2	4	4	5	7	7	3	1	1	8	3	1	1	1	2	2	1	1	1	0.40	0.30	0.03
2037609	2024-04-06 21:30:00	33	0	4.15	4.05	1.69	4.60	4.15	1.69	1	0	1	2	2	0	3	2	1	0	1	2	3	1	2	3	3	2	1	1	1	0	0.45	0.10	0.00
2037608	2024-04-06 21:30:00	33	3	2.21	3.55	3.15	2.21	3.55	3.15	0	0	0	0	1	1	0	1	1	1	0	0	1	3	1	1	1	2	2	0	0	0	0.00	0.00	0.00
2037607	2024-04-06 02:30:00	33	1	1.79	3.80	3.90	1.79	3.90	4.25	5	4	6	3	5	7	8	9	13	7	6	2	15	3	2	1	1	2	3	0	1	1	0.00	0.10	0.35
2037606	2024-04-07 00:30:00	33	0	2.23	3.90	2.67	2.16	4.00	2.97	2	0	3	1	3	3	3	3	6	3	3	0	6	2	2	1	1	1	3	-1	1	1	-0.07	0.10	0.30
2037605	2024-03-30 22:30:00	33	0	2.75	3.35	2.38	2.89	3.55	2.38	0	1	0	1	2	0	1	3	0	2	0	3	3	2	1	3	2	3	1	1	1	0	0.14	0.20	0.00
2037604	2024-03-31 23:30:00	33	1	1.26	5.80	9.10	1.28	6.00	9.70	1	1	3	2	2	3	3	3	6	3	3	0	6	2	2	1	1	1	3	1	1	1	0.02	0.20	0.60
2037603	2024-03-30 22:30:00	33	1	1.37	4.85	6.80	1.38	5.00	7.80	1	0	2	1	2	3	2	2	5	3	3	0	5	2	2	1	1	1	3	1	1	1	0.01	0.15	1.00
2037602	2024-03-30 22:30:00	33	1	2.01	3.30	3.55	1.99	3.45	3.90	4	2	1	1	5	4	5	7	5	3	1	3	8	2	1	2	1	3	1	-1	1	1	-0.02	0.15	0.35
2037600	2024-03-30 22:30:00	33	0	2.25	3.55	2.84	2.25	3.65	3.00	0	0	1	0	2	1	0	2	2	2	0	0	2	3	1	1	1	2	2	0	1	1	0.00	0.10	0.16
2235836	2024-12-01 01:30:00	33	1	4.00	4.20	1.69	4.80	4.25	1.65	3	9	2	9	9	1	12	18	3	11	5	20	23	2	1	3	2	3	1	1	1	-1	0.80	0.05	-0.04
2214789	2024-05-28 02:30:00	33	0	2.23	3.50	2.88	2.21	3.60	3.10	1	0	3	1	1	2	2	1	5	3	4	0	5	2	3	1	2	1	3	-1	1	1	-0.02	0.10	0.22
2214788	2024-05-24 02:30:00	33	0	2.13	3.50	3.10	2.25	3.55	3.05	2	4	6	4	4	5	6	8	11	8	6	3	14	3	2	1	1	2	3	1	1	-1	0.12	0.05	-0.05
2235874	2024-12-16 02:30:00	33	3	2.17	3.65	2.90	2.25	3.40	3.20	4	11	7	6	5	11	10	16	18	12	6	4	22	3	2	1	1	2	3	1	-1	1	0.08	-0.25	0.30
2235875	2024-12-15 01:30:00	33	0	2.63	3.25	2.54	2.69	3.40	2.61	5	1	2	3	2	4	8	3	6	3	8	5	11	1	3	2	3	1	2	1	1	1	0.06	0.15	0.07
2235872	2024-12-15 22:30:00	33	0	3.90	3.70	1.80	4.05	3.85	1.84	3	1	0	1	1	4	4	2	4	2	4	2	6	1	3	1	2	1	2	1	1	1	0.15	0.15	0.04
2235873	2024-12-14 22:30:00	33	0	4.85	4.00	1.60	5.60	4.10	1.60	1	4	0	6	3	0	7	7	0	3	3	10	10	1	1	3	2	2	1	1	1	0	0.75	0.10	0.00
2235878	2024-12-22 22:30:00	33	3	2.21	3.45	2.98	2.25	3.50	3.15	1	0	3	2	2	3	3	2	6	4	5	1	7	2	3	1	2	1	3	1	1	1	0.04	0.05	0.17
2235879	2024-12-21 03:30:00	33	3	1.29	5.80	7.70	1.25	6.70	10.00	14	15	26	13	15	20	27	30	46	25	22	6	52	3	2	1	1	2	3	-1	1	1	-0.04	0.90	2.30
2235876	2024-12-14 22:30:00	33	1	1.61	3.55	5.70	1.61	3.90	5.80	0	0	2	0	2	2	0	2	4	5	3	1	5	3	2	1	1	2	3	0	1	1	0.00	0.35	0.10
2235877	2024-12-22 01:30:00	33	3	1.37	4.75	7.30	1.37	4.95	8.20	4	3	7	3	5	5	7	8	12	7	6	2	14	3	2	1	1	2	3	0	1	1	0.00	0.20	0.90
2235882	2024-12-14 22:30:00	33	3	5.50	4.35	1.48	6.60	4.60	1.47	3	3	5	7	5	4	10	8	9	2	4	3	12	1	3	2	3	1	2	1	1	-1	1.10	0.25	-0.01
2235883	2024-12-21 22:30:00	33	0	2.29	3.50	2.78	2.29	3.70	2.92	0	1	1	0	1	2	0	2	3	4	2	1	4	3	2	1	1	2	3	0	1	1	0.00	0.20	0.14
2235880	2024-12-21 22:30:00	33	0	1.85	3.70	3.70	1.84	3.85	4.05	4	1	2	2	3	4	6	4	6	2	4	2	8	1	3	1	2	1	2	-1	1	1	-0.01	0.15	0.35
2235881	2024-12-21 22:30:00	33	3	3.10	3.30	2.35	3.10	3.30	2.35	0	1	0	1	0	0	1	1	0	0	0	1	1	1	1	3	2	2	1	0	0	0	0.00	0.00	0.00
2235886	2024-12-23 00:30:00	33	0	2.82	3.55	2.26	3.00	3.60	2.28	4	0	2	3	1	3	7	1	5	0	6	2	7	1	3	2	3	1	2	1	1	1	0.18	0.05	0.02
2235887	2025-01-11 03:30:00	33	0	2.63	3.40	2.47	2.84	3.40	2.49	10	5	2	15	3	2	25	8	4	1	18	22	26	1	2	3	3	2	1	1	0	1	0.21	0.00	0.02
2235884	2024-12-21 22:30:00	33	0	1.43	4.50	6.40	1.45	4.65	6.90	4	2	3	3	5	6	7	7	9	3	3	1	10	2	2	1	1	1	3	1	1	1	0.02	0.15	0.50
2235885	2024-12-21 22:30:00	33	3	2.11	3.30	3.30	2.11	3.35	3.60	1	0	0	0	1	2	1	1	2	1	1	0	2	2	2	1	1	1	3	0	1	1	0.00	0.05	0.30
2235890	2025-01-11 22:30:00	33	0	2.35	3.50	2.71	2.35	3.70	2.84	0	4	5	0	6	4	0	10	9	13	3	4	13	3	1	2	1	3	2	0	1	1	0.00	0.20	0.13
2235891	2025-01-12 22:30:00	33	3	1.76	3.95	3.90	1.83	3.90	4.05	2	2	2	2	3	3	4	5	5	2	1	1	6	3	1	1	1	2	2	1	-1	1	0.07	-0.05	0.15
2235888	2025-01-12 01:30:00	33	0	7.30	5.10	1.35	7.40	5.70	1.35	8	3	4	12	6	2	20	9	6	1	12	15	21	1	2	3	3	2	1	1	1	0	0.10	0.60	0.00
2235889	2025-01-11 22:30:00	33	3	1.38	4.70	7.10	1.41	4.90	7.20	1	3	8	4	3	5	5	6	13	8	7	0	13	3	2	1	1	2	3	1	1	1	0.03	0.20	0.10
2235894	2025-01-11 22:30:00	33	3	3.05	3.15	2.28	3.35	3.20	2.28	1	1	0	2	1	0	3	2	0	1	2	4	4	1	2	3	3	2	1	1	1	0	0.30	0.05	0.00
2235895	2025-01-15 03:30:00	33	3	1.33	5.00	7.90	1.37	5.00	8.00	9	11	10	10	8	14	19	19	24	14	14	9	33	2	2	1	1	1	3	1	0	1	0.04	0.00	0.10
2235892	2025-01-13 00:30:00	33	0	3.30	3.55	2.02	3.65	3.50	2.05	5	3	4	5	2	7	10	5	11	5	10	4	15	2	3	1	2	1	3	1	-1	1	0.35	-0.05	0.03
2235893	2025-01-11 22:30:00	33	0	3.20	3.50	2.09	3.35	3.45	2.17	6	4	5	7	4	3	13	8	8	4	9	9	17	1	2	2	3	1	1	1	-1	1	0.15	-0.05	0.08
2235898	2025-01-16 03:30:00	33	3	1.11	10.00	20.00	1.12	10.00	17.00	2	3	4	2	4	4	4	7	8	6	3	2	10	3	2	1	1	2	3	1	0	-1	0.01	0.00	-3.00
2235899	2025-01-15 01:30:00	33	3	5.30	4.40	1.50	5.80	4.60	1.52	1	2	1	4	3	2	5	5	3	3	3	5	8	1	1	3	2	2	1	1	1	1	0.50	0.20	0.02
2235896	2025-01-16 01:30:00	33	3	2.53	3.00	2.83	2.61	3.20	2.84	5	4	14	6	6	13	11	10	27	17	18	1	28	2	3	1	2	1	3	1	1	1	0.08	0.20	0.01
2235897	2025-01-11 22:30:00	33	3	1.61	3.90	4.90	1.63	4.05	5.30	3	2	6	7	2	4	10	4	10	1	7	1	11	1	3	1	2	1	2	1	1	1	0.02	0.15	0.40
2235902	2025-01-16 03:30:00	33	0	1.86	3.40	4.60	2.03	3.25	4.00	3	5	10	9	3	6	12	8	16	7	11	3	19	2	3	1	2	1	3	1	-1	-1	0.17	-0.15	-0.60
2235903	2025-01-16 03:30:00	33	1	1.64	4.20	4.95	1.69	4.10	4.70	4	5	7	8	5	6	12	10	13	2	4	1	14	2	3	1	2	1	3	1	-1	-1	0.05	-0.10	-0.25
2235900	2025-01-16 03:30:00	33	3	1.99	3.65	3.30	1.95	3.70	3.75	11	5	12	13	6	11	24	11	23	3	16	4	27	1	3	2	3	1	2	-1	1	1	-0.04	0.05	0.45
2235901	2025-01-15 03:30:00	33	3	1.83	3.75	3.75	1.71	4.10	4.55	12	3	8	5	9	15	17	12	23	6	11	0	23	2	3	1	2	1	3	-1	1	1	-0.12	0.35	0.80
2235854	2024-12-02 00:30:00	33	0	3.65	3.60	1.90	3.85	3.75	1.90	5	3	8	5	5	5	10	8	13	5	7	2	15	2	3	1	2	1	3	1	1	0	0.20	0.15	0.00
2235855	2024-12-01 22:30:00	33	3	2.05	3.60	3.20	2.02	3.80	3.45	4	1	2	3	2	5	7	3	7	2	6	2	9	1	3	1	2	1	2	-1	1	1	-0.03	0.20	0.25
2235853	2024-11-30 22:30:00	33	3	2.00	3.60	3.35	2.03	3.75	3.45	3	1	3	5	3	4	8	4	7	1	5	2	9	1	3	2	3	1	2	1	1	1	0.03	0.15	0.10
2235858	2024-11-30 22:30:00	33	1	2.81	3.70	2.21	2.88	3.70	2.31	4	3	0	3	3	2	7	6	2	0	1	5	7	1	2	3	3	2	1	1	0	1	0.07	0.00	0.10
2235859	2024-12-07 22:30:00	33	3	1.23	6.00	10.00	1.24	6.00	12.00	4	6	5	5	7	6	9	13	11	8	4	6	17	3	1	2	1	3	2	1	0	1	0.01	0.00	2.00
2235856	2024-11-30 22:30:00	33	0	1.72	3.85	4.15	1.76	3.90	4.45	0	2	3	3	1	1	3	3	4	1	1	0	4	2	2	1	1	1	3	1	1	1	0.04	0.05	0.30
2235857	2024-11-30 22:30:00	33	0	4.25	3.55	1.77	4.65	3.80	1.75	1	1	3	4	2	1	5	3	4	1	3	2	6	1	3	2	3	1	2	1	1	-1	0.40	0.25	-0.02
2235862	2024-12-07 22:30:00	33	3	1.08	9.40	22.00	1.09	11.00	24.00	1	1	3	2	3	5	3	4	8	8	7	3	11	3	2	1	1	2	3	1	1	1	0.01	1.60	2.00
2235863	2024-12-07 22:30:00	33	1	1.56	4.15	5.00	1.56	4.20	5.90	0	2	1	0	1	3	0	3	4	5	2	1	5	3	2	1	1	2	3	0	1	1	0.00	0.05	0.90
2235860	2024-12-08 01:30:00	33	1	2.91	3.80	2.12	3.10	3.80	2.14	4	3	5	7	3	3	11	6	8	4	9	7	15	1	3	2	3	1	2	1	0	1	0.19	0.00	0.02
2235861	2024-12-07 22:30:00	33	0	2.90	3.55	2.21	3.25	3.65	2.13	2	0	1	3	2	0	5	2	1	0	3	4	5	1	2	3	3	2	1	1	1	-1	0.35	0.10	-0.08
2235866	2024-12-07 22:30:00	33	0	4.85	4.30	1.56	5.70	4.45	1.54	1	0	4	5	3	1	6	3	5	0	3	1	6	1	3	2	3	1	2	1	1	-1	0.85	0.15	-0.02
2235867	2024-12-07 03:30:00	33	3	1.75	3.70	4.20	1.77	3.60	4.85	4	5	3	3	4	8	7	9	11	8	6	4	15	3	2	1	1	2	3	1	-1	1	0.02	-0.10	0.65
2235864	2024-12-09 00:30:00	33	1	2.47	3.55	2.53	2.49	3.60	2.69	6	0	2	6	1	3	12	1	5	0	11	7	12	1	3	2	3	1	2	1	1	1	0.02	0.05	0.16
2235865	2024-11-30 03:30:00	33	3	1.85	3.60	3.85	1.91	3.40	4.25	4	5	7	10	2	5	14	7	12	4	11	6	18	1	3	2	3	1	2	1	-1	1	0.06	-0.20	0.40
2235870	2024-12-16 00:30:00	33	1	1.42	4.80	6.00	1.42	5.00	6.70	2	0	0	2	1	3	4	1	3	2	5	3	6	1	3	2	3	1	2	0	1	1	0.00	0.20	0.70
2235871	2024-12-14 03:30:00	33	3	2.16	3.35	3.15	2.25	3.30	3.30	3	8	10	6	6	9	9	14	19	15	10	5	24	3	2	1	1	2	3	1	-1	1	0.09	-0.05	0.15
2235868	2024-12-08 22:30:00	33	3	2.13	3.50	3.05	2.12	3.50	3.40	1	2	1	0	1	2	1	3	3	4	2	2	5	3	1	1	1	2	2	-1	0	1	-0.01	0.00	0.35
2235869	2024-12-14 22:30:00	33	3	1.41	4.65	6.60	1.42	4.95	7.00	2	0	1	1	4	4	3	4	5	3	2	1	6	3	2	1	1	2	3	1	1	1	0.01	0.30	0.40
2021453	2023-06-12 02:45:00	34	0	2.79	2.99	2.58	2.95	3.10	2.58	7	2	2	7	2	5	14	4	7	0	10	7	14	1	3	2	3	1	2	1	1	0	0.16	0.11	0.00
1843608	2023-06-05 03:00:00	34	3	1.58	4.00	5.10	1.58	4.30	5.40	5	3	4	5	4	7	10	7	11	1	4	0	11	2	3	1	2	1	3	0	1	1	0.00	0.30	0.30
1843610	2023-06-05 03:00:00	34	0	3.50	3.55	1.95	4.20	3.60	1.87	3	1	7	9	2	4	12	3	11	0	9	1	12	1	3	2	3	1	2	1	1	-1	0.70	0.05	-0.08
2043327	2024-05-27 02:45:00	34	3	2.05	3.55	3.25	2.09	3.70	3.35	11	4	10	13	7	8	24	11	18	3	16	9	27	1	3	2	3	1	2	1	1	1	0.04	0.15	0.10
2043325	2023-08-29 02:45:00	34	0	6.10	4.40	1.45	7.60	4.50	1.45	1	1	2	3	3	1	4	4	3	1	1	2	5	1	1	3	2	2	1	1	1	0	1.50	0.10	0.00
2043324	2024-05-27 02:45:00	34	1	4.85	4.20	1.58	6.20	4.45	1.51	2	2	3	4	5	1	6	7	4	4	3	6	10	2	1	3	2	3	1	1	1	-1	1.35	0.25	-0.07
2043323	2024-05-27 00:00:00	34	1	1.46	4.50	5.90	1.41	4.80	7.70	6	0	2	0	4	9	6	4	11	7	9	2	13	2	3	1	2	1	3	-1	1	1	-0.05	0.30	1.80
2043322	2024-05-26 02:45:00	34	1	1.17	8.20	15.00	1.14	9.40	16.00	4	5	4	2	8	6	6	13	10	7	0	3	13	3	1	2	1	3	2	-1	1	1	-0.03	1.20	1.00
2043321	2024-05-27 02:45:00	34	1	1.33	5.30	7.10	1.37	5.20	8.00	4	5	9	7	5	8	11	10	17	6	7	0	17	2	3	1	2	1	3	1	-1	1	0.04	-0.10	0.90
2043320	2024-05-26 00:00:00	34	3	1.35	5.00	7.20	1.39	4.80	8.20	3	6	9	7	3	5	10	9	14	4	5	0	14	2	3	1	2	1	3	1	-1	1	0.04	-0.20	1.00
2043319	2023-08-27 02:45:00	34	3	1.64	3.65	5.10	1.65	3.75	5.60	2	2	3	2	4	4	4	6	7	3	1	0	7	3	2	1	1	2	3	1	1	1	0.01	0.10	0.50
2043318	2023-08-21 02:45:00	34	0	4.55	3.50	1.84	4.45	3.45	1.86	2	2	5	6	2	2	8	4	7	0	4	1	8	1	3	2	3	1	2	-1	-1	1	-0.10	-0.05	0.02
2043314	2023-08-20 02:45:00	34	3	1.35	4.90	7.50	1.41	4.90	7.10	1	6	7	5	4	3	6	10	10	4	0	0	10	3	1	1	1	2	2	1	0	-1	0.06	0.00	-0.40
2043312	2023-08-20 00:30:00	34	0	7.60	4.75	1.36	8.00	4.95	1.38	2	2	1	2	2	3	4	4	4	0	0	0	4	1	1	1	1	1	1	1	1	1	0.40	0.20	0.02
2043310	2023-08-22 02:45:00	34	0	3.85	3.50	1.98	3.85	3.50	1.99	2	1	3	4	2	3	6	3	6	1	4	1	7	1	3	1	2	1	2	0	0	1	0.00	0.00	0.01
2043309	2023-08-21 00:30:00	34	1	1.52	4.00	7.00	1.55	3.95	6.60	2	2	2	2	2	1	4	4	3	0	0	1	4	1	1	3	2	2	1	1	-1	-1	0.03	-0.05	-0.40
2043357	2024-05-12 21:00:00	34	3	2.20	3.40	3.00	2.20	3.50	3.25	0	1	1	0	1	2	0	2	3	4	2	1	4	3	2	1	1	2	3	0	1	1	0.00	0.10	0.25
2043355	2023-09-03 02:45:00	34	0	1.65	3.85	4.70	1.60	4.05	5.70	5	2	2	2	5	7	7	7	9	2	2	0	9	2	2	1	1	1	3	-1	1	1	-0.05	0.20	1.00
2043353	2024-05-14 02:45:00	34	3	1.58	4.05	4.95	1.58	4.35	5.40	3	1	3	4	4	3	7	5	6	2	4	3	9	1	3	2	3	1	2	0	1	1	0.00	0.30	0.45
2043352	2023-09-04 00:30:00	34	3	1.64	4.00	5.30	1.66	4.00	5.10	1	2	3	2	3	2	3	5	5	2	0	0	5	3	1	1	1	2	2	1	0	-1	0.02	0.00	-0.20
2043351	2024-05-13 02:45:00	34	3	1.95	3.60	3.45	1.97	3.75	3.65	10	4	9	10	5	9	20	9	18	6	17	8	26	1	3	2	3	1	2	1	1	1	0.02	0.15	0.20
2043350	2023-09-04 02:45:00	34	0	4.45	3.80	1.69	5.10	3.85	1.68	2	2	1	2	2	1	4	4	2	0	0	2	4	1	1	3	2	2	1	1	1	-1	0.65	0.05	-0.01
2043348	2024-05-19 02:45:00	34	3	2.60	3.20	2.61	2.75	3.20	2.66	9	2	8	10	1	9	19	3	17	1	17	3	20	1	3	2	3	1	2	1	0	1	0.15	0.00	0.05
2043346	2023-09-02 02:45:00	34	0	2.83	3.10	2.49	2.73	3.20	2.69	14	0	14	14	1	14	28	1	28	2	29	2	30	1	3	1	2	1	2	-1	1	1	-0.10	0.10	0.20
2043345	2024-05-19 18:30:00	34	0	2.31	3.45	2.80	2.33	3.45	2.76	0	0	3	2	0	1	2	0	4	2	4	0	4	2	3	1	2	1	3	1	0	-1	0.02	0.00	-0.04
2043344	2024-05-21 00:30:00	34	0	4.95	3.80	1.64	5.40	4.05	1.62	9	4	6	10	6	6	19	10	12	1	10	8	20	1	3	2	3	1	2	1	1	-1	0.45	0.25	-0.02
2043343	2024-05-20 02:45:00	34	3	1.49	4.30	6.80	1.51	4.30	6.40	4	4	6	4	7	8	8	11	14	8	5	2	16	3	2	1	1	2	3	1	0	-1	0.02	0.00	-0.40
2043342	2024-05-19 21:00:00	34	0	2.67	3.55	2.36	2.85	3.65	2.36	2	0	0	3	1	1	5	1	1	0	4	4	5	1	2	2	3	1	1	1	1	0	0.18	0.10	0.00
2043340	2024-05-19 00:00:00	34	0	4.20	3.75	1.74	4.85	3.85	1.71	2	3	3	7	5	0	9	8	3	0	1	6	9	1	2	3	3	2	1	1	1	-1	0.65	0.10	-0.03
2043338	2024-05-20 00:00:00	34	1	1.65	3.90	4.55	1.66	4.00	5.00	6	5	5	5	6	6	11	11	11	4	4	4	15	1	1	1	1	1	1	1	1	1	0.01	0.10	0.45
2043337	2023-08-28 02:45:00	34	3	1.32	5.30	7.50	1.34	5.40	8.40	2	3	6	5	3	8	7	6	14	7	8	0	14	2	3	1	2	1	3	1	1	1	0.02	0.10	0.90
2043336	2024-05-18 02:45:00	34	1	2.36	3.45	2.72	2.35	3.60	2.90	4	4	9	2	5	10	6	9	19	14	11	1	20	3	2	1	1	2	3	-1	1	1	-0.01	0.15	0.18
2043334	2024-05-21 02:45:00	34	1	2.53	3.10	3.00	2.58	3.10	2.96	1	1	6	2	1	6	3	2	12	10	11	1	13	2	3	1	2	1	3	1	0	-1	0.05	0.00	-0.04
2043332	2023-08-28 00:30:00	34	1	1.46	4.15	6.40	1.54	4.20	6.10	1	3	3	4	2	2	5	5	5	2	2	2	7	1	1	1	1	1	1	1	1	-1	0.08	0.05	-0.30
2043330	2024-05-25 02:45:00	34	3	3.20	3.20	2.21	3.25	3.30	2.28	7	2	9	7	3	7	14	5	16	4	13	2	18	2	3	1	2	1	3	1	1	1	0.05	0.10	0.07
2043328	2024-05-27 02:45:00	34	0	2.51	3.10	2.80	2.56	3.15	2.91	2	2	5	3	2	6	5	4	11	7	8	1	12	2	3	1	2	1	3	1	1	1	0.05	0.05	0.11
2043391	2023-09-23 02:45:00	34	3	2.38	3.10	2.97	2.51	3.10	3.05	0	3	9	4	3	8	4	6	17	13	11	0	17	3	2	1	1	2	3	1	0	1	0.13	0.00	0.08
2043390	2024-05-04 02:45:00	34	1	2.78	2.87	2.69	2.81	3.05	2.75	10	1	4	8	5	8	18	6	12	0	12	6	18	1	3	2	3	1	2	1	1	1	0.03	0.18	0.06
2043389	2024-05-05 02:45:00	34	3	5.40	4.45	1.49	5.90	4.55	1.52	10	8	8	10	10	10	20	18	18	5	7	7	25	1	2	2	3	1	1	1	1	1	0.50	0.10	0.03
2043388	2024-05-07 00:00:00	34	0	7.30	4.85	1.36	8.50	5.00	1.36	4	2	4	9	4	3	13	6	7	2	9	8	15	1	3	2	3	1	2	1	1	0	1.20	0.15	0.00
2043387	2024-05-06 02:45:00	34	1	2.84	3.15	2.63	2.84	3.20	2.61	8	1	3	6	2	4	14	3	7	0	11	7	14	1	3	2	3	1	2	0	1	-1	0.00	0.05	-0.02
2043386	2024-05-06 00:00:00	34	1	1.45	4.30	6.30	1.48	4.40	6.90	1	3	4	5	3	3	6	6	7	1	1	0	7	2	2	1	1	1	3	1	1	1	0.03	0.10	0.60
2043385	2024-05-05 00:00:00	34	1	4.05	3.45	1.84	4.40	3.55	1.84	1	0	2	3	1	1	4	1	3	0	3	1	4	1	3	2	3	1	2	1	1	0	0.35	0.10	0.00
2043384	2024-05-05 21:00:00	34	1	2.38	3.40	2.98	2.38	3.40	2.99	0	0	0	0	1	2	0	1	2	2	1	0	2	3	2	1	1	2	3	0	0	1	0.00	0.00	0.01
2043381	2023-09-24 18:30:00	34	0	8.80	5.20	1.29	8.80	5.20	1.29	1	0	2	2	1	1	3	1	3	0	2	0	3	1	3	1	2	1	2	0	0	0	0.00	0.00	0.00
2043380	2023-09-25 00:00:00	34	1	3.25	3.55	2.05	3.65	3.60	2.00	0	0	4	3	1	0	3	1	4	2	4	1	5	2	3	1	2	1	3	1	1	-1	0.40	0.05	-0.05
2043378	2023-09-23 21:00:00	34	3	1.33	4.80	8.50	1.33	4.80	8.30	1	0	1	0	1	1	1	1	2	1	1	0	2	2	2	1	1	1	3	0	0	-1	0.00	0.00	-0.20
2043377	2024-05-19 21:00:00	34	1	1.99	3.25	3.75	1.91	3.35	4.35	6	0	1	0	2	8	6	2	9	3	7	0	9	2	3	1	2	1	3	-1	1	1	-0.08	0.10	0.60
2043375	2024-05-27 00:00:00	34	3	3.25	3.45	2.07	3.25	3.55	2.16	4	4	5	4	5	6	8	9	11	6	5	3	14	3	2	1	1	2	3	0	1	1	0.00	0.10	0.09
2043372	2023-09-16 21:00:00	34	3	1.91	3.40	3.80	1.93	3.45	4.10	2	1	3	2	2	4	4	3	7	3	4	0	7	2	3	1	2	1	3	1	1	1	0.02	0.05	0.30
2043371	2023-09-17 00:00:00	34	3	2.12	3.50	3.10	2.12	3.60	3.30	0	4	5	0	6	6	0	10	11	15	5	4	15	3	2	1	1	2	3	0	1	1	0.00	0.10	0.20
2043370	2023-09-17 02:45:00	34	1	5.10	3.95	1.66	5.10	3.95	1.66	4	3	1	4	4	1	8	7	2	0	1	6	8	1	2	3	3	2	1	0	0	0	0.00	0.00	0.00
2043369	2023-09-17 21:00:00	34	3	2.74	3.45	2.35	2.72	3.45	2.36	2	0	1	1	0	2	3	0	3	0	3	0	3	1	3	1	2	1	2	-1	0	1	-0.02	0.00	0.01
2043368	2024-05-12 21:00:00	34	0	2.83	2.93	2.60	2.96	3.00	2.63	9	5	5	11	2	9	20	7	14	0	13	6	20	1	3	2	3	1	2	1	1	1	0.13	0.07	0.03
2043366	2024-05-12 00:00:00	34	0	2.19	3.35	3.10	2.19	3.45	3.30	0	2	1	0	3	3	0	5	4	8	3	4	8	3	1	2	1	3	2	0	1	1	0.00	0.10	0.20
2043365	2023-09-18 02:45:00	34	3	1.42	4.60	7.80	1.37	4.85	9.00	10	8	9	7	11	13	17	19	22	5	3	0	22	3	2	1	1	2	3	-1	1	1	-0.05	0.25	1.20
2043364	2024-05-12 02:45:00	34	3	1.46	4.30	6.10	1.52	4.45	5.90	4	3	9	6	6	6	10	9	15	6	7	1	16	2	3	1	2	1	3	1	1	-1	0.06	0.15	-0.20
2043363	2024-05-14 00:30:00	34	0	2.94	3.10	2.40	3.05	3.20	2.44	3	3	0	3	4	2	6	7	2	4	3	8	10	2	1	3	2	3	1	1	1	1	0.11	0.10	0.04
2043362	2024-05-12 18:30:00	34	3	1.61	3.80	5.20	1.64	3.75	4.95	1	2	3	3	2	0	4	4	3	2	2	3	6	1	1	3	2	2	1	1	-1	-1	0.03	-0.05	-0.25
2043422	2024-04-29 00:00:00	34	3	1.45	4.40	6.00	1.46	4.55	7.00	10	11	3	12	11	3	22	22	6	2	2	18	24	1	1	3	2	2	1	1	1	1	0.01	0.15	1.00
2043420	2024-04-29 00:00:00	34	1	1.85	3.60	3.85	1.98	3.55	3.80	3	2	7	7	2	3	10	4	10	1	7	1	11	1	3	1	2	1	2	1	-1	-1	0.13	-0.05	-0.05
2043419	2024-04-27 21:00:00	34	1	2.06	3.25	3.50	2.03	3.30	3.95	1	1	1	3	2	2	4	3	3	1	2	2	5	1	2	2	3	1	1	-1	1	1	-0.03	0.05	0.45
2043416	2023-10-01 00:00:00	34	3	1.77	3.70	4.65	1.77	3.70	4.65	0	1	1	0	2	2	0	3	3	3	0	0	3	3	1	1	1	2	2	0	0	0	0.00	0.00	0.00
2043414	2023-09-28 02:45:00	34	3	1.38	4.95	8.10	1.40	4.85	7.70	0	2	2	2	1	2	2	3	4	2	1	0	4	3	2	1	1	2	3	1	-1	-1	0.02	-0.10	-0.40
2043411	2023-09-27 02:45:00	34	3	1.53	4.20	6.30	1.50	4.20	6.90	2	3	4	2	4	6	4	7	10	7	4	1	11	3	2	1	1	2	3	-1	0	1	-0.03	0.00	0.60
2043410	2023-09-28 02:45:00	34	0	1.34	5.60	8.00	1.32	5.70	8.70	2	1	2	2	3	5	4	4	7	3	3	0	7	2	2	1	1	1	3	-1	1	1	-0.02	0.10	0.70
2043408	2024-04-28 02:45:00	34	3	1.65	3.65	4.95	1.63	4.00	5.40	3	3	7	1	7	7	4	10	14	13	7	3	17	3	2	1	1	2	3	-1	1	1	-0.02	0.35	0.45
2043407	2023-09-29 00:30:00	34	1	3.30	3.55	2.02	3.65	3.70	1.99	6	2	6	6	3	7	12	5	13	2	9	1	14	2	3	1	2	1	3	1	1	-1	0.35	0.15	-0.03
2043406	2024-04-28 00:00:00	34	1	2.11	3.30	3.30	2.11	3.35	3.60	1	1	2	2	2	3	3	3	5	3	3	1	6	2	2	1	1	1	3	0	1	1	0.00	0.05	0.30
2043403	2023-09-28 00:30:00	34	0	5.40	3.85	1.65	5.00	3.75	1.71	2	2	1	1	2	2	3	4	3	1	0	1	4	2	1	2	1	3	1	-1	-1	1	-0.40	-0.10	0.06
2043402	2024-04-30 02:45:00	34	3	2.42	3.05	2.93	2.42	3.00	3.30	5	10	9	6	8	12	11	18	21	12	5	2	23	3	2	1	1	2	3	0	-1	1	0.00	-0.05	0.37
2043401	2024-04-27 02:45:00	34	3	1.45	4.55	6.10	1.43	4.85	7.10	5	8	11	5	8	9	10	16	20	13	7	3	23	3	2	1	1	2	3	-1	1	1	-0.02	0.30	1.00
2043399	2023-09-25 02:45:00	34	1	3.25	3.00	2.44	3.15	3.00	2.49	2	2	1	1	1	1	3	3	2	1	1	2	4	1	1	3	2	2	1	-1	0	1	-0.10	0.00	0.05
2043398	2023-09-24 00:00:00	34	3	4.00	3.85	1.75	4.45	3.95	1.75	0	0	1	3	2	0	3	2	1	0	1	2	3	1	2	3	3	2	1	1	1	0	0.45	0.10	0.00
2043397	2024-05-05 21:00:00	34	3	3.15	3.30	2.33	3.10	3.30	2.35	1	0	0	1	1	1	2	1	1	0	1	1	2	1	2	2	3	1	1	-1	0	1	-0.05	0.00	0.02
2043392	2024-05-07 02:45:00	34	1	3.25	3.45	2.08	3.65	3.65	1.99	5	2	10	6	6	7	11	8	17	10	13	4	21	2	3	1	2	1	3	1	1	-1	0.40	0.20	-0.09
2043455	2023-10-07 02:45:00	34	1	2.42	3.50	2.64	2.53	3.55	2.68	1	2	3	3	2	3	4	4	6	4	4	2	8	2	2	1	1	1	3	1	1	1	0.11	0.05	0.04
2043454	2024-04-14 21:00:00	34	1	4.10	3.75	1.75	4.20	3.95	1.79	4	0	0	1	1	3	5	1	3	0	4	2	5	1	3	2	3	1	2	1	1	1	0.10	0.20	0.04
2043453	2023-10-08 21:00:00	34	3	2.79	3.30	2.40	2.66	3.30	2.49	2	0	1	1	0	1	3	0	2	0	3	1	3	1	3	2	3	1	2	-1	0	1	-0.13	0.00	0.09
2043452	2024-04-14 18:30:00	34	1	1.31	5.20	8.30	1.31	5.10	8.40	0	1	4	0	1	4	0	2	8	8	6	0	8	3	2	1	1	2	3	0	-1	1	0.00	-0.10	0.10
2043451	2024-04-13 21:00:00	34	3	2.23	2.94	3.45	2.23	3.05	3.65	0	2	0	0	1	2	0	3	2	3	0	1	3	3	1	2	1	3	2	0	1	1	0.00	0.11	0.20
2043450	2024-04-13 02:45:00	34	3	1.29	5.20	9.10	1.33	5.20	9.20	6	4	11	8	4	14	14	8	25	12	18	1	26	2	3	1	2	1	3	1	0	1	0.04	0.00	0.10
2043449	2024-04-15 02:45:00	34	1	1.19	6.70	12.00	1.19	6.80	15.00	3	3	1	4	4	3	7	7	4	2	2	5	9	1	1	3	2	2	1	0	1	1	0.00	0.10	3.00
2043448	2023-10-07 21:00:00	34	1	1.33	4.90	8.00	1.33	4.90	8.10	1	1	2	1	1	2	2	2	4	2	2	0	4	2	2	1	1	1	3	0	0	1	0.00	0.00	0.10
2043447	2023-10-08 02:45:00	34	0	4.00	3.55	1.93	4.35	3.50	1.87	5	6	5	9	5	2	14	11	7	0	3	7	14	1	2	3	3	2	1	1	-1	-1	0.35	-0.05	-0.06
2043446	2024-04-16 00:30:00	34	1	1.94	3.40	3.70	1.95	3.45	4.05	5	4	9	9	4	8	14	8	17	5	11	2	19	2	3	1	2	1	3	1	1	1	0.01	0.05	0.35
2043444	2024-04-16 02:45:00	34	1	1.44	4.30	6.50	1.47	4.50	6.80	3	5	7	7	4	4	10	9	11	1	2	0	11	2	3	1	2	1	3	1	1	1	0.03	0.20	0.30
2043442	2023-10-07 00:30:00	34	1	2.91	3.20	2.35	3.15	3.25	2.35	0	2	0	3	1	0	3	3	0	1	1	4	4	1	1	3	2	2	1	1	1	0	0.24	0.05	0.00
2043438	2024-04-21 21:00:00	34	1	1.72	3.70	4.40	1.72	3.70	5.00	0	1	0	0	2	1	0	3	1	4	1	3	4	3	1	2	1	3	2	0	0	1	0.00	0.00	0.60
2043436	2024-04-23 00:30:00	34	0	2.36	3.00	3.10	2.35	3.15	3.25	2	2	2	1	3	4	3	5	6	4	2	1	7	3	2	1	1	2	3	-1	1	1	-0.01	0.15	0.15
2043435	2024-04-23 02:45:00	34	0	3.30	3.60	2.00	3.55	3.65	2.01	6	4	8	7	3	9	13	7	17	9	15	5	22	2	3	1	2	1	3	1	1	1	0.25	0.05	0.01
2043434	2024-04-22 02:45:00	34	0	4.00	3.60	1.91	4.10	3.55	1.91	2	2	2	6	2	1	8	4	3	0	4	5	8	1	2	3	3	2	1	1	-1	0	0.10	-0.05	0.00
2043433	2024-04-20 00:30:00	34	0	2.75	3.10	2.53	3.05	3.10	2.53	0	1	0	3	0	0	3	1	0	0	2	3	3	1	2	3	3	2	1	1	0	0	0.30	0.00	0.00
2043432	2024-04-21 00:00:00	34	3	4.75	3.95	1.71	4.80	3.95	1.70	1	0	1	2	1	0	3	1	1	0	2	2	3	1	2	2	3	1	1	1	0	-1	0.05	0.00	-0.01
2043430	2024-04-20 02:45:00	34	1	4.30	3.55	1.77	5.10	3.45	1.78	3	4	1	10	1	1	13	5	2	2	10	13	15	1	2	3	3	2	1	1	-1	1	0.80	-0.10	0.01
2043427	2023-10-01 02:45:00	34	0	7.30	4.75	1.38	7.50	4.65	1.43	6	5	3	6	4	5	12	9	8	0	3	4	12	1	2	3	3	2	1	1	-1	1	0.20	-0.10	0.05
2043426	2024-04-29 02:45:00	34	3	1.73	3.75	4.20	1.57	4.25	5.70	5	0	3	1	7	6	6	7	9	4	3	1	10	3	2	1	1	2	3	-1	1	1	-0.16	0.50	1.50
2043424	2024-04-28 21:00:00	34	1	1.66	3.70	5.60	1.66	3.70	5.60	0	0	0	0	1	1	0	1	1	1	0	0	1	3	1	1	1	2	2	0	0	0	0.00	0.00	0.00
2043487	2024-04-01 21:00:00	34	1	2.21	3.30	3.40	2.21	3.25	3.45	0	1	0	0	1	2	0	2	2	2	0	0	2	3	1	1	1	2	2	0	-1	1	0.00	-0.05	0.05
2043485	2024-04-01 18:30:00	34	3	1.23	5.40	12.00	1.23	5.40	12.00	1	3	0	1	2	0	2	5	0	4	1	6	6	2	1	3	2	3	1	0	0	0	0.00	0.00	0.00
2043484	2023-10-31 03:45:00	34	3	2.25	3.35	2.97	2.26	3.45	3.15	1	2	4	2	3	4	3	5	8	7	5	2	10	3	2	1	1	2	3	1	1	1	0.01	0.10	0.18
2043483	2023-10-29 02:45:00	34	3	1.37	4.85	9.10	1.39	4.65	8.80	9	7	10	9	8	13	18	15	23	5	8	0	23	2	3	1	2	1	3	1	-1	-1	0.02	-0.20	-0.30
2043482	2023-10-30 01:00:00	34	3	1.60	3.95	5.80	1.56	4.05	6.20	1	1	2	2	2	2	3	3	4	1	1	0	4	2	2	1	1	1	3	-1	1	1	-0.04	0.10	0.40
2043480	2023-10-31 01:30:00	34	0	4.50	3.85	1.67	5.20	4.05	1.63	5	3	3	7	5	1	12	8	4	0	4	8	12	1	2	3	3	2	1	1	1	-1	0.70	0.20	-0.04
2043479	2024-04-07 00:00:00	34	3	2.20	3.30	3.45	2.20	3.25	3.45	0	2	0	0	2	1	0	4	1	4	0	3	4	3	1	2	1	3	2	0	-1	0	0.00	-0.05	0.00
2043477	2024-04-08 00:00:00	34	0	2.66	3.00	2.93	2.56	3.00	3.05	1	1	1	0	3	3	1	4	4	3	0	0	4	3	1	1	1	2	2	-1	0	1	-0.10	0.00	0.12
2043476	2023-10-21 21:00:00	34	0	4.80	3.85	1.64	4.80	3.85	1.64	0	0	0	1	0	0	1	0	0	0	1	1	1	1	2	2	3	1	1	0	0	0	0.00	0.00	0.00
2043475	2024-04-09 02:45:00	34	0	7.10	4.30	1.42	8.30	4.80	1.39	8	7	9	11	11	6	19	18	15	5	6	9	24	1	2	3	3	2	1	1	1	-1	1.20	0.50	-0.03
2043474	2023-10-24 00:30:00	34	1	2.19	3.20	3.25	2.21	3.20	3.50	2	0	1	1	0	3	3	0	4	1	4	0	4	2	3	1	2	1	3	1	0	1	0.02	0.00	0.25
2043473	2024-04-06 02:45:00	34	1	3.15	3.50	2.25	3.20	3.50	2.21	2	0	2	3	1	1	5	1	3	0	4	2	5	1	3	2	3	1	2	1	0	-1	0.05	0.00	-0.04
2043472	2023-10-22 00:00:00	34	0	4.30	3.55	1.77	5.30	3.75	1.68	2	1	3	4	3	1	6	4	4	0	2	2	6	1	2	2	3	1	1	1	1	-1	1.00	0.20	-0.09
2043470	2024-04-07 21:00:00	34	0	3.75	3.65	1.86	4.15	3.75	1.84	1	0	2	3	1	1	4	1	3	0	3	1	4	1	3	2	3	1	2	1	1	-1	0.40	0.10	-0.02
2043468	2024-04-06 21:00:00	34	3	1.35	4.80	8.20	1.37	5.00	8.20	1	2	4	2	4	2	3	6	6	4	1	1	7	3	1	1	1	2	2	1	1	0	0.02	0.20	0.00
2043467	2023-10-22 21:00:00	34	3	1.72	3.60	4.50	1.72	3.60	4.50	0	0	1	0	0	0	0	0	1	1	1	0	1	2	2	1	1	1	3	0	0	0	0.00	0.00	0.00
2043466	2024-04-08 02:45:00	34	3	1.82	3.35	4.30	1.80	3.50	4.85	4	0	3	1	2	7	5	2	10	5	8	0	10	2	3	1	2	1	3	-1	1	1	-0.02	0.15	0.55
2043465	2024-04-07 18:30:00	34	1	3.90	3.55	1.84	3.90	3.60	1.84	2	0	3	2	1	3	4	1	6	3	6	1	7	2	3	1	2	1	3	0	1	0	0.00	0.05	0.00
2043463	2023-10-22 18:30:00	34	3	1.69	3.80	4.45	1.69	3.80	4.45	0	0	1	0	1	0	0	1	1	1	0	0	1	3	1	1	1	2	2	0	0	0	0.00	0.00	0.00
2043461	2023-10-23 02:45:00	34	0	2.25	3.30	3.35	2.29	3.25	3.25	0	1	3	1	1	2	1	2	5	4	3	0	5	3	2	1	1	2	3	1	-1	-1	0.04	-0.05	-0.10
2043460	2024-04-08 00:00:00	34	3	4.40	3.85	1.69	4.80	3.95	1.70	1	0	0	1	2	1	2	2	1	1	1	2	3	1	1	3	2	2	1	1	1	1	0.40	0.10	0.01
2043459	2023-10-09 02:45:00	34	0	1.55	4.25	5.00	1.58	4.25	5.50	3	3	4	4	3	5	7	6	9	2	3	0	9	2	3	1	2	1	3	1	0	1	0.03	0.00	0.50
2043456	2024-04-14 00:00:00	34	1	3.80	3.00	2.20	3.85	3.00	2.19	0	0	1	2	0	0	2	0	1	0	2	1	2	1	3	2	3	1	2	1	0	-1	0.05	0.00	-0.01
2043519	2024-03-10 01:00:00	34	0	3.30	3.30	2.12	3.55	3.35	2.13	2	1	2	4	1	1	6	2	3	0	4	3	6	1	3	2	3	1	2	1	1	1	0.25	0.05	0.01
2043518	2023-11-11 03:45:00	34	3	1.99	3.25	4.15	1.98	3.25	4.20	4	0	4	4	1	6	8	1	10	2	9	0	10	2	3	1	2	1	3	-1	0	1	-0.01	0.00	0.05
2043517	2023-11-12 22:00:00	34	3	2.07	3.25	3.45	2.03	3.45	3.75	2	2	1	0	2	5	2	4	6	5	3	1	7	3	2	1	1	2	3	-1	1	1	-0.04	0.20	0.30
2043516	2024-03-17 01:00:00	34	0	2.89	3.25	2.51	2.88	3.25	2.53	1	0	0	2	1	1	3	1	1	0	2	2	3	1	2	2	3	1	1	-1	0	1	-0.01	0.00	0.02
2043515	2023-11-05 19:30:00	34	0	3.10	3.25	2.23	3.10	3.20	2.23	1	2	0	2	0	0	3	2	0	0	1	3	3	1	2	3	3	2	1	0	-1	0	0.00	-0.05	0.00
2043514	2024-03-18 01:00:00	34	3	1.41	4.40	6.90	1.43	4.65	7.50	4	4	4	4	5	10	8	9	14	6	5	0	14	3	2	1	1	2	3	1	1	1	0.02	0.25	0.60
2043513	2024-03-16 22:00:00	34	3	2.08	3.40	3.25	2.08	3.50	3.55	0	0	1	0	1	1	0	1	2	2	1	0	2	3	2	1	1	2	3	0	1	1	0.00	0.10	0.30
2043512	2024-03-17 19:30:00	34	1	1.54	3.75	6.10	1.49	4.00	7.80	2	0	2	1	3	3	3	3	5	2	2	0	5	2	2	1	1	1	3	-1	1	1	-0.05	0.25	1.70
2043511	2023-11-07 03:45:00	34	3	2.12	3.50	3.40	2.20	3.45	3.25	0	3	4	4	3	3	4	6	7	5	3	2	9	3	2	1	1	2	3	1	-1	-1	0.08	-0.05	-0.15
2043510	2023-11-04 22:00:00	34	0	6.90	4.65	1.39	7.40	5.00	1.40	2	1	3	4	4	2	6	5	5	0	1	1	6	1	2	2	3	1	1	1	1	1	0.50	0.35	0.01
2043509	2024-03-18 03:45:00	34	1	1.59	4.05	4.95	1.62	4.20	5.10	8	2	11	8	6	8	16	8	19	5	13	2	21	2	3	1	2	1	3	1	1	1	0.03	0.15	0.15
2043508	2024-03-17 03:45:00	34	0	3.30	3.60	2.13	3.05	3.50	2.28	6	3	0	4	2	5	10	5	5	1	6	6	11	1	2	2	3	1	1	-1	-1	1	-0.25	-0.10	0.15
2043506	2024-03-16 03:45:00	34	0	3.50	3.20	2.08	3.75	3.15	2.13	9	4	11	11	2	9	20	6	20	6	20	6	26	1	3	1	2	1	2	1	-1	1	0.25	-0.05	0.05
2043505	2023-11-06 03:45:00	34	0	2.78	3.25	2.42	2.87	3.25	2.53	12	7	6	17	6	7	29	13	13	0	16	16	29	1	2	2	3	1	1	1	0	1	0.09	0.00	0.11
2043504	2024-06-03 00:00:00	34	0	1.45	4.50	6.20	1.47	4.65	6.40	1	2	3	3	2	2	4	4	5	2	2	1	6	2	2	1	1	1	3	1	1	1	0.02	0.15	0.20
2043503	2023-11-05 22:00:00	34	3	2.63	3.15	2.63	2.78	3.20	2.63	0	1	0	3	1	0	3	2	0	0	1	3	3	1	2	3	3	2	1	1	1	0	0.15	0.05	0.00
2043502	2023-11-04 03:45:00	34	3	2.58	3.30	2.56	2.75	3.25	2.63	8	6	6	13	4	6	21	10	12	2	13	11	23	1	3	2	3	1	2	1	-1	1	0.17	-0.05	0.07
2043501	2023-11-05 01:00:00	34	0	2.99	3.50	2.17	3.45	3.65	2.05	4	2	7	8	4	2	12	6	9	1	7	4	13	1	3	2	3	1	2	1	1	-1	0.46	0.15	-0.12
2043500	2024-03-30 22:00:00	34	3	1.84	3.30	4.25	1.85	3.40	4.65	0	0	2	2	1	1	2	1	3	1	2	0	3	2	3	1	2	1	3	1	1	1	0.01	0.10	0.40
2043499	2024-04-01 21:00:00	34	1	2.90	3.35	2.47	2.90	3.35	2.47	0	0	0	1	1	0	1	1	0	0	0	1	1	1	1	3	2	2	1	0	0	0	0.00	0.00	0.00
2043497	2024-03-30 19:30:00	34	0	2.12	3.50	3.10	2.14	3.50	3.05	0	0	1	2	0	0	2	0	1	0	2	1	2	1	3	2	3	1	2	1	0	-1	0.02	0.00	-0.05
2043496	2023-11-05 03:45:00	34	0	1.45	4.50	7.20	1.47	4.40	6.90	4	6	7	6	5	7	10	11	14	4	3	0	14	3	2	1	1	2	3	1	-1	-1	0.02	-0.10	-0.30
2043495	2024-04-02 00:00:00	34	1	3.85	3.45	1.88	4.30	3.55	1.87	1	0	6	5	1	2	6	1	8	3	8	1	9	2	3	1	2	1	3	1	1	-1	0.45	0.10	-0.01
2043494	2024-03-31 01:00:00	34	3	2.84	3.05	2.51	3.00	3.10	2.51	2	1	1	2	2	2	4	3	3	1	2	2	5	1	2	2	3	1	1	1	1	0	0.16	0.05	0.00
2043493	2024-04-02 02:45:00	34	3	1.20	6.60	15.00	1.21	6.40	14.00	3	2	4	4	4	4	7	6	8	3	4	2	10	2	3	1	2	1	3	1	-1	-1	0.01	-0.20	-1.00
2043492	2023-10-28 21:00:00	34	1	2.56	3.50	2.47	2.56	3.55	2.44	0	2	2	0	1	2	0	3	4	5	2	1	5	3	2	1	1	2	3	0	1	-1	0.00	0.05	-0.03
2043491	2024-03-30 22:00:00	34	1	1.96	3.40	3.60	1.96	3.50	3.90	1	0	0	0	2	1	1	2	1	2	1	2	3	2	1	2	1	3	1	0	1	1	0.00	0.10	0.30
2043490	2023-10-30 03:45:00	34	1	2.20	3.45	3.30	2.26	3.40	3.15	0	1	2	2	1	1	2	2	3	1	1	0	3	2	2	1	1	1	3	1	-1	-1	0.06	-0.05	-0.15
2043489	2024-03-31 03:45:00	34	0	2.64	3.30	2.51	2.82	3.40	2.49	5	0	1	3	1	3	8	1	4	0	7	4	8	1	3	2	3	1	2	1	1	-1	0.18	0.10	-0.02
2043551	2024-03-03 22:00:00	34	1	2.25	3.45	3.15	2.25	3.45	3.15	0	0	0	0	1	1	0	1	1	1	0	0	1	3	1	1	1	2	2	0	0	0	0.00	0.00	0.00
2236066	2024-08-20 00:30:00	34	0	3.65	3.50	1.93	3.75	3.75	1.94	3	2	3	2	4	5	5	6	8	8	7	5	13	3	2	1	1	2	3	1	1	1	0.10	0.25	0.01
2236067	2024-08-18 00:30:00	34	1	2.92	3.40	2.25	3.35	3.55	2.13	2	1	4	7	3	1	9	4	5	1	6	5	10	1	3	2	3	1	2	1	1	-1	0.43	0.15	-0.12
2043549	2023-11-26 01:00:00	34	0	2.60	3.55	2.61	2.66	3.55	2.56	4	1	4	6	2	3	10	3	7	1	8	4	11	1	3	2	3	1	2	1	0	-1	0.06	0.00	-0.05
2236064	2024-08-18 00:30:00	34	1	5.70	4.00	1.53	6.80	4.15	1.51	1	1	3	4	4	1	5	5	4	0	0	1	5	1	1	3	2	2	1	1	1	-1	1.10	0.15	-0.02
2043548	2024-03-10 22:00:00	34	3	1.42	4.45	6.50	1.43	4.65	7.60	1	1	1	2	3	3	3	4	4	1	0	0	4	3	1	1	1	2	2	1	1	1	0.01	0.20	1.10
2236065	2024-08-19 02:45:00	34	3	1.44	4.20	7.00	1.42	4.45	8.00	8	4	6	4	9	13	12	13	19	7	6	0	19	3	2	1	1	2	3	-1	1	1	-0.02	0.25	1.00
2043547	2024-03-03 22:00:00	34	0	2.13	3.35	3.55	2.13	3.35	3.55	0	0	0	0	1	1	0	1	1	1	0	0	1	3	1	1	1	2	2	0	0	0	0.00	0.00	0.00
2236070	2024-08-27 00:30:00	34	1	2.16	3.35	3.15	2.23	3.40	3.25	2	2	5	4	2	4	6	4	9	4	6	1	10	2	3	1	2	1	3	1	1	1	0.07	0.05	0.10
2043546	2024-03-04 01:00:00	34	0	1.99	3.35	3.55	2.00	3.45	3.85	4	0	2	3	1	4	7	1	6	2	8	3	9	1	3	2	3	1	2	1	1	1	0.01	0.10	0.30
2236071	2024-08-25 00:30:00	34	3	4.30	3.95	1.68	4.85	4.05	1.68	3	0	2	5	3	1	8	3	3	1	6	6	9	1	2	2	3	1	1	1	1	0	0.55	0.10	0.00
2236068	2024-08-19 00:30:00	34	3	4.80	3.65	1.76	5.00	3.70	1.72	0	0	3	4	1	0	4	1	3	0	3	1	4	1	3	2	3	1	2	1	1	-1	0.20	0.05	-0.04
2043544	2023-11-27 03:45:00	34	1	3.25	3.30	2.26	3.15	3.20	2.38	5	3	0	4	2	5	9	5	5	4	8	8	13	1	2	2	3	1	1	-1	-1	1	-0.10	-0.10	0.12
2236069	2024-08-26 02:45:00	34	0	1.47	4.30	7.30	1.45	4.30	7.60	6	3	4	6	4	8	12	7	12	1	6	1	13	1	3	1	2	1	2	-1	0	1	-0.02	0.00	0.30
2236074	2024-08-26 00:30:00	34	3	2.95	3.25	2.31	3.25	3.25	2.29	4	1	3	4	1	3	8	2	6	1	7	3	9	1	3	2	3	1	2	1	0	-1	0.30	0.00	-0.02
2236075	2024-08-26 02:45:00	34	3	1.95	3.45	3.65	1.98	3.45	3.95	2	3	3	4	3	3	6	6	6	5	5	5	11	1	1	1	1	1	1	1	0	1	0.03	0.00	0.30
2043541	2023-11-26 19:30:00	34	1	2.72	3.35	2.42	2.72	3.35	2.42	3	0	2	2	1	2	5	1	4	0	4	1	5	1	3	2	3	1	2	0	0	0	0.00	0.00	0.00
2236072	2024-08-26 00:30:00	34	1	1.42	4.35	7.00	1.43	4.50	7.80	1	1	2	2	2	3	3	3	5	2	2	0	5	2	2	1	1	1	3	1	1	1	0.01	0.15	0.80
2043540	2023-11-28 03:45:00	34	3	2.23	3.05	3.25	2.47	3.05	3.15	0	4	10	7	3	7	7	7	17	12	12	2	19	2	2	1	1	1	3	1	0	-1	0.24	0.00	-0.10
2236073	2024-08-25 02:45:00	34	3	1.21	6.40	11.00	1.21	6.40	15.00	2	4	1	2	3	3	4	7	4	8	5	8	12	2	1	2	1	3	1	0	0	1	0.00	0.00	4.00
2043539	2023-11-27 01:00:00	34	3	1.55	3.85	5.70	1.64	3.75	5.80	6	5	8	8	2	9	14	7	17	3	10	0	17	2	3	1	2	1	3	1	-1	1	0.09	-0.10	0.10
2236078	2024-09-01 00:30:00	34	1	1.63	3.80	5.80	1.67	3.75	5.40	0	1	2	2	1	1	2	2	3	1	1	0	3	2	2	1	1	1	3	1	-1	-1	0.04	-0.05	-0.40
2043538	2024-03-10 19:30:00	34	0	2.21	3.10	3.30	2.21	3.10	3.30	0	0	0	0	0	1	0	0	1	1	1	0	1	2	2	1	1	1	3	0	0	0	0.00	0.00	0.00
2236079	2024-09-02 00:30:00	34	0	2.04	3.20	3.60	2.06	3.30	3.80	1	3	2	3	3	2	4	6	4	2	0	2	6	2	1	2	1	3	1	1	1	1	0.02	0.10	0.20
2043537	2023-11-26 03:45:00	34	3	2.08	3.30	3.40	2.11	3.45	3.50	9	2	10	10	4	8	19	6	18	4	17	5	23	1	3	2	3	1	2	1	1	1	0.03	0.15	0.10
2236076	2024-08-25 00:30:00	34	3	3.20	3.10	2.40	3.40	3.15	2.28	3	0	3	4	2	1	7	2	4	1	6	4	8	1	3	2	3	1	2	1	1	-1	0.20	0.05	-0.12
2236077	2024-08-27 02:45:00	34	0	4.35	3.50	1.78	4.65	3.55	1.81	7	4	6	7	4	7	14	8	13	4	10	5	18	1	3	2	3	1	2	1	1	1	0.30	0.05	0.03
2236082	2024-09-02 02:45:00	34	1	1.78	3.50	4.25	1.82	3.60	4.45	3	4	6	5	4	4	8	8	10	2	2	0	10	2	2	1	1	1	3	1	1	1	0.04	0.10	0.20
2043534	2023-11-11 22:00:00	34	1	5.20	3.50	1.66	5.50	3.75	1.66	1	0	1	2	1	0	3	1	1	0	2	2	3	1	2	2	3	1	1	1	1	0	0.30	0.25	0.00
2236083	2024-08-25 02:45:00	34	0	2.47	3.10	2.84	2.56	3.10	2.99	1	0	6	4	0	3	5	0	9	4	9	0	9	2	3	1	2	1	3	1	0	1	0.09	0.00	0.15
2043533	2024-03-09 03:45:00	34	1	1.81	3.40	4.30	1.79	3.50	4.85	8	1	7	5	3	9	13	4	16	5	14	2	18	2	3	1	2	1	3	-1	1	1	-0.02	0.10	0.55
2236080	2024-08-31 02:45:00	34	3	1.64	4.05	4.50	1.57	4.35	5.50	9	0	2	2	6	9	11	6	11	1	6	1	12	1	3	1	2	1	2	-1	1	1	-0.07	0.30	1.00
2043532	2024-03-09 22:00:00	34	3	2.23	3.50	2.88	2.25	3.70	2.99	0	2	2	1	3	2	1	5	4	5	1	2	6	3	1	2	1	3	2	1	1	1	0.02	0.20	0.11
2236081	2024-09-02 00:30:00	34	1	1.68	3.65	4.75	1.70	3.70	5.20	0	1	3	2	2	2	2	3	5	3	2	0	5	3	2	1	1	2	3	1	1	1	0.02	0.05	0.45
2043531	2024-03-17 22:00:00	34	0	4.55	3.75	1.68	5.20	3.80	1.68	1	0	0	2	1	0	3	1	0	0	2	3	3	1	2	3	3	2	1	1	1	0	0.65	0.05	0.00
2236086	2024-09-01 02:45:00	34	3	1.49	4.40	6.60	1.47	4.55	6.60	4	3	6	4	6	7	8	9	13	9	8	4	17	3	2	1	1	2	3	-1	1	0	-0.02	0.15	0.00
2043530	2023-11-12 19:30:00	34	0	1.21	6.00	12.00	1.20	6.10	13.00	5	3	2	4	4	4	9	7	6	3	5	6	12	1	2	3	3	2	1	-1	1	1	-0.01	0.10	1.00
2236087	2024-09-02 02:45:00	34	3	2.09	3.10	3.55	2.20	3.30	3.45	6	2	6	9	2	5	15	4	11	1	12	5	16	1	3	2	3	1	2	1	1	-1	0.11	0.20	-0.10
2236084	2024-09-01 02:45:00	34	1	2.74	3.45	2.53	2.79	3.50	2.47	8	2	3	10	4	1	18	6	4	0	12	14	18	1	2	3	3	2	1	1	1	-1	0.05	0.05	-0.06
2236085	2024-09-01 00:30:00	34	3	2.25	3.10	3.15	2.25	3.20	3.40	1	1	3	2	2	3	3	3	6	5	5	2	8	2	2	1	1	1	3	0	1	1	0.00	0.10	0.25
2043527	2024-03-12 03:45:00	34	0	1.89	3.35	3.95	1.90	3.40	4.35	4	0	4	3	1	7	7	1	11	4	10	0	11	2	3	1	2	1	3	1	1	1	0.01	0.05	0.40
2236090	2024-09-15 02:45:00	34	3	1.28	5.40	9.10	1.28	5.80	11.00	4	2	3	3	6	4	7	8	7	6	5	6	13	2	1	2	1	3	1	0	1	1	0.00	0.40	1.90
2043526	2024-03-11 01:00:00	34	1	2.28	3.30	3.25	2.29	3.30	3.20	1	1	2	1	2	2	2	3	4	2	1	0	4	3	2	1	1	2	3	1	0	-1	0.01	0.00	-0.05
2236091	2024-09-16 00:00:00	34	0	3.95	3.60	1.82	4.35	3.70	1.81	5	1	3	5	2	3	10	3	6	1	8	5	11	1	3	2	3	1	2	1	1	-1	0.40	0.10	-0.01
2236088	2024-08-31 00:30:00	34	0	3.35	3.30	2.08	3.60	3.40	2.09	3	0	4	6	1	2	9	1	6	2	10	5	11	1	3	2	3	1	2	1	1	1	0.25	0.10	0.01
2043524	2023-11-12 01:00:00	34	3	1.38	4.75	8.40	1.41	4.55	7.90	3	3	4	3	4	5	6	7	9	3	2	0	9	3	2	1	1	2	3	1	-1	-1	0.03	-0.20	-0.50
2236089	2024-09-15 21:00:00	34	3	1.82	3.75	3.80	1.82	3.90	4.10	0	0	1	1	1	1	1	1	2	1	1	0	2	2	2	1	1	1	3	0	1	1	0.00	0.15	0.30
2043523	2024-03-11 03:45:00	34	1	2.49	3.25	2.68	2.47	3.30	2.91	4	3	7	5	3	6	9	6	13	4	7	0	13	2	3	1	2	1	3	-1	1	1	-0.02	0.05	0.23
2043522	2024-03-09 22:00:00	34	3	1.85	3.50	3.90	1.84	3.60	4.35	1	1	0	0	1	3	1	2	3	3	2	1	4	3	2	1	1	2	3	-1	1	1	-0.01	0.10	0.45
2236095	2024-09-16 02:45:00	34	1	7.60	4.80	1.41	7.80	4.75	1.41	8	6	5	12	7	6	20	13	11	4	11	13	24	1	2	3	3	2	1	1	-1	0	0.20	-0.05	0.00
2043521	2023-11-13 03:45:00	34	3	1.19	7.20	14.00	1.16	7.80	16.00	6	5	4	5	8	7	11	13	11	5	3	5	16	2	1	2	1	3	1	-1	1	1	-0.03	0.60	2.00
2236092	2024-09-15 00:00:00	34	1	4.85	3.50	1.70	5.50	3.60	1.70	0	0	1	2	2	0	2	2	1	0	0	1	2	1	1	3	2	2	1	1	1	0	0.65	0.10	0.00
2043520	2024-03-16 22:00:00	34	0	2.66	3.00	2.68	2.66	3.05	2.88	2	0	1	1	1	4	3	1	5	2	4	0	5	2	3	1	2	1	3	0	1	1	0.00	0.05	0.20
2043583	2024-02-25 01:00:00	34	0	2.77	3.25	2.44	2.93	3.20	2.51	5	3	0	7	2	2	12	5	2	0	7	10	12	1	2	3	3	2	1	1	-1	1	0.16	-0.05	0.07
2043582	2023-12-10 22:00:00	34	3	2.09	3.25	3.80	2.12	3.25	3.70	0	0	1	1	1	1	1	1	2	1	1	0	2	2	2	1	1	1	3	1	0	-1	0.03	0.00	-0.10
2043581	2024-02-27 01:30:00	34	3	1.97	3.20	3.90	2.01	3.30	4.00	6	2	6	8	2	7	14	4	13	2	12	3	16	1	3	2	3	1	2	1	1	1	0.04	0.10	0.10
2043580	2023-12-09 03:45:00	34	3	2.31	3.25	2.94	2.40	3.20	3.10	2	2	8	8	1	4	10	3	12	5	12	3	15	2	3	1	2	1	3	1	-1	1	0.09	-0.05	0.16
2043579	2024-02-26 03:45:00	34	1	2.31	3.60	2.94	2.44	3.45	2.85	1	3	6	5	1	8	6	4	14	8	10	0	14	2	3	1	2	1	3	1	-1	-1	0.13	-0.15	-0.09
2043578	2023-12-10 03:45:00	34	3	1.27	5.40	9.60	1.28	5.60	10.00	8	2	6	6	5	9	14	7	15	7	14	6	21	2	3	1	2	1	3	1	1	1	0.01	0.20	0.40
2043577	2024-02-26 01:00:00	34	0	6.90	4.45	1.41	7.30	4.45	1.46	7	4	3	6	3	6	13	7	9	1	7	5	14	1	3	2	3	1	2	1	0	1	0.40	0.00	0.05
2043576	2023-12-10 19:30:00	34	1	3.40	3.30	2.21	3.40	3.30	2.21	0	0	0	1	1	0	1	1	0	0	0	1	1	1	1	3	2	2	1	0	0	0	0.00	0.00	0.00
2043575	2023-12-12 01:30:00	34	1	2.44	3.15	2.84	2.63	3.25	2.78	6	3	11	8	4	11	14	7	22	8	15	0	22	2	3	1	2	1	3	1	1	-1	0.19	0.10	-0.06
2043574	2023-12-12 03:45:00	34	3	2.31	3.50	2.77	2.42	3.60	2.79	0	1	6	4	2	6	4	3	12	8	9	0	12	2	3	1	2	1	3	1	1	1	0.11	0.10	0.02
2043573	2024-02-25 03:45:00	34	3	2.28	3.05	3.20	2.36	3.05	3.35	1	1	3	4	1	3	5	2	6	4	7	3	9	2	3	1	2	1	3	1	0	1	0.08	0.00	0.15
2043572	2024-02-27 03:45:00	34	3	2.29	3.10	3.10	2.40	3.20	3.10	2	6	7	4	6	3	6	12	10	12	6	8	18	3	1	2	1	3	2	1	1	0	0.11	0.10	0.00
2043571	2024-02-25 22:00:00	34	1	3.65	3.60	1.89	4.05	3.70	1.88	1	1	1	2	2	0	3	3	1	2	2	4	5	1	1	3	2	2	1	1	1	-1	0.40	0.10	-0.01
2043570	2023-12-10 01:00:00	34	3	2.40	3.25	2.83	2.47	3.35	2.88	0	0	3	1	1	3	1	1	6	5	5	0	6	2	2	1	1	1	3	1	1	1	0.07	0.10	0.05
2043569	2024-02-24 03:45:00	34	3	1.57	3.75	5.70	1.55	3.95	6.70	7	4	9	6	6	8	13	10	17	5	8	1	18	2	3	1	2	1	3	-1	1	1	-0.02	0.20	1.00
2043568	2023-12-11 03:45:00	34	1	2.05	3.25	3.55	2.09	3.35	3.70	4	1	4	6	2	3	10	3	7	2	9	5	12	1	3	2	3	1	2	1	1	1	0.04	0.10	0.15
2043566	2023-12-05 03:45:00	34	3	2.89	3.10	2.44	2.96	3.20	2.51	7	2	1	7	3	3	14	5	4	1	10	11	15	1	2	3	3	2	1	1	1	1	0.07	0.10	0.07
2043564	2023-12-04 03:45:00	34	0	2.73	3.35	2.40	2.79	3.50	2.47	5	1	2	5	2	3	10	3	5	0	7	5	10	1	3	2	3	1	2	1	1	1	0.06	0.15	0.07
2043563	2024-03-03 19:30:00	34	3	2.26	3.35	2.97	2.26	3.35	2.97	0	0	0	0	1	0	0	1	0	1	0	1	1	2	1	2	1	3	1	0	0	0	0.00	0.00	0.00
2043562	2023-12-02 03:45:00	34	0	3.60	3.35	1.98	4.10	3.35	1.97	14	9	21	21	9	15	35	18	36	14	31	13	49	2	3	1	2	1	3	1	0	-1	0.50	0.00	-0.01
2043561	2024-03-02 22:00:00	34	1	1.66	3.70	4.80	1.66	3.80	5.40	1	0	0	0	2	2	1	2	2	1	0	0	2	3	1	1	1	2	2	0	1	1	0.00	0.10	0.60
2043560	2023-12-03 19:30:00	34	1	2.99	3.10	2.36	2.95	3.10	2.40	3	1	0	1	1	1	4	2	1	0	2	3	4	1	2	3	3	2	1	-1	0	1	-0.04	0.00	0.04
2043559	2024-03-03 03:45:00	34	1	2.61	3.15	2.85	2.53	3.15	2.95	2	1	3	2	2	3	4	3	6	2	3	0	6	2	3	1	2	1	3	-1	0	1	-0.08	0.00	0.10
2236059	2024-08-19 00:30:00	34	1	1.93	3.25	3.95	1.93	3.30	4.40	5	1	6	4	2	8	9	3	14	5	11	0	14	2	3	1	2	1	3	0	1	1	0.00	0.05	0.45
2043557	2024-03-04 03:45:00	34	3	2.38	3.15	3.20	2.47	3.10	3.10	0	2	3	3	2	3	3	4	6	4	3	1	7	3	2	1	1	2	3	1	-1	-1	0.09	-0.05	-0.10
2043556	2024-03-03 01:00:00	34	0	3.50	3.45	2.11	3.60	3.40	2.09	1	1	2	3	1	1	4	2	3	1	3	2	5	1	3	2	3	1	2	1	-1	-1	0.10	-0.05	-0.02
2043555	2023-12-02 22:00:00	34	1	1.96	3.30	3.75	2.00	3.40	3.95	2	1	4	3	1	4	5	2	8	3	6	0	8	2	3	1	2	1	3	1	1	1	0.04	0.10	0.20
2236062	2024-08-18 02:45:00	34	1	2.44	3.20	2.80	2.56	3.25	2.85	0	1	4	4	1	2	4	2	6	2	4	0	6	2	3	1	2	1	3	1	1	1	0.12	0.05	0.05
2043554	2024-03-02 03:45:00	34	0	2.99	3.20	2.31	3.15	3.30	2.33	6	2	4	7	3	4	13	5	8	0	8	5	13	1	3	2	3	1	2	1	1	1	0.16	0.10	0.02
2236063	2024-08-20 02:45:00	34	3	1.33	4.70	8.50	1.35	5.00	9.20	1	2	4	3	2	2	4	4	6	2	2	0	6	2	2	1	1	1	3	1	1	1	0.02	0.30	0.70
2043553	2024-03-05 03:45:00	34	3	1.27	5.50	12.00	1.26	5.60	12.00	2	2	3	3	3	4	5	5	7	6	6	4	11	2	2	1	1	1	3	-1	1	0	-0.01	0.10	0.00
2236060	2024-08-18 02:45:00	34	1	1.65	3.80	4.80	1.57	4.05	6.00	6	3	2	2	9	7	8	12	9	6	2	5	14	3	1	2	1	3	2	-1	1	1	-0.08	0.25	1.20
2043552	2023-12-03 03:45:00	34	3	1.44	4.45	6.30	1.44	4.65	7.10	4	2	9	6	6	10	10	8	19	11	13	2	21	2	3	1	2	1	3	0	1	1	0.00	0.20	0.80
2236061	2024-08-19 02:45:00	34	1	3.55	3.45	1.97	4.00	3.45	1.95	3	1	5	5	1	3	8	2	8	1	7	1	9	1	3	1	2	1	2	1	0	-1	0.45	0.00	-0.02
2236130	2024-10-21 02:45:00	34	0	3.75	3.70	1.84	4.35	3.60	1.85	3	3	5	6	1	3	9	4	8	1	6	2	10	1	3	2	3	1	2	1	-1	1	0.60	-0.10	0.01
2043614	2023-12-23 19:30:00	34	0	5.00	3.80	1.62	5.20	3.80	1.60	4	2	1	3	4	0	7	6	1	1	2	7	8	1	2	3	3	2	1	1	0	-1	0.20	0.00	-0.02
2236131	2024-10-21 00:00:00	34	3	2.70	3.10	2.58	2.53	3.05	3.05	8	4	0	5	2	4	13	6	4	0	7	9	13	1	2	3	3	2	1	-1	-1	1	-0.17	-0.05	0.47
2236134	2024-10-19 21:00:00	34	1	3.25	3.10	2.21	3.25	3.10	2.21	0	0	1	1	0	0	1	0	1	0	1	0	1	1	3	1	2	1	2	0	0	0	0.00	0.00	0.00
2043610	2023-12-23 01:30:00	34	0	3.70	3.25	2.00	4.15	3.45	1.93	6	1	7	8	3	5	14	4	12	2	12	4	16	1	3	2	3	1	2	1	1	-1	0.45	0.20	-0.07
2236135	2024-10-20 21:00:00	34	0	2.81	3.30	2.38	3.10	3.25	2.38	1	1	0	1	0	0	2	1	0	0	1	2	2	1	2	3	3	2	1	1	-1	0	0.29	-0.05	0.00
2043609	2023-12-24 03:45:00	34	3	2.81	3.20	2.42	2.58	3.15	2.89	15	1	9	10	0	16	25	1	25	4	28	4	29	1	3	1	2	1	2	-1	-1	1	-0.23	-0.05	0.47
2043608	2023-12-23 22:00:00	34	3	2.72	3.15	2.54	2.72	3.35	2.61	2	1	4	3	3	4	5	4	8	3	4	0	8	2	3	1	2	1	3	0	1	1	0.00	0.20	0.07
2236133	2024-10-20 02:45:00	34	3	2.05	3.25	3.95	2.17	3.05	3.80	1	5	5	7	1	3	8	6	8	3	5	3	11	1	3	1	2	1	2	1	-1	-1	0.12	-0.20	-0.15
2043607	2023-12-17 22:00:00	34	1	2.20	3.60	3.15	2.20	3.60	3.15	0	0	0	0	1	1	0	1	1	1	0	0	1	3	1	1	1	2	2	0	0	0	0.00	0.00	0.00
2236138	2024-10-27 02:45:00	34	3	1.37	4.80	7.10	1.29	5.80	10.00	6	1	4	1	6	8	7	7	12	5	5	0	12	2	2	1	1	1	3	-1	1	1	-0.08	1.00	2.90
2043604	2024-02-19 03:45:00	34	3	4.05	3.65	1.79	4.60	3.65	1.79	4	5	4	8	5	2	12	10	6	1	3	7	13	1	2	3	3	2	1	1	0	0	0.55	0.00	0.00
2236137	2024-10-22 02:45:00	34	0	2.36	3.15	2.93	2.38	3.05	3.30	1	7	5	1	4	7	2	11	12	14	5	4	16	3	2	1	1	2	3	1	-1	1	0.02	-0.10	0.37
2043603	2023-12-17 01:00:00	34	3	1.33	5.10	7.90	1.32	5.20	9.50	2	2	3	1	4	5	3	6	8	5	2	0	8	3	2	1	1	2	3	-1	1	1	-0.01	0.10	1.60
2236142	2024-10-27 22:00:00	34	3	1.52	3.95	5.90	1.51	4.35	6.30	1	0	3	0	2	3	1	2	6	5	4	0	6	3	2	1	1	2	3	-1	1	1	-0.01	0.40	0.40
2043602	2024-02-18 19:30:00	34	0	2.26	3.05	3.25	2.25	3.05	3.25	1	1	1	0	0	2	1	1	3	2	2	0	3	2	2	1	1	1	3	-1	0	0	-0.01	0.00	0.00
2236141	2024-10-28 01:00:00	34	1	1.75	3.30	4.85	1.77	3.60	4.85	3	1	2	2	2	5	5	3	7	2	4	0	7	2	3	1	2	1	3	1	1	0	0.02	0.30	0.00
2043599	2023-12-18 03:45:00	34	0	4.80	3.70	1.75	3.95	3.40	1.99	14	8	6	13	3	12	27	11	18	3	19	12	30	1	3	2	3	1	2	-1	-1	1	-0.85	-0.30	0.24
2236146	2024-10-27 19:30:00	34	1	2.23	3.30	3.05	2.13	3.45	3.45	2	4	0	1	4	4	3	8	4	6	1	5	9	3	1	2	1	3	2	-1	1	1	-0.10	0.15	0.40
2043598	2024-02-19 01:00:00	34	0	3.45	3.75	1.91	3.85	3.80	1.90	1	1	3	4	1	1	5	2	4	2	5	3	7	1	3	2	3	1	2	1	1	-1	0.40	0.05	-0.01
2043597	2023-12-16 03:45:00	34	1	4.55	3.15	1.84	4.45	3.15	1.97	20	7	14	21	3	18	41	10	32	6	37	15	47	1	3	2	3	1	2	-1	0	1	-0.10	0.00	0.13
2236144	2024-10-28 03:45:00	34	3	2.49	3.35	2.86	2.53	3.35	2.80	3	0	4	4	1	4	7	1	8	1	7	0	8	2	3	1	2	1	3	1	0	-1	0.04	0.00	-0.06
2043596	2024-02-18 22:00:00	34	1	3.50	3.35	2.13	3.55	3.35	2.13	0	0	0	2	1	0	2	1	0	0	1	2	2	1	2	3	3	2	1	1	0	0	0.05	0.00	0.00
2236145	2024-10-26 21:00:00	34	3	1.30	5.20	8.20	1.29	5.20	12.00	3	2	7	4	1	5	7	3	12	5	9	0	12	2	3	1	2	1	3	-1	0	1	-0.01	0.00	3.80
2043595	2023-12-17 22:00:00	34	3	1.40	4.55	7.20	1.42	4.55	7.90	0	1	1	1	1	1	1	2	2	2	1	1	3	3	1	1	1	2	2	1	0	1	0.02	0.00	0.70
2236150	2024-11-01 03:45:00	34	3	1.71	3.65	4.50	1.70	3.85	4.95	4	3	6	3	7	5	7	10	11	10	7	6	17	3	2	1	1	2	3	-1	1	1	-0.01	0.20	0.45
2043593	2023-12-18 01:00:00	34	3	2.42	2.89	3.10	2.42	3.00	3.25	1	6	4	1	5	4	2	11	8	10	1	4	12	3	1	2	1	3	2	0	1	1	0.00	0.11	0.15
2236148	2024-10-26 00:30:00	34	3	2.19	3.40	3.05	2.29	3.40	3.15	1	2	5	5	3	3	6	5	8	6	7	4	12	2	3	1	2	1	3	1	0	1	0.10	0.00	0.10
2236149	2024-10-30 03:45:00	34	0	2.36	3.45	2.74	2.53	3.35	2.80	0	5	12	6	4	9	6	9	21	17	14	2	23	3	2	1	1	2	3	1	-1	1	0.17	-0.10	0.06
2236154	2024-10-31 01:30:00	34	0	6.80	4.40	1.41	7.30	4.50	1.45	18	11	14	23	13	15	41	24	29	1	18	13	42	1	3	2	3	1	2	1	1	1	0.50	0.10	0.04
2043590	2024-02-18 22:00:00	34	1	1.89	3.40	3.85	1.89	3.50	4.25	1	0	0	0	1	1	1	1	1	1	1	1	2	1	1	1	1	1	1	0	1	1	0.00	0.10	0.40
2236155	2024-11-01 01:30:00	34	0	4.10	3.55	1.80	4.55	3.60	1.81	5	3	5	7	2	5	12	5	10	1	8	3	13	1	3	2	3	1	2	1	1	1	0.45	0.05	0.01
2043589	2023-12-17 19:30:00	34	3	1.59	3.95	5.00	1.59	3.95	5.10	3	1	1	2	3	4	5	4	5	1	2	1	6	1	3	1	2	1	2	0	0	1	0.00	0.00	0.10
2236152	2024-10-30 01:30:00	34	0	2.88	3.15	2.42	3.00	3.15	2.51	5	3	0	4	4	2	9	7	2	1	3	8	10	1	2	3	3	2	1	1	0	1	0.12	0.00	0.09
2236153	2024-11-01 03:45:00	34	0	2.62	3.35	2.51	2.78	3.30	2.58	10	1	5	10	2	6	20	3	11	0	17	9	20	1	3	2	3	1	2	1	-1	1	0.16	-0.05	0.07
2043587	2023-12-09 22:00:00	34	1	3.70	3.35	1.96	4.10	3.40	1.95	0	2	3	4	3	1	4	5	4	2	1	2	6	2	1	2	1	3	1	1	1	-1	0.40	0.05	-0.01
2043585	2024-02-25 19:30:00	34	3	1.30	5.20	8.60	1.30	5.10	8.50	2	2	7	2	1	5	4	3	12	8	9	0	12	2	3	1	2	1	3	0	-1	-1	0.00	-0.10	-0.10
2236156	2024-10-31 03:45:00	34	1	1.39	4.65	6.90	1.44	4.85	6.70	7	5	10	6	10	11	13	15	21	10	8	2	23	3	2	1	1	2	3	1	1	-1	0.05	0.20	-0.20
2043584	2024-02-24 22:00:00	34	0	2.17	3.35	3.15	2.17	3.50	3.30	0	0	0	0	1	2	0	1	2	2	1	0	2	3	2	1	1	2	3	0	1	1	0.00	0.15	0.15
2043647	2024-01-07 22:00:00	34	0	2.98	3.15	2.35	3.20	3.20	2.35	1	0	0	1	1	0	2	1	0	0	1	2	2	1	2	3	3	2	1	1	1	0	0.22	0.05	0.00
2236098	2024-09-17 00:30:00	34	0	2.25	3.25	3.05	2.49	3.35	2.87	0	2	9	5	2	5	5	4	14	9	10	0	14	2	3	1	2	1	3	1	1	-1	0.24	0.10	-0.18
2043646	2024-01-07 22:00:00	34	3	2.91	3.20	2.53	2.91	3.20	2.53	0	0	0	1	1	0	1	1	0	0	0	1	1	1	1	3	2	2	1	0	0	0	0.00	0.00	0.00
2236099	2024-09-25 02:45:00	34	0	1.50	4.25	6.00	1.49	4.40	6.40	2	2	4	3	4	4	5	6	8	6	5	3	11	3	2	1	1	2	3	-1	1	1	-0.01	0.15	0.40
2043645	2024-01-07 03:45:00	34	3	2.90	3.55	2.20	3.00	3.60	2.28	6	2	1	2	2	6	8	4	7	3	7	4	11	1	3	2	3	1	2	1	1	1	0.10	0.05	0.08
2236096	2024-09-17 02:45:00	34	3	1.64	3.85	5.50	1.62	3.90	5.70	3	0	2	1	2	5	4	2	7	3	5	0	7	2	3	1	2	1	3	-1	1	1	-0.02	0.05	0.20
2043644	2024-01-08 01:00:00	34	0	7.60	4.40	1.39	7.20	4.35	1.47	7	5	4	9	4	5	16	9	9	1	8	8	17	1	2	2	3	1	1	-1	-1	1	-0.40	-0.05	0.08
2043643	2024-01-07 01:00:00	34	1	2.21	3.20	3.20	2.25	3.25	3.35	0	0	1	1	2	1	1	2	2	2	1	1	3	3	1	1	1	2	2	1	1	1	0.04	0.05	0.15
2236102	2024-09-22 18:30:00	34	3	2.28	3.25	3.00	2.33	3.20	2.94	0	1	1	1	1	0	1	2	1	1	0	1	2	2	1	2	1	3	1	1	-1	-1	0.05	-0.05	-0.06
2043642	2024-01-06 19:30:00	34	3	1.15	6.80	15.00	1.15	6.90	15.00	1	1	1	0	2	1	1	3	2	2	0	1	3	3	1	2	1	3	2	0	1	0	0.00	0.10	0.00
2236103	2024-09-23 02:45:00	34	0	1.69	3.95	4.30	1.67	3.95	5.10	3	7	6	1	6	11	4	13	17	16	7	3	20	3	2	1	1	2	3	-1	0	1	-0.02	0.00	0.80
2043641	2024-01-06 22:00:00	34	0	2.66	3.35	2.46	2.66	3.35	2.66	0	1	0	0	0	2	0	1	2	2	1	0	2	3	2	1	1	2	3	0	0	1	0.00	0.00	0.20
2236100	2024-09-23 00:00:00	34	3	1.65	3.70	4.95	1.60	3.90	5.90	1	3	3	0	6	5	1	9	8	9	1	2	10	3	1	2	1	3	2	-1	1	1	-0.05	0.20	0.95
2043640	2024-01-07 19:30:00	34	0	4.55	3.90	1.65	5.20	4.05	1.64	2	0	1	3	2	0	5	2	1	0	3	4	5	1	2	3	3	2	1	1	1	-1	0.65	0.15	-0.01
2236101	2024-09-21 00:30:00	34	0	2.28	3.15	3.10	2.23	3.25	3.40	6	4	6	5	4	10	11	8	16	8	11	3	19	2	3	1	2	1	3	-1	1	1	-0.05	0.10	0.30
2043639	2024-01-06 03:45:00	34	1	2.04	3.00	3.90	2.03	3.10	4.30	11	1	10	14	3	11	25	4	21	3	24	7	28	1	3	2	3	1	2	-1	1	1	-0.01	0.10	0.40
2236106	2024-09-22 21:00:00	34	0	2.98	3.05	2.40	3.10	3.20	2.42	6	1	0	9	3	1	15	4	1	0	11	14	15	1	2	3	3	2	1	1	1	1	0.12	0.15	0.02
2043638	2024-01-08 03:45:00	34	1	2.36	3.30	3.10	2.40	3.25	3.05	1	2	1	2	2	1	3	4	2	4	3	5	7	2	1	3	2	3	1	1	-1	-1	0.04	-0.05	-0.05
2236107	2024-09-21 21:00:00	34	3	3.05	3.15	2.31	3.15	3.25	2.36	1	0	0	2	1	1	3	1	1	0	2	2	3	1	2	2	3	1	1	1	1	1	0.10	0.10	0.05
2043637	2023-12-31 01:00:00	34	0	1.96	3.40	3.65	1.99	3.45	3.90	2	1	2	3	1	3	5	2	5	1	4	1	6	1	3	1	2	1	2	1	1	1	0.03	0.05	0.25
2236104	2024-09-22 00:00:00	34	1	2.26	3.15	3.15	2.26	3.30	3.30	0	1	2	1	2	1	1	3	3	4	2	2	5	3	1	1	1	2	2	0	1	1	0.00	0.15	0.15
2043636	2023-12-30 22:00:00	34	3	3.35	3.05	2.21	3.55	3.15	2.21	1	0	1	2	1	0	3	1	1	0	2	2	3	1	2	2	3	1	1	1	1	0	0.20	0.10	0.00
2043635	2023-12-30 01:30:00	34	1	1.67	3.80	4.60	1.67	3.90	5.10	2	2	6	4	3	5	6	5	11	7	8	2	13	2	3	1	2	1	3	0	1	1	0.00	0.10	0.50
2236110	2024-09-29 21:00:00	34	3	1.39	4.50	7.30	1.40	4.80	7.70	1	0	3	2	1	3	3	1	6	3	5	0	6	2	3	1	2	1	3	1	1	1	0.01	0.30	0.40
2043634	2023-12-30 03:45:00	34	3	1.72	3.60	4.50	1.67	3.80	5.30	5	1	7	2	5	7	7	6	14	7	8	0	14	2	3	1	2	1	3	-1	1	1	-0.05	0.20	0.80
2236111	2024-09-29 02:45:00	34	1	2.71	3.25	2.47	2.92	3.25	2.49	4	2	1	7	1	1	11	3	2	1	9	10	12	1	2	3	3	2	1	1	0	1	0.21	0.00	0.02
2043633	2023-12-31 03:45:00	34	3	2.09	2.97	3.80	2.12	3.05	4.00	5	2	6	5	2	8	10	4	14	5	11	1	15	2	3	1	2	1	3	1	1	1	0.03	0.08	0.20
2043632	2023-12-30 03:45:00	34	1	4.90	3.55	1.68	5.60	3.65	1.67	7	2	2	8	3	2	15	5	4	4	14	15	19	1	2	3	3	2	1	1	1	-1	0.70	0.10	-0.01
2236109	2024-09-28 02:45:00	34	3	1.36	4.65	7.60	1.34	5.30	8.60	5	3	9	1	7	12	6	10	21	17	13	2	23	3	2	1	1	2	3	-1	1	1	-0.02	0.65	1.00
2043631	2023-12-30 01:30:00	34	3	2.17	3.15	3.30	2.23	3.15	3.50	2	2	3	3	2	3	5	4	6	5	6	4	10	2	3	1	2	1	3	1	0	1	0.06	0.00	0.20
2236114	2024-09-29 00:00:00	34	0	5.00	3.40	1.70	5.60	3.50	1.70	3	3	3	5	4	3	8	7	6	3	4	5	11	1	2	3	3	2	1	1	1	0	0.60	0.10	0.00
2043630	2023-12-30 22:00:00	34	1	2.07	3.35	3.35	2.07	3.45	3.60	1	0	0	0	1	2	1	1	2	1	1	0	2	2	2	1	1	1	3	0	1	1	0.00	0.10	0.25
2043629	2023-12-30 19:30:00	34	3	1.42	4.30	7.20	1.42	4.50	8.10	2	1	1	1	5	4	3	6	5	3	0	1	6	3	1	2	1	3	2	0	1	1	0.00	0.20	0.90
2043628	2023-12-31 01:00:00	34	3	1.46	4.45	6.00	1.51	4.45	6.10	2	2	3	5	1	4	7	3	7	1	5	1	8	1	3	1	2	1	2	1	0	1	0.05	0.00	0.10
2236113	2024-09-30 00:00:00	34	1	3.15	3.15	2.23	3.40	3.25	2.23	1	1	0	1	1	1	2	2	1	0	0	1	2	1	1	3	2	2	1	1	1	0	0.25	0.10	0.00
2236118	2024-09-29 18:30:00	34	0	2.68	3.15	2.58	2.73	3.15	2.53	3	0	3	4	0	3	7	0	6	0	7	1	7	1	3	2	3	1	2	1	0	-1	0.05	0.00	-0.05
2043625	2023-12-24 01:00:00	34	3	2.36	3.35	3.05	2.42	3.30	3.00	0	1	1	1	1	2	1	2	3	2	1	0	3	3	2	1	1	2	3	1	-1	-1	0.06	-0.05	-0.05
2236116	2024-10-01 02:45:00	34	0	2.13	3.50	3.05	2.16	3.60	3.25	3	1	3	2	2	4	5	3	7	4	6	2	9	2	3	1	2	1	3	1	1	1	0.03	0.10	0.20
2236117	2024-09-28 21:00:00	34	0	6.40	4.20	1.47	7.50	4.45	1.44	5	1	7	10	5	3	15	6	10	1	10	6	16	1	3	2	3	1	2	1	1	-1	1.10	0.25	-0.03
2236122	2024-10-06 02:45:00	34	3	1.30	5.10	9.10	1.33	5.30	9.10	1	1	3	2	2	3	3	3	6	3	3	0	6	2	2	1	1	1	3	1	1	0	0.03	0.20	0.00
2043622	2023-12-23 22:00:00	34	1	1.77	3.40	4.50	1.75	3.55	5.10	1	0	1	0	2	2	1	2	3	2	1	0	3	3	2	1	1	2	3	-1	1	1	-0.02	0.15	0.60
2236123	2024-10-06 18:30:00	34	1	1.33	4.55	9.40	1.34	4.50	8.90	4	6	8	5	4	4	9	10	12	5	4	2	14	3	2	1	1	2	3	1	-1	-1	0.01	-0.05	-0.50
2043621	2023-12-23 01:30:00	34	0	2.19	3.30	3.10	2.28	3.40	3.15	0	3	4	2	3	3	2	6	7	5	1	0	7	3	2	1	1	2	3	1	1	1	0.09	0.10	0.05
2236120	2024-10-06 00:00:00	34	3	1.47	4.20	6.20	1.52	4.35	6.20	1	3	3	4	3	3	5	6	6	1	0	0	6	3	1	1	1	2	2	1	1	0	0.05	0.15	0.00
2043620	2023-12-23 03:45:00	34	1	6.90	4.65	1.40	7.20	4.55	1.46	17	8	8	13	7	12	30	15	20	1	16	11	31	1	3	2	3	1	2	1	-1	1	0.30	-0.10	0.06
2236121	2024-10-07 02:45:00	34	3	2.90	3.55	2.20	3.20	3.60	2.17	1	3	3	6	3	0	7	6	3	2	3	6	9	1	2	3	3	2	1	1	1	-1	0.30	0.05	-0.03
2043619	2023-12-24 01:00:00	34	3	1.23	5.90	9.90	1.23	6.10	14.00	2	3	3	3	4	4	5	7	7	3	1	1	8	3	1	1	1	2	2	0	1	1	0.00	0.20	4.10
2043618	2023-12-23 03:45:00	34	0	2.69	3.35	2.44	2.84	3.30	2.53	3	4	0	6	2	2	9	6	2	0	3	7	9	1	2	3	3	2	1	1	-1	1	0.15	-0.05	0.09
2236124	2024-10-06 21:00:00	34	3	1.60	3.80	5.20	1.60	3.90	5.90	0	1	1	1	1	1	1	2	2	1	0	0	2	3	1	1	1	2	2	0	1	1	0.00	0.10	0.70
2236125	2024-10-07 00:00:00	34	1	3.90	3.30	1.92	4.20	3.40	1.93	5	1	4	5	2	5	10	3	9	0	7	1	10	1	3	2	3	1	2	1	1	1	0.30	0.10	0.01
2043679	2024-01-21 22:00:00	34	3	2.68	3.25	2.49	2.82	3.40	2.49	1	2	0	3	2	0	4	4	0	0	0	4	4	1	1	3	2	2	1	1	1	0	0.14	0.15	0.00
2236195	2024-12-02 03:45:00	34	1	4.75	3.35	1.75	5.40	3.30	1.79	7	4	3	8	3	5	15	7	8	1	9	8	16	1	3	2	3	1	2	1	-1	1	0.65	-0.05	0.04
2236192	2024-11-30 03:45:00	34	3	1.97	3.50	3.50	2.00	3.45	3.85	9	5	11	9	5	12	18	10	23	16	24	11	34	2	3	1	2	1	3	1	-1	1	0.03	-0.05	0.35
2043676	2024-01-21 03:45:00	34	0	3.65	3.55	1.90	4.25	3.55	1.88	16	12	14	20	10	14	36	22	28	9	23	17	45	1	3	2	3	1	2	1	0	-1	0.60	0.00	-0.02
2236193	2024-11-30 22:00:00	34	1	2.08	3.10	3.60	2.14	3.25	3.65	2	3	7	8	2	5	10	5	12	3	8	1	13	2	3	1	2	1	3	1	1	1	0.06	0.15	0.05
2236198	2024-12-01 19:30:00	34	0	1.99	3.25	3.70	2.00	3.35	4.00	1	0	0	1	1	2	2	1	2	1	2	1	3	1	3	1	2	1	2	1	1	1	0.01	0.10	0.30
2236199	2024-12-07 03:45:00	34	3	2.01	3.55	3.30	2.16	3.55	3.25	17	8	16	20	6	14	37	14	30	10	33	17	47	1	3	2	3	1	2	1	0	-1	0.15	0.00	-0.05
2236196	2024-12-01 22:00:00	34	0	4.85	3.20	1.78	5.30	3.35	1.78	2	1	3	5	1	2	7	2	5	0	5	2	7	1	3	2	3	1	2	1	1	0	0.45	0.15	0.00
2236197	2024-12-01 22:00:00	34	3	4.15	3.55	1.80	4.65	3.75	1.76	1	1	4	5	3	1	6	4	5	1	3	2	7	1	3	2	3	1	2	1	1	-1	0.50	0.20	-0.04
2236202	2024-12-07 22:00:00	34	1	2.42	3.05	2.97	2.42	3.05	3.20	0	1	3	0	2	2	0	3	5	5	2	0	5	3	2	1	1	2	3	0	0	1	0.00	0.00	0.23
2236203	2024-12-07 01:30:00	34	3	1.17	7.10	12.00	1.20	7.00	13.00	6	9	3	7	7	3	13	16	6	8	5	15	21	2	1	3	2	3	1	1	-1	1	0.03	-0.10	1.00
2236200	2024-12-08 03:45:00	34	3	1.55	3.90	5.60	1.63	3.85	5.70	7	7	15	13	6	9	20	13	24	4	11	0	24	2	3	1	2	1	3	1	-1	1	0.08	-0.05	0.10
2236201	2024-12-08 19:30:00	34	3	1.50	4.25	5.60	1.52	4.45	6.00	1	0	1	1	2	2	2	2	3	2	2	1	4	2	2	1	1	1	3	1	1	1	0.02	0.20	0.40
2236206	2024-12-09 03:45:00	34	0	1.90	3.35	3.90	1.94	3.45	4.05	3	3	6	4	5	2	7	8	8	7	6	6	14	3	1	1	1	2	2	1	1	1	0.04	0.10	0.15
2043666	2024-02-23 03:45:00	34	0	2.29	2.90	3.35	2.53	2.99	3.10	0	6	8	8	5	4	8	11	12	9	6	5	17	3	2	1	1	2	3	1	1	-1	0.24	0.09	-0.25
2236207	2024-12-08 22:00:00	34	0	2.51	2.90	2.97	2.51	2.82	3.15	0	10	2	0	5	7	0	15	9	15	0	6	15	3	1	2	1	3	2	0	-1	1	0.00	-0.08	0.18
2043665	2024-02-29 01:00:00	34	0	3.70	3.75	1.84	4.15	3.90	1.81	2	1	5	6	3	2	8	4	7	2	6	3	10	1	3	2	3	1	2	1	1	-1	0.45	0.15	-0.03
2236204	2024-12-08 01:00:00	34	1	1.70	3.45	5.00	1.73	3.45	5.50	1	3	3	2	4	3	3	7	6	7	3	4	10	3	1	2	1	3	2	1	0	1	0.03	0.00	0.50
2043664	2024-01-22 01:00:00	34	0	3.75	3.15	2.14	3.60	3.15	2.21	3	2	0	3	3	2	6	5	2	2	3	6	8	1	2	3	3	2	1	-1	0	1	-0.15	0.00	0.07
2236205	2024-12-10 03:45:00	34	0	2.53	3.00	2.84	2.69	2.99	2.91	5	5	12	9	4	8	14	9	20	8	13	2	22	2	3	1	2	1	3	1	-1	1	0.16	-0.01	0.07
2043663	2024-01-21 01:00:00	34	3	1.45	4.05	7.20	1.45	4.25	7.80	3	2	3	2	4	5	5	6	8	3	2	0	8	3	2	1	1	2	3	0	1	1	0.00	0.20	0.60
2236210	2024-12-15 22:00:00	34	3	2.66	3.05	2.64	2.75	3.10	2.54	0	1	2	1	1	0	1	2	2	2	1	1	3	3	1	1	1	2	2	1	1	-1	0.09	0.05	-0.10
2043662	2024-01-28 22:00:00	34	1	2.42	3.30	2.76	2.42	3.40	2.93	0	0	0	0	1	2	0	1	2	2	1	0	2	3	2	1	1	2	3	0	1	1	0.00	0.10	0.17
2236211	2024-12-14 22:00:00	34	0	5.20	4.20	1.54	6.70	4.55	1.47	2	1	5	5	3	3	7	4	8	2	5	1	9	2	3	1	2	1	3	1	1	-1	1.50	0.35	-0.07
2043661	2024-01-30 03:45:00	34	0	4.75	3.65	1.68	5.40	3.70	1.68	2	1	2	5	2	2	7	3	4	0	4	3	7	1	3	2	3	1	2	1	1	0	0.65	0.05	0.00
2236208	2024-12-16 03:45:00	34	1	1.45	4.25	6.40	1.52	4.15	6.50	1	5	7	5	2	3	6	7	10	5	4	1	11	3	2	1	1	2	3	1	-1	1	0.07	-0.10	0.10
2043660	2024-01-28 22:00:00	34	3	2.21	3.50	2.93	2.21	3.65	3.10	0	0	1	0	2	2	0	2	3	3	1	0	3	3	2	1	1	2	3	0	1	1	0.00	0.15	0.17
2236209	2024-12-09 01:00:00	34	1	2.80	3.40	2.51	2.78	3.20	2.66	8	7	0	10	5	3	18	12	3	0	6	15	18	1	2	3	3	2	1	-1	-1	1	-0.02	-0.20	0.15
2043659	2024-01-28 03:45:00	34	1	1.72	3.55	4.60	1.76	3.60	4.90	1	5	6	3	4	7	4	9	13	10	5	1	14	3	2	1	1	2	3	1	1	1	0.04	0.05	0.30
2236214	2024-12-17 03:45:00	34	0	3.50	3.40	2.12	3.65	3.35	2.09	4	2	5	6	2	7	10	4	12	7	13	5	17	2	3	1	2	1	3	1	-1	-1	0.15	-0.05	-0.03
2043658	2024-01-29 01:00:00	34	1	2.28	3.05	3.15	2.28	3.10	3.45	1	3	1	1	2	3	2	5	4	4	1	2	6	3	1	2	1	3	2	0	1	1	0.00	0.05	0.30
2236215	2024-12-15 03:45:00	34	1	1.31	4.75	9.90	1.40	4.55	8.80	10	13	16	15	10	14	25	23	30	14	16	9	39	2	3	1	2	1	3	1	-1	-1	0.09	-0.20	-1.10
2043657	2024-01-28 01:00:00	34	1	1.30	5.00	9.00	1.28	5.40	12.00	3	1	1	1	3	4	4	4	5	1	1	0	5	2	2	1	1	1	3	-1	1	1	-0.02	0.40	3.00
2236212	2024-12-16 01:00:00	34	3	3.05	3.35	2.19	3.50	3.30	2.17	5	1	8	8	0	6	13	1	14	1	13	0	14	2	3	1	2	1	3	1	-1	-1	0.45	-0.05	-0.02
2043656	2024-01-28 19:30:00	34	3	2.11	3.00	3.65	2.09	3.10	4.00	2	3	2	3	2	3	5	5	5	3	3	3	8	1	1	1	1	1	1	-1	1	1	-0.02	0.10	0.35
2236213	2024-12-14 03:45:00	34	0	2.66	2.85	2.83	2.78	2.86	2.94	9	5	15	14	6	12	23	11	27	7	19	3	30	2	3	1	2	1	3	1	1	1	0.12	0.01	0.11
2043655	2024-02-04 22:00:00	34	3	1.39	4.40	7.50	1.46	4.40	7.30	5	3	6	8	1	3	13	4	9	2	11	6	15	1	3	2	3	1	2	1	0	-1	0.07	0.00	-0.20
2236218	2024-12-15 01:00:00	34	0	5.00	3.55	1.76	4.80	3.50	1.80	2	1	1	2	1	2	4	2	3	0	2	1	4	1	3	2	3	1	2	-1	-1	1	-0.20	-0.05	0.04
2043654	2024-02-06 03:45:00	34	3	1.49	4.30	6.80	1.47	4.35	7.20	7	4	7	7	6	11	14	10	18	4	8	0	18	2	3	1	2	1	3	-1	1	1	-0.02	0.05	0.40
2236219	2024-12-22 19:30:00	34	3	1.56	4.25	4.95	1.52	4.45	6.00	2	0	6	1	4	5	3	4	11	8	7	0	11	3	2	1	1	2	3	-1	1	1	-0.04	0.20	1.05
2043653	2024-02-03 03:45:00	34	3	3.70	3.30	2.09	3.35	3.30	2.23	6	4	0	4	5	3	10	9	3	2	3	9	12	1	2	3	3	2	1	-1	0	1	-0.35	0.00	0.14
2236216	2024-12-15 19:30:00	34	3	2.49	2.99	2.91	2.42	2.95	3.15	1	3	3	2	3	4	3	6	7	5	2	1	8	3	2	1	1	2	3	-1	-1	1	-0.07	-0.04	0.24
2043652	2024-02-05 03:45:00	34	3	1.83	3.40	4.75	1.89	3.35	4.50	2	2	6	7	2	3	9	4	9	2	7	2	11	1	3	1	2	1	2	1	-1	-1	0.06	-0.05	-0.25
2236217	2024-12-15 22:00:00	34	0	1.87	3.65	3.70	1.89	3.60	4.10	1	1	1	2	1	2	3	2	3	2	3	2	5	1	3	1	2	1	2	1	-1	1	0.02	-0.05	0.40
2043651	2024-02-04 01:00:00	34	0	4.25	4.05	1.68	4.90	4.05	1.67	2	1	2	3	2	1	5	3	3	0	2	2	5	1	2	2	3	1	1	1	0	-1	0.65	0.00	-0.01
2236222	2024-12-22 01:00:00	34	0	4.95	3.50	1.69	5.40	3.65	1.69	2	0	2	4	1	1	6	1	3	1	6	4	7	1	3	2	3	1	2	1	1	0	0.45	0.15	0.00
2043650	2024-02-03 22:00:00	34	1	2.81	3.05	2.51	3.00	3.10	2.53	2	2	0	5	1	1	7	3	1	0	4	6	7	1	2	3	3	2	1	1	1	1	0.19	0.05	0.02
2236223	2024-12-24 03:45:00	34	3	1.22	6.10	10.00	1.29	5.80	9.80	11	18	12	16	14	11	27	32	23	15	10	19	42	2	1	3	2	3	1	1	-1	-1	0.07	-0.30	-0.20
2043649	2024-02-04 03:45:00	34	3	1.75	3.65	4.85	1.72	3.70	5.00	2	1	4	3	3	5	5	4	9	5	6	1	10	2	3	1	2	1	3	-1	1	1	-0.03	0.05	0.15
2236220	2024-12-23 01:00:00	34	3	1.26	5.60	9.80	1.30	5.40	10.00	2	2	3	4	2	4	6	4	7	3	5	2	9	2	3	1	2	1	3	1	-1	1	0.04	-0.20	0.20
2043648	2024-02-05 01:00:00	34	3	2.06	3.25	3.50	2.09	3.30	3.70	2	2	3	3	3	2	5	5	5	5	5	5	10	1	1	1	1	1	1	1	1	1	0.03	0.05	0.20
2236221	2024-12-24 01:30:00	34	0	1.60	3.85	5.10	1.61	4.05	5.50	4	1	5	4	3	5	8	4	10	2	6	0	10	2	3	1	2	1	3	1	1	1	0.01	0.20	0.40
2236162	2024-11-05 03:45:00	34	3	1.50	4.40	6.40	1.50	4.35	6.50	0	1	2	1	1	2	1	2	4	3	2	0	4	3	2	1	1	2	3	0	-1	1	0.00	-0.05	0.10
2236163	2024-11-03 03:45:00	34	0	4.60	3.70	1.69	5.50	3.95	1.63	5	4	3	7	6	2	12	10	5	2	4	9	14	1	2	3	3	2	1	1	1	-1	0.90	0.25	-0.06
2236160	2024-11-02 22:00:00	34	3	1.62	3.70	6.10	1.62	3.70	6.10	0	0	0	0	1	1	0	1	1	1	0	0	1	3	1	1	1	2	2	0	0	0	0.00	0.00	0.00
2236161	2024-11-04 03:45:00	34	3	1.17	6.90	12.00	1.18	7.40	16.00	0	2	1	1	3	2	1	5	3	5	1	3	6	3	1	2	1	3	2	1	1	1	0.01	0.50	4.00
2236166	2024-11-03 22:00:00	34	0	2.98	3.35	2.25	3.20	3.35	2.29	2	3	0	3	3	1	5	6	1	2	1	6	7	2	1	3	2	3	1	1	0	1	0.22	0.00	0.04
2236167	2024-11-03 01:00:00	34	0	3.75	3.20	2.00	4.40	3.40	1.90	5	0	7	8	3	5	13	3	12	3	13	4	16	1	3	2	3	1	2	1	1	-1	0.65	0.20	-0.10
2236164	2024-11-05 01:30:00	34	0	1.87	3.60	3.75	1.87	3.75	4.05	4	3	4	3	6	5	7	9	9	6	4	4	13	3	1	1	1	2	2	0	1	1	0.00	0.15	0.30
2236165	2024-11-03 19:30:00	34	0	2.08	3.40	3.25	2.17	3.55	3.25	1	1	4	4	2	2	5	3	6	5	7	4	10	2	3	1	2	1	3	1	1	0	0.09	0.15	0.00
2236170	2024-11-10 19:30:00	34	3	1.36	4.70	7.50	1.36	5.00	8.20	3	2	5	3	4	5	6	6	10	6	6	2	12	2	2	1	1	1	3	0	1	1	0.00	0.30	0.70
2236171	2024-11-10 01:00:00	34	1	5.40	4.25	1.59	5.10	4.20	1.62	8	6	7	7	6	9	15	12	16	3	6	2	18	2	3	1	2	1	3	-1	-1	1	-0.30	-0.05	0.03
2236168	2024-11-04 01:00:00	34	3	4.10	3.45	1.84	4.35	3.60	1.85	6	2	8	8	4	7	14	6	15	2	10	1	16	2	3	1	2	1	3	1	1	1	0.25	0.15	0.01
2236169	2024-11-10 22:00:00	34	0	2.12	3.25	3.35	2.13	3.30	3.60	3	1	2	3	1	3	6	2	5	1	5	2	7	1	3	2	3	1	2	1	1	1	0.01	0.05	0.25
2236174	2024-11-10 03:45:00	34	3	1.56	3.80	6.90	1.57	3.80	6.60	2	1	3	3	2	4	5	3	7	3	5	1	8	2	3	1	2	1	3	1	0	-1	0.01	0.00	-0.30
2043698	2024-01-29 03:45:00	34	0	3.65	3.50	1.91	4.00	3.55	1.93	15	7	18	19	6	14	34	13	32	7	28	9	41	1	3	2	3	1	2	1	1	1	0.35	0.05	0.02
2236175	2024-11-11 03:45:00	34	1	1.83	3.60	3.90	1.81	3.80	4.30	7	3	7	4	7	9	11	10	16	6	7	1	17	2	3	1	2	1	3	-1	1	1	-0.02	0.20	0.40
2236172	2024-11-10 22:00:00	34	3	1.42	4.45	6.60	1.46	4.45	7.10	0	2	5	4	1	2	4	3	7	4	5	1	8	2	3	1	2	1	3	1	0	1	0.04	0.00	0.50
2043696	2024-01-27 22:00:00	34	3	1.51	4.15	5.70	1.51	4.30	6.40	1	1	0	1	1	2	2	2	2	2	2	2	4	1	1	1	1	1	1	0	1	1	0.00	0.15	0.70
2043695	2024-02-03 22:00:00	34	1	2.28	3.30	2.96	2.25	3.45	3.20	1	1	1	0	3	4	1	4	5	7	4	3	8	3	2	1	1	2	3	-1	1	1	-0.03	0.15	0.24
2043694	2024-02-04 19:30:00	34	1	1.48	3.85	7.00	1.48	3.85	7.00	0	1	1	1	0	0	1	1	1	0	0	0	1	1	1	1	1	1	1	0	0	0	0.00	0.00	0.00
2236179	2024-11-24 01:00:00	34	1	2.17	3.20	3.25	2.21	3.20	3.50	3	3	3	2	2	7	5	5	10	5	5	0	10	2	2	1	1	1	3	1	0	1	0.04	0.00	0.25
2043692	2024-01-14 01:00:00	34	3	2.21	3.25	3.10	2.21	3.30	3.40	1	1	2	2	1	3	3	2	5	4	5	2	7	2	3	1	2	1	3	0	1	1	0.00	0.05	0.30
2236177	2024-11-11 01:00:00	34	0	4.15	3.45	1.82	4.35	3.55	1.85	9	6	6	9	9	4	18	15	10	4	7	12	22	1	2	3	3	2	1	1	1	1	0.20	0.10	0.03
2043691	2024-01-13 22:00:00	34	3	1.33	5.00	7.60	1.34	5.10	9.30	0	0	0	1	1	2	1	1	2	1	1	0	2	2	2	1	1	1	3	1	1	1	0.01	0.10	1.70
2236182	2024-11-26 01:30:00	34	1	2.75	2.88	2.71	3.10	2.88	2.63	4	8	9	9	7	7	13	15	16	8	6	5	21	3	2	1	1	2	3	1	0	-1	0.35	0.00	-0.08
2043690	2024-01-14 03:45:00	34	0	6.60	4.30	1.50	7.40	4.45	1.45	1	1	4	5	4	3	6	5	7	3	4	2	9	2	3	1	2	1	3	1	1	-1	0.80	0.15	-0.05
2236183	2024-11-25 01:00:00	34	3	1.75	3.55	4.40	1.83	3.45	4.70	5	7	11	7	5	10	12	12	21	11	11	2	23	2	2	1	1	1	3	1	-1	1	0.08	-0.10	0.30
2043689	2024-01-15 03:45:00	34	3	2.13	3.30	3.60	2.38	3.25	3.10	3	1	4	4	1	4	7	2	8	2	7	1	9	2	3	1	2	1	3	1	-1	-1	0.25	-0.05	-0.50
2236180	2024-11-24 22:00:00	34	0	2.98	3.25	2.28	3.40	3.25	2.23	0	1	4	5	1	0	5	2	4	1	4	2	6	1	3	2	3	1	2	1	0	-1	0.42	0.00	-0.05
2043688	2024-01-14 19:30:00	34	3	1.66	3.55	5.10	1.66	3.65	5.80	0	1	0	0	1	2	0	2	2	2	0	0	2	3	1	1	1	2	2	0	1	1	0.00	0.10	0.70
2236181	2024-11-24 19:30:00	34	1	2.56	3.15	2.69	2.53	3.10	3.00	2	1	1	1	0	5	3	1	6	3	5	0	6	2	3	1	2	1	3	-1	-1	1	-0.03	-0.05	0.31
2043687	2024-01-17 03:45:00	34	3	1.37	4.70	7.30	1.35	4.90	9.50	9	7	14	8	10	13	17	17	27	10	10	0	27	2	2	1	1	1	3	-1	1	1	-0.02	0.20	2.20
2236186	2024-11-24 22:00:00	34	1	2.05	3.00	3.85	2.06	3.00	4.30	1	2	1	1	3	2	2	5	3	5	2	4	7	3	1	2	1	3	2	1	0	1	0.01	0.00	0.45
2043686	2024-01-13 22:00:00	34	1	2.74	2.95	2.66	2.98	2.99	2.63	2	3	1	4	3	2	6	6	3	1	1	4	7	1	1	3	2	2	1	1	1	-1	0.24	0.04	-0.03
2236187	2024-11-24 03:45:00	34	0	4.25	4.00	1.68	4.85	4.20	1.65	7	3	6	8	5	6	15	8	12	2	9	5	17	1	3	2	3	1	2	1	1	-1	0.60	0.20	-0.03
2043685	2024-01-14 22:00:00	34	3	3.05	3.15	2.47	3.05	3.15	2.47	0	0	0	1	1	0	1	1	0	0	0	1	1	1	1	3	2	2	1	0	0	0	0.00	0.00	0.00
2236184	2024-11-25 03:45:00	34	3	1.85	3.40	4.10	1.89	3.35	4.50	4	1	7	7	0	6	11	1	13	2	12	0	13	2	3	1	2	1	3	1	-1	1	0.04	-0.05	0.40
2043684	2024-01-15 01:00:00	34	1	1.66	3.70	4.85	1.68	3.75	5.40	0	2	1	1	2	3	1	4	4	5	2	2	6	3	1	1	1	2	2	1	1	1	0.02	0.05	0.55
2236185	2024-11-26 03:45:00	34	0	2.31	3.35	3.15	2.28	3.35	3.20	1	2	2	2	3	2	3	5	4	4	2	3	7	3	1	2	1	3	2	-1	0	1	-0.03	0.00	0.05
2043683	2024-01-16 03:45:00	34	3	1.43	4.60	6.20	1.41	4.70	7.80	9	4	11	7	6	13	16	10	24	11	17	3	27	2	3	1	2	1	3	-1	1	1	-0.02	0.10	1.60
2236190	2024-12-03 03:45:00	34	0	3.05	3.35	2.21	3.35	3.30	2.25	4	4	4	7	3	4	11	7	8	1	5	4	12	1	3	2	3	1	2	1	-1	1	0.30	-0.05	0.04
2043682	2024-01-22 03:45:00	34	0	5.40	3.45	1.66	4.80	3.40	1.82	8	3	2	6	3	6	14	6	8	1	9	7	15	1	3	2	3	1	2	-1	-1	1	-0.60	-0.05	0.16
2236191	2024-12-01 03:45:00	34	3	1.73	3.70	4.35	1.94	3.35	4.25	10	10	14	14	5	15	24	15	29	7	16	2	31	2	3	1	2	1	3	1	-1	-1	0.21	-0.35	-0.10
2043681	2024-02-29 03:45:00	34	3	1.64	3.95	4.65	1.62	4.05	5.40	6	3	7	6	4	8	12	7	15	6	11	3	18	2	3	1	2	1	3	-1	1	1	-0.02	0.10	0.75
2236188	2024-11-23 22:00:00	34	0	6.70	4.80	1.39	8.20	5.00	1.37	4	3	2	6	4	2	10	7	4	1	4	7	11	1	2	3	3	2	1	1	1	-1	1.50	0.20	-0.02
2043680	2024-01-21 19:30:00	34	3	2.36	3.30	2.85	2.36	3.30	2.84	0	0	3	0	0	4	0	0	7	7	7	0	7	2	2	1	1	1	3	0	0	-1	0.00	0.00	-0.01
2236189	2024-12-01 01:00:00	34	3	1.32	4.75	9.00	1.34	5.10	9.50	6	3	9	4	7	10	10	10	19	9	9	0	19	2	2	1	1	1	3	1	1	1	0.02	0.35	0.50
2236259	2025-01-16 03:45:00	34	1	1.47	4.20	6.20	1.50	4.20	7.00	2	4	7	5	4	9	7	8	16	13	12	4	20	3	2	1	1	2	3	1	0	1	0.03	0.00	0.80
1853273	2023-06-05 03:00:00	34	3	1.84	3.70	4.25	1.79	3.70	4.50	5	1	5	6	2	8	11	3	13	2	10	0	13	2	3	1	2	1	3	-1	0	1	-0.05	0.00	0.25
2236263	2025-01-05 03:45:00	34	1	2.91	2.96	2.51	3.05	3.00	2.58	6	6	0	4	10	2	10	16	2	7	1	15	17	2	1	3	2	3	1	1	1	1	0.14	0.04	0.07
2236260	2025-01-05 19:30:00	34	0	2.38	3.15	2.90	2.38	3.30	3.05	0	0	3	0	2	3	0	2	6	6	4	0	6	3	2	1	1	2	3	0	1	1	0.00	0.15	0.15
2236261	2025-01-05 22:00:00	34	1	2.66	2.90	2.78	2.66	3.00	2.93	0	1	1	1	1	2	1	2	3	2	1	0	3	3	2	1	1	2	3	0	1	1	0.00	0.10	0.15
2236266	2025-01-04 22:00:00	34	1	2.28	3.10	3.15	2.31	3.10	3.40	6	4	6	6	5	8	12	9	14	6	9	4	18	2	3	1	2	1	3	1	0	1	0.03	0.00	0.25
2236267	2025-01-06 03:45:00	34	3	2.42	3.10	3.20	2.66	3.15	2.81	3	0	6	5	1	6	8	1	12	4	11	0	12	2	3	1	2	1	3	1	1	-1	0.24	0.05	-0.39
2236264	2025-01-06 01:00:00	34	1	1.86	3.55	4.35	1.91	3.45	4.25	3	3	6	6	2	6	9	5	12	4	8	1	13	2	3	1	2	1	3	1	-1	-1	0.05	-0.10	-0.10
2236265	2025-01-12 03:45:00	34	1	1.34	5.30	8.70	1.36	5.20	8.40	10	10	18	11	10	20	21	20	38	18	19	1	39	2	3	1	2	1	3	1	-1	-1	0.02	-0.10	-0.30
2236271	2025-01-13 01:00:00	34	1	2.66	3.10	2.61	2.75	3.15	2.72	10	0	7	7	1	10	17	1	17	0	16	0	17	1	3	1	2	1	2	1	1	1	0.09	0.05	0.11
2236268	2025-01-11 22:00:00	34	0	2.05	3.10	3.70	1.95	3.15	4.55	4	0	5	4	1	5	8	1	10	4	11	2	12	2	3	1	2	1	3	-1	1	1	-0.10	0.05	0.85
2236269	2025-01-12 19:30:00	34	3	1.97	3.40	3.60	1.98	3.45	3.95	0	0	0	1	1	2	1	1	2	2	2	1	3	2	2	1	1	1	3	1	1	1	0.01	0.05	0.35
2236274	2025-01-13 03:45:00	34	3	1.24	5.80	10.00	1.24	6.00	13.00	3	6	3	5	4	5	8	10	8	6	4	6	14	2	1	2	1	3	1	0	1	1	0.00	0.20	3.00
2236275	2025-01-11 22:00:00	34	1	4.85	3.90	1.62	5.30	4.00	1.63	4	1	0	3	2	1	7	3	1	0	4	6	7	1	2	3	3	2	1	1	1	1	0.45	0.10	0.01
2236272	2025-01-11 03:45:00	34	1	1.80	3.50	4.20	1.95	3.50	3.95	10	8	15	14	7	11	24	15	26	6	15	4	30	2	3	1	2	1	3	1	0	-1	0.15	0.00	-0.25
2236273	2025-01-14 03:45:00	34	3	3.65	3.40	1.96	4.15	3.35	1.97	8	4	10	13	3	9	21	7	19	3	17	5	24	1	3	2	3	1	2	1	-1	1	0.50	-0.05	0.01
2236278	2025-01-19 03:45:00	34	0	2.33	3.15	2.99	2.42	3.15	3.15	0	5	3	3	3	4	3	8	7	7	2	3	10	3	1	2	1	3	2	1	0	1	0.09	0.00	0.16
2236279	2025-01-18 22:00:00	34	3	1.62	3.75	5.10	1.61	3.90	5.80	3	0	0	1	3	2	4	3	2	0	1	2	4	1	2	3	3	2	1	-1	1	1	-0.01	0.15	0.70
2236276	2025-01-12 01:00:00	34	1	4.35	3.10	1.89	4.75	3.10	1.94	10	1	8	10	0	10	20	1	18	1	20	3	21	1	3	2	3	1	2	1	0	1	0.40	0.00	0.05
2236277	2025-01-12 22:00:00	34	0	8.30	5.00	1.31	9.00	5.20	1.34	11	5	6	12	6	5	23	11	11	0	12	12	23	1	2	2	3	1	1	1	1	1	0.70	0.20	0.03
2236282	2025-01-20 03:45:00	34	3	1.23	6.20	13.00	1.27	5.80	11.00	3	6	3	7	4	2	10	10	5	4	4	9	14	1	1	3	2	2	1	1	-1	-1	0.04	-0.40	-2.00
2236283	2025-01-19 19:30:00	34	1	1.76	3.40	4.60	1.76	3.45	5.20	1	2	5	3	2	4	4	4	9	6	6	1	10	2	2	1	1	1	3	0	1	1	0.00	0.05	0.60
2236280	2025-01-21 03:45:00	34	3	2.17	3.20	3.25	2.12	3.45	3.50	5	1	8	4	4	7	9	5	15	9	13	3	18	2	3	1	2	1	3	-1	1	1	-0.05	0.25	0.25
2236281	2025-01-19 22:00:00	34	3	1.98	3.30	3.65	1.95	3.40	4.15	5	0	3	3	2	5	8	2	8	1	7	1	9	1	3	1	2	1	2	-1	1	1	-0.03	0.10	0.50
2236286	2025-01-20 01:00:00	34	0	4.45	3.50	1.76	4.55	3.70	1.79	3	2	2	3	3	3	6	5	5	2	3	3	8	1	2	2	3	1	1	1	1	1	0.10	0.20	0.03
2236287	2025-01-18 03:45:00	34	3	1.52	4.10	6.80	1.52	4.05	6.90	3	2	4	2	2	7	5	4	11	6	7	0	11	2	3	1	2	1	3	0	-1	1	0.00	-0.05	0.10
2236284	2025-01-19 01:00:00	34	3	2.20	3.10	3.30	2.38	3.20	3.15	5	2	6	6	1	6	11	3	12	2	10	1	13	2	3	1	2	1	3	1	1	-1	0.18	0.10	-0.15
2236285	2025-01-19 22:00:00	34	1	2.17	3.55	2.98	2.26	3.50	3.10	1	1	2	1	0	3	2	1	5	3	4	0	5	2	3	1	2	1	3	1	-1	1	0.09	-0.05	0.12
2236226	2024-12-21 22:00:00	34	0	3.25	2.80	2.40	3.45	2.91	2.40	0	1	0	1	2	0	1	3	0	2	0	3	3	2	1	3	2	3	1	1	1	0	0.20	0.11	0.00
2236227	2024-12-22 22:00:00	34	3	2.44	3.40	2.67	2.44	3.45	2.86	1	0	2	1	2	3	2	2	5	3	3	0	5	2	2	1	1	1	3	0	1	1	0.00	0.05	0.19
2236224	2024-12-22 03:45:00	34	0	5.00	3.80	1.62	5.50	4.00	1.62	5	3	6	6	5	5	11	8	11	4	7	4	15	1	3	1	2	1	2	1	1	0	0.50	0.20	0.00
2236225	2024-12-23 03:45:00	34	0	6.10	3.70	1.62	5.90	3.65	1.65	2	1	0	2	1	2	4	2	2	0	2	2	4	1	2	2	3	1	1	-1	-1	1	-0.20	-0.05	0.03
2236230	2024-12-31 03:45:00	34	0	1.52	3.95	6.00	1.47	4.30	7.30	4	2	4	2	8	6	6	10	10	7	3	3	13	3	1	1	1	2	2	-1	1	1	-0.05	0.35	1.30
2236231	2024-12-29 01:00:00	34	0	5.90	4.80	1.43	7.60	4.85	1.40	7	3	5	11	4	2	18	7	7	1	12	12	19	1	2	2	3	1	1	1	1	-1	1.70	0.05	-0.03
2236228	2024-12-21 03:45:00	34	0	4.55	3.75	1.68	5.10	3.95	1.66	6	7	4	9	7	4	15	14	8	7	8	14	22	1	2	3	3	2	1	1	1	-1	0.55	0.20	-0.02
2236229	2024-12-30 03:45:00	34	1	2.28	3.40	2.88	2.31	3.20	3.25	3	2	4	5	0	5	8	2	9	2	8	1	10	2	3	1	2	1	3	1	-1	1	0.03	-0.20	0.37
2236234	2024-12-30 01:00:00	34	1	1.95	3.40	3.65	1.95	3.25	4.35	4	3	4	4	1	7	8	4	11	5	9	2	13	2	3	1	2	1	3	0	-1	1	0.00	-0.15	0.70
2090870	2023-10-08 00:00:00	34	3	2.02	3.10	3.85	1.93	3.30	4.35	4	2	2	1	4	4	5	6	6	3	2	2	8	3	1	1	1	2	2	-1	1	1	-0.09	0.20	0.50
2236235	2024-12-29 03:45:00	34	1	2.74	3.45	2.36	3.05	3.20	2.42	9	7	0	7	4	2	16	11	2	7	12	21	23	1	2	3	3	2	1	1	-1	1	0.31	-0.25	0.06
2236232	2024-12-31 01:30:00	34	3	1.78	3.60	4.20	1.73	3.50	5.40	3	3	3	2	2	4	5	5	7	3	3	1	8	2	2	1	1	1	3	-1	-1	1	-0.05	-0.10	1.20
2236233	2024-12-28 22:00:00	34	0	2.47	2.93	3.00	2.47	2.93	3.30	0	2	0	0	2	2	0	4	2	5	1	3	5	3	1	2	1	3	2	0	0	1	0.00	0.00	0.30
2236238	2024-12-29 19:30:00	34	1	2.29	3.00	3.20	2.29	3.00	3.55	0	2	1	1	2	2	1	4	3	4	1	2	5	3	1	2	1	3	2	0	0	1	0.00	0.00	0.35
2236239	2025-01-15 03:45:00	34	1	2.05	3.20	3.55	2.14	3.10	3.85	13	8	13	16	6	14	29	14	27	12	27	14	41	1	3	2	3	1	2	1	-1	1	0.09	-0.10	0.30
2236236	2024-12-28 22:00:00	34	3	2.25	3.25	3.05	2.33	3.50	2.99	0	0	4	3	1	2	3	1	6	3	5	0	6	2	3	1	2	1	3	1	1	-1	0.08	0.25	-0.06
2236237	2024-12-29 22:00:00	34	3	1.28	5.60	8.40	1.25	5.90	12.00	4	1	1	0	3	6	4	4	7	4	4	1	8	2	2	1	1	1	3	-1	1	1	-0.03	0.30	3.60
2236242	2025-01-15 01:30:00	34	0	3.35	3.45	2.02	3.80	3.50	2.00	8	5	11	9	5	11	17	10	22	6	13	1	23	2	3	1	2	1	3	1	1	-1	0.45	0.05	-0.02
2236251	2025-01-05 01:00:00	34	0	2.92	3.10	2.40	2.94	3.15	2.56	8	0	10	10	1	10	18	1	20	3	20	1	21	2	3	1	2	1	3	1	1	1	0.02	0.05	0.16
2045797	2023-09-18 00:00:00	34	3	2.40	3.55	2.63	2.42	3.60	2.79	2	2	2	2	2	5	4	4	7	3	3	0	7	2	2	1	1	1	3	1	1	1	0.02	0.05	0.16
2236288	2025-01-26 19:30:00	34	3	1.30	5.40	8.20	1.29	5.80	9.40	1	1	1	1	1	2	2	2	3	1	1	0	3	2	2	1	1	1	3	-1	1	1	-0.01	0.40	1.20
2236289	2025-01-25 22:00:00	34	0	3.90	3.55	1.85	4.10	3.75	1.86	2	1	1	3	3	2	5	4	3	2	3	4	7	1	2	3	3	2	1	1	1	1	0.20	0.20	0.01
2236294	2025-01-26 01:00:00	34	3	2.17	3.10	3.35	2.21	3.10	3.65	2	0	4	6	0	3	8	0	7	3	11	4	11	1	3	2	3	1	2	1	0	1	0.04	0.00	0.30
2236295	2025-01-25 03:45:00	34	3	2.20	3.10	3.30	2.26	3.05	3.60	2	4	6	4	2	6	6	6	12	7	7	1	13	2	2	1	1	1	3	1	-1	1	0.06	-0.05	0.30
2236292	2025-01-27 03:45:00	34	0	2.01	3.45	3.80	2.09	3.40	3.60	5	2	4	8	1	3	13	3	7	2	12	8	15	1	3	2	3	1	2	1	-1	-1	0.08	-0.05	-0.20
2236296	2025-01-26 22:00:00	34	0	3.05	3.25	2.26	3.30	3.25	2.26	2	0	0	1	0	1	3	0	1	0	3	2	3	1	3	2	3	1	2	1	0	0	0.25	0.00	0.00
2236307	2025-02-09 22:00:00	34	3	1.87	3.65	3.70	1.90	3.70	3.90	2	1	2	2	2	3	4	3	5	1	2	0	5	2	3	1	2	1	3	1	1	1	0.03	0.05	0.20
1853352	2023-06-05 03:00:00	34	3	2.00	3.35	3.60	1.86	3.60	4.30	13	1	3	3	4	12	16	5	15	4	15	5	20	1	3	2	3	1	2	-1	1	1	-0.14	0.25	0.70
2236310	2025-02-11 03:45:00	34	3	1.46	4.50	7.00	1.46	4.50	6.90	5	4	5	7	5	7	12	9	12	1	4	1	13	1	3	1	2	1	2	0	0	-1	0.00	0.00	-0.10
2236311	2025-02-09 22:00:00	34	3	1.34	4.75	8.30	1.36	5.10	8.40	3	0	2	1	5	3	4	5	5	1	0	0	5	3	1	1	1	2	2	1	1	1	0.02	0.35	0.10
2236308	2025-02-08 03:45:00	34	0	3.40	3.35	2.06	3.80	3.30	2.07	5	2	7	6	2	5	11	4	12	7	14	6	18	2	3	1	2	1	3	1	-1	1	0.40	-0.05	0.01
2236313	2025-02-10 03:45:00	34	1	1.40	4.25	7.40	1.46	4.30	7.50	6	11	10	8	8	13	14	19	23	11	6	2	25	3	2	1	1	2	3	1	1	1	0.06	0.05	0.10
2236316	2025-02-08 22:00:00	34	0	5.50	4.20	1.51	6.00	4.35	1.53	1	0	0	1	1	1	2	1	1	0	1	1	2	1	2	2	3	1	1	1	1	1	0.50	0.15	0.02
2236317	2025-02-09 19:30:00	34	0	4.15	3.70	1.75	4.35	3.95	1.76	1	2	2	3	2	1	4	4	3	1	1	2	5	1	1	3	2	2	1	1	1	1	0.20	0.25	0.01
1853397	2023-06-04 00:30:00	34	0	2.58	3.45	2.68	2.63	3.50	2.61	1	0	7	4	2	3	5	2	10	5	8	0	10	2	3	1	2	1	3	1	1	-1	0.05	0.05	-0.07
2173984	2024-03-13 03:00:00	35	0	3.70	3.70	1.73	4.60	4.10	1.70	9	7	6	11	14	2	20	21	8	7	6	19	27	2	1	3	2	3	1	1	1	-1	0.90	0.40	-0.03
2088602	2023-09-19 00:00:00	35	3	1.10	7.40	13.00	1.12	7.00	11.00	4	3	3	4	4	2	8	7	5	1	2	4	9	1	2	3	3	2	1	1	-1	-1	0.02	-0.40	-2.00
2088600	2023-09-19 02:00:00	35	1	1.11	7.10	13.00	1.07	8.40	15.00	4	2	3	1	5	4	5	7	7	5	3	3	10	3	1	1	1	2	2	-1	1	1	-0.04	1.30	2.00
2138922	2024-02-22 02:00:00	35	3	1.16	6.90	8.20	1.17	6.60	8.60	6	8	14	6	8	14	12	16	28	17	13	1	29	3	2	1	1	2	3	1	-1	1	0.01	-0.30	0.40
2088591	2023-12-13 16:00:00	35	3	1.44	4.40	5.00	1.39	4.60	5.50	12	13	14	14	13	13	26	26	27	2	2	1	28	2	2	1	1	1	3	-1	1	1	-0.05	0.20	0.50
2285106	2024-12-04 02:00:00	35	3	1.10	7.80	12.00	1.13	6.90	11.00	1	7	3	4	1	2	5	8	5	3	0	3	8	2	1	2	1	3	1	1	-1	-1	0.03	-0.90	-1.00
2285107	2024-12-03 16:00:00	35	0	3.75	3.85	1.68	4.00	3.95	1.62	0	0	2	2	2	0	2	2	2	1	1	1	3	1	1	1	1	1	1	1	1	-1	0.25	0.10	-0.06
2088588	2023-11-07 18:00:00	35	3	2.18	3.20	2.94	2.19	3.20	2.85	8	1	9	9	1	8	17	2	17	1	16	1	18	1	3	1	2	1	2	1	0	-1	0.01	0.00	-0.09
2285108	2024-12-03 18:00:00	35	3	2.20	3.20	2.82	2.20	3.20	2.83	2	0	2	1	0	3	3	0	5	3	6	1	6	2	3	1	2	1	3	0	0	1	0.00	0.00	0.01
2285109	2024-12-03 20:00:00	35	1	1.51	4.00	4.80	1.55	3.90	4.50	0	1	2	1	0	1	1	1	3	3	3	1	4	2	2	1	1	1	3	1	-1	-1	0.04	-0.10	-0.30
2088583	2023-12-12 17:30:00	35	1	1.33	4.70	6.30	1.41	4.35	5.50	4	7	8	8	4	4	12	11	12	1	2	1	13	1	3	1	2	1	2	1	-1	-1	0.08	-0.35	-0.80
2088581	2023-11-29 20:00:00	35	3	2.25	3.25	2.75	2.17	3.30	2.79	5	4	6	2	5	2	7	9	8	5	3	4	12	3	1	2	1	3	2	-1	1	1	-0.08	0.05	0.04
2088580	2023-11-08 18:00:00	35	3	2.25	3.30	2.68	2.36	3.30	2.55	1	0	2	2	0	1	3	0	3	1	4	1	4	1	3	1	2	1	2	1	0	-1	0.11	0.00	-0.13
2138939	2024-02-23 02:00:00	35	3	1.24	6.00	9.80	1.28	5.50	8.20	2	7	9	6	2	2	8	9	11	4	3	1	12	3	2	1	1	2	3	1	-1	-1	0.04	-0.50	-1.60
2173629	2024-03-06 18:00:00	35	0	2.25	3.40	2.62	2.37	3.40	2.47	1	2	4	3	1	2	4	3	6	3	4	1	7	2	3	1	2	1	3	1	0	-1	0.12	0.00	-0.15
2088577	2023-10-25 18:00:00	35	3	1.87	3.40	3.45	2.11	3.25	2.96	4	5	9	8	4	5	12	9	14	3	6	1	15	2	3	1	2	1	3	1	-1	-1	0.24	-0.15	-0.49
2173630	2024-03-13 18:00:00	35	3	1.58	3.90	4.25	1.58	3.95	4.20	1	0	1	0	1	1	1	1	2	1	1	0	2	2	2	1	1	1	3	0	1	-1	0.00	0.05	-0.05
2284928	2024-10-22 00:00:00	35	3	2.01	3.20	3.25	2.03	3.15	3.20	0	1	1	2	1	0	2	2	1	2	2	3	4	1	1	3	2	2	1	1	-1	-1	0.02	-0.05	-0.05
2284929	2024-10-22 00:00:00	35	0	5.20	4.25	1.45	6.10	4.50	1.37	4	5	8	11	8	4	15	13	12	3	5	6	18	1	2	3	3	2	1	1	1	-1	0.90	0.25	-0.08
2284934	2024-11-04 22:00:00	35	1	2.11	3.35	2.89	2.13	3.35	2.84	1	0	2	1	1	0	2	1	2	0	1	0	2	1	3	1	2	1	2	1	0	-1	0.02	0.00	-0.05
2284933	2024-10-23 18:00:00	35	0	2.45	3.20	2.50	2.50	3.20	2.45	2	0	3	2	0	1	4	0	4	0	4	0	4	1	3	1	2	1	2	1	0	-1	0.05	0.00	-0.05
2224392	2024-08-13 20:00:00	35	1	2.18	3.20	2.75	2.12	3.20	2.99	7	2	7	8	2	7	15	4	14	1	12	2	16	1	3	2	3	1	2	-1	0	1	-0.06	0.00	0.24
2284947	2024-11-26 00:00:00	35	0	4.30	4.40	1.51	5.10	4.05	1.52	4	4	1	2	2	3	6	6	4	0	0	2	6	1	1	3	2	2	1	1	-1	1	0.80	-0.35	0.01
2186259	2024-04-17 18:00:00	35	3	2.07	3.40	2.91	2.14	3.35	2.83	2	2	4	2	2	2	4	4	6	3	3	1	7	2	2	1	1	1	3	1	-1	-1	0.07	-0.05	-0.08
2186258	2024-04-24 18:00:00	35	3	2.19	3.30	2.78	2.19	3.35	2.75	0	0	2	1	1	0	1	1	2	1	1	0	2	2	2	1	1	1	3	0	1	-1	0.00	0.05	-0.03
2284945	2024-11-25 22:00:00	35	0	3.40	3.85	1.74	3.30	3.85	1.80	3	2	3	4	3	4	7	5	7	1	3	1	8	1	3	1	2	1	2	-1	0	1	-0.10	0.00	0.06
2284950	2024-11-27 00:00:00	35	1	4.70	4.65	1.45	4.95	4.65	1.47	7	4	4	8	4	5	15	8	9	0	7	6	15	1	3	2	3	1	2	1	0	1	0.25	0.00	0.02
2284951	2024-11-26 18:00:00	35	3	1.35	5.10	5.40	1.34	5.10	5.70	4	2	1	1	3	4	5	5	5	1	1	1	6	1	1	1	1	1	1	-1	0	1	-0.01	0.00	0.30
2285080	2024-12-03 00:00:00	35	1	1.75	3.85	3.45	1.79	3.80	3.35	0	2	3	1	1	1	1	3	4	3	1	0	4	3	2	1	1	2	3	1	-1	-1	0.04	-0.05	-0.10
2173983	2024-03-06 02:00:00	35	3	1.43	4.30	5.60	1.45	4.45	6.10	18	11	14	14	16	20	32	27	34	9	14	7	41	2	3	1	2	1	3	1	1	1	0.02	0.15	0.50
2285084	2024-12-03 02:00:00	35	0	1.42	4.85	4.75	1.43	4.80	4.60	6	5	6	6	6	4	12	11	10	1	2	3	13	1	2	3	3	2	1	1	-1	-1	0.01	-0.05	-0.15
2284642	2024-12-04 18:00:00	35	3	1.23	5.50	8.40	1.24	5.50	7.70	1	0	2	1	1	2	2	1	4	2	3	0	4	2	3	1	2	1	3	1	0	-1	0.01	0.00	-0.70
2284643	2024-11-06 18:00:00	35	3	1.56	3.85	4.60	1.59	3.80	4.40	0	1	1	1	1	0	1	2	1	1	0	1	2	2	1	2	1	3	1	1	-1	-1	0.03	-0.05	-0.20
2284641	2024-10-22 20:00:00	35	1	2.97	3.60	1.98	2.94	3.65	1.98	5	3	5	5	6	4	10	9	9	4	5	5	14	1	2	2	3	1	1	-1	1	0	-0.03	0.05	0.00
2089433	2023-12-05 02:00:00	35	3	1.93	3.35	3.30	1.97	3.35	3.20	5	2	4	4	2	5	9	4	9	2	7	2	11	1	3	1	2	1	2	1	0	-1	0.04	0.00	-0.10
2138984	2024-02-20 18:00:00	35	1	2.12	3.20	2.98	2.20	3.20	2.83	0	0	3	2	0	1	2	0	4	2	4	0	4	2	3	1	2	1	3	1	0	-1	0.08	0.00	-0.15
2224745	2024-08-07 00:15:00	35	1	2.14	3.15	2.98	2.16	3.20	2.87	1	1	4	1	2	1	2	3	5	6	5	3	8	3	2	1	1	2	3	1	1	-1	0.02	0.05	-0.11
2284906	2024-09-17 18:00:00	35	3	2.74	3.35	2.19	2.82	3.30	2.17	10	2	10	11	2	10	21	4	20	1	18	2	22	1	3	2	3	1	2	1	-1	-1	0.08	-0.05	-0.02
2089430	2023-11-28 00:00:00	35	0	8.50	5.20	1.23	10.00	6.30	1.15	7	7	11	12	11	6	19	18	17	1	2	3	20	1	2	3	3	2	1	1	1	-1	1.50	1.10	-0.08
2138985	2024-02-21 17:00:00	35	0	3.15	3.45	1.95	3.15	3.40	1.96	4	1	4	4	1	2	8	2	6	0	6	2	8	1	3	2	3	1	2	0	-1	1	0.00	-0.05	0.01
2138986	2024-02-20 16:00:00	35	0	1.48	4.30	4.70	1.44	4.40	5.00	4	2	2	2	3	4	6	5	6	0	1	0	6	1	3	1	2	1	2	-1	1	1	-0.04	0.10	0.30
2089428	2023-11-06 20:00:00	35	3	6.10	4.00	1.42	4.70	3.70	1.56	9	8	7	7	7	8	16	15	15	1	2	2	17	1	2	2	3	1	1	-1	-1	1	-1.40	-0.30	0.14
2138987	2024-02-21 19:00:00	35	1	1.30	5.00	6.60	1.29	5.00	6.70	3	2	4	3	3	4	6	5	8	2	3	0	8	2	3	1	2	1	3	-1	0	1	-0.01	0.00	0.10
2089427	2023-10-24 00:00:00	35	3	1.10	8.00	12.00	1.14	6.90	10.00	1	2	2	2	1	0	3	3	2	1	1	2	4	1	1	3	2	2	1	1	-1	-1	0.04	-1.10	-2.00
2224748	2024-08-13 23:30:00	35	3	3.05	3.15	2.12	3.30	3.25	1.96	4	0	6	5	3	2	9	3	8	3	9	4	12	1	3	2	3	1	2	1	1	-1	0.25	0.10	-0.16
2284908	2024-09-18 18:00:00	35	0	2.08	3.40	2.89	2.06	3.45	2.92	1	0	3	0	1	2	1	1	5	4	4	0	5	2	2	1	1	1	3	-1	1	1	-0.02	0.05	0.03
2026319	2023-08-23 01:20:00	35	3	1.23	5.30	8.40	1.18	5.80	9.60	13	9	12	10	11	12	23	20	24	4	7	3	27	2	3	1	2	1	3	-1	1	1	-0.05	0.50	1.20
2285040	2024-11-26 20:00:00	35	0	2.81	3.35	2.14	2.88	3.35	2.20	3	2	2	4	1	2	7	3	4	0	4	3	7	1	3	2	3	1	2	1	0	1	0.07	0.00	0.06
2285041	2024-11-27 18:00:00	35	3	1.47	4.35	4.80	1.42	4.50	5.30	2	0	0	0	2	2	2	2	2	1	1	1	3	1	1	1	1	1	1	-1	1	1	-0.05	0.15	0.50
2284919	2024-10-01 02:00:00	35	3	1.21	5.60	8.70	1.19	6.00	9.00	5	3	5	4	5	9	9	8	14	5	6	0	14	2	3	1	2	1	3	-1	1	1	-0.02	0.40	0.30
2026312	2023-08-22 19:30:00	35	0	1.22	5.20	9.40	1.26	5.10	7.70	2	4	5	5	2	2	7	6	7	1	2	1	8	1	3	1	2	1	2	1	-1	-1	0.04	-0.10	-1.70
2173559	2024-03-05 18:00:00	35	1	2.32	3.15	2.67	2.23	3.20	2.79	2	0	3	3	1	2	5	1	5	0	4	0	5	1	3	1	2	1	2	-1	1	1	-0.09	0.05	0.12
2284916	2024-10-01 00:00:00	35	3	1.80	3.50	3.60	1.71	3.50	4.00	3	2	1	0	3	5	3	5	6	3	1	0	6	3	2	1	1	2	3	-1	0	1	-0.09	0.00	0.40
2173560	2024-03-12 18:00:00	35	3	2.13	3.15	3.00	2.28	3.25	2.68	1	2	7	3	3	2	4	5	9	5	4	0	9	3	2	1	1	2	3	1	1	-1	0.15	0.10	-0.32
2088572	2023-09-20 18:00:00	35	3	1.82	3.45	3.55	1.85	3.45	3.45	1	1	2	2	1	1	3	2	3	1	2	1	4	1	3	1	2	1	2	1	0	-1	0.03	0.00	-0.10
2205381	2024-05-26 00:00:00	35	3	2.01	3.60	2.90	2.09	3.90	3.15	2	5	7	3	5	7	5	10	14	12	7	3	17	3	2	1	1	2	3	1	1	1	0.08	0.30	0.25
2284870	2024-09-17 00:00:00	35	1	2.09	3.35	2.92	2.09	3.50	2.80	0	1	6	1	3	3	1	4	9	8	5	0	9	3	2	1	1	2	3	0	1	-1	0.00	0.15	-0.12
2205380	2024-05-11 18:00:00	35	3	1.77	3.55	3.65	1.97	3.45	3.10	2	2	7	8	2	2	10	4	9	1	7	2	11	1	3	2	3	1	2	1	-1	-1	0.20	-0.10	-0.55
2284871	2024-09-17 00:00:00	35	1	7.10	4.20	1.35	6.30	4.40	1.36	10	7	6	8	8	6	18	15	12	0	3	6	18	1	2	3	3	2	1	-1	1	1	-0.80	0.20	0.01
2088568	2023-11-29 18:00:00	35	3	1.42	4.00	5.80	1.45	3.95	5.80	2	2	1	1	3	2	3	5	3	2	0	2	5	2	1	2	1	3	1	1	-1	0	0.03	-0.05	0.00
2088567	2023-11-08 20:00:00	35	3	3.00	3.50	1.99	3.75	3.55	1.75	8	6	10	10	6	8	18	12	18	2	8	2	20	1	3	1	2	1	2	1	1	-1	0.75	0.05	-0.24
2088565	2023-10-24 18:00:00	35	0	1.82	3.30	3.75	1.80	3.25	3.90	4	4	3	3	3	5	7	7	8	2	2	1	9	2	2	1	1	1	3	-1	-1	1	-0.02	-0.05	0.15
2088564	2023-10-24 20:00:00	35	3	1.31	4.65	7.10	1.42	4.15	5.90	6	10	12	11	7	7	17	17	19	3	3	1	20	2	2	1	1	1	3	1	-1	-1	0.11	-0.50	-1.20
2284622	2024-09-18 20:00:00	35	1	1.57	4.05	4.15	1.54	4.10	4.35	23	15	22	19	16	30	42	31	52	13	24	3	55	2	3	1	2	1	3	-1	1	1	-0.03	0.05	0.20
2284623	2024-10-22 18:00:00	35	3	1.34	4.90	5.90	1.35	5.00	5.60	4	5	6	5	7	4	9	12	10	4	1	3	13	3	1	2	1	3	2	1	1	-1	0.01	0.10	-0.30
2089073	2023-10-25 18:00:00	35	0	1.69	3.60	3.95	1.69	3.60	4.00	0	0	0	0	0	1	0	0	1	2	2	1	2	2	2	1	1	1	3	0	0	1	0.00	0.00	0.05
2088560	2023-09-20 20:00:00	35	1	3.60	3.45	1.81	3.90	3.45	1.74	0	1	3	3	1	0	3	2	3	1	2	1	4	1	3	1	2	1	2	1	0	-1	0.30	0.00	-0.07
2284627	2024-12-03 20:00:00	35	1	1.77	3.60	3.60	1.70	3.70	3.85	2	0	0	0	2	2	2	2	2	2	2	2	4	1	1	1	1	1	1	-1	1	1	-0.07	0.10	0.25
2089453	2023-12-06 00:00:00	35	1	7.10	4.75	1.29	6.80	4.60	1.33	20	18	13	17	12	20	37	30	33	1	8	5	38	1	3	2	3	1	2	-1	-1	1	-0.30	-0.15	0.04
2284624	2024-11-26 18:00:00	35	0	2.04	3.50	2.89	1.88	3.60	3.20	4	7	5	0	8	8	4	15	13	16	5	7	20	3	1	2	1	3	2	-1	1	1	-0.16	0.10	0.31
2138963	2024-02-23 00:00:00	35	3	1.31	4.70	6.90	1.31	5.10	8.10	3	5	7	5	6	6	8	11	13	5	2	0	13	3	2	1	1	2	3	0	1	1	0.00	0.40	1.20
2284630	2024-12-04 20:00:00	35	0	2.22	3.35	2.70	2.16	3.35	2.80	2	1	2	1	1	3	3	2	5	2	3	0	5	2	3	1	2	1	3	-1	0	1	-0.06	0.00	0.10
2089450	2023-11-28 02:00:00	35	1	1.25	5.10	7.70	1.28	4.85	7.70	9	9	9	9	9	12	18	18	21	3	3	0	21	2	2	1	1	1	3	1	-1	0	0.03	-0.25	0.00
2284629	2024-11-05 18:00:00	35	3	1.87	3.65	3.25	1.85	3.65	3.25	4	1	2	2	1	3	6	2	5	2	6	3	8	1	3	2	3	1	2	-1	0	0	-0.02	0.00	0.00
2284634	2024-09-17 20:00:00	35	3	2.31	3.25	2.63	2.06	3.40	2.95	8	1	4	3	4	7	11	5	11	3	9	3	14	1	3	1	2	1	2	-1	1	1	-0.25	0.15	0.32
2284635	2024-10-23 20:00:00	35	3	3.05	3.45	1.99	2.94	3.40	2.06	5	3	5	4	3	5	9	6	10	1	4	0	10	2	3	1	2	1	3	-1	-1	1	-0.11	-0.05	0.07
2185947	2024-04-24 02:00:00	35	3	1.19	6.80	7.20	1.19	6.70	12.00	17	29	20	24	22	19	41	51	39	25	15	27	66	2	1	3	2	3	1	0	-1	1	0.00	-0.10	4.80
2185946	2024-04-18 00:00:00	35	3	4.70	4.05	1.51	4.90	4.10	1.49	3	3	3	5	3	3	8	6	6	1	3	3	9	1	2	2	3	1	1	1	1	-1	0.20	0.05	-0.02
2284633	2024-11-05 16:00:00	35	1	2.79	3.30	2.18	2.81	3.25	2.19	1	1	1	1	1	1	2	2	2	1	1	1	3	1	1	1	1	1	1	1	-1	1	0.02	-0.05	0.01
2284638	2024-09-17 18:00:00	35	3	2.05	3.30	3.10	2.05	3.35	3.00	11	5	6	10	6	5	21	11	11	2	12	12	23	1	2	2	3	1	1	0	1	-1	0.00	0.05	-0.10
2089442	2023-12-05 00:00:00	35	3	1.15	6.50	10.00	1.14	6.60	11.00	3	3	2	3	3	3	6	6	5	3	3	4	9	1	1	3	2	2	1	-1	1	1	-0.01	0.10	1.00
2284639	2024-11-26 20:00:00	35	3	2.85	3.60	2.03	2.99	3.70	2.02	8	5	6	9	6	6	17	11	12	1	7	6	18	1	3	2	3	1	2	1	1	-1	0.14	0.10	-0.01
2173791	2024-03-12 03:00:00	35	3	1.36	4.50	6.20	1.38	5.00	8.00	4	7	12	6	7	11	10	14	23	13	9	0	23	3	2	1	1	2	3	1	1	1	0.02	0.50	1.80
2173790	2024-03-05 00:00:00	35	3	4.35	3.80	1.70	4.35	3.85	1.70	1	0	0	2	2	0	3	2	0	0	1	3	3	1	2	3	3	2	1	0	1	0	0.00	0.05	0.00
2284637	2024-11-27 18:00:00	35	3	1.93	3.40	3.25	1.93	3.40	3.25	1	1	2	1	1	2	2	2	4	3	3	1	5	2	2	1	1	1	3	0	0	0	0.00	0.00	0.00
2088315	2023-09-28 08:30:00	36	0	1.98	3.80	3.20	1.99	3.70	3.60	18	6	11	11	4	13	29	10	24	1	20	6	30	1	3	2	3	1	2	1	-1	1	0.01	-0.10	0.40
2041282	2023-08-24 07:00:00	36	1	2.91	3.65	2.07	2.98	3.80	2.21	10	2	4	7	3	10	17	5	14	1	13	4	18	1	3	2	3	1	2	1	1	1	0.07	0.15	0.14
2041281	2023-08-24 09:30:00	36	1	2.17	3.45	2.88	2.35	3.50	2.94	11	4	10	12	4	12	23	8	22	3	18	4	26	1	3	2	3	1	2	1	1	1	0.18	0.05	0.06
2323491	2024-12-19 03:30:00	37	3	1.40	4.10	6.10	1.38	4.95	8.40	17	7	11	9	11	23	26	18	34	8	16	0	34	2	3	1	2	1	3	-1	1	1	-0.02	0.85	2.30
2323494	2024-12-20 04:00:00	37	3	2.31	3.70	2.41	2.42	3.90	2.64	1	7	10	2	7	14	3	14	24	25	14	4	28	3	2	1	1	2	3	1	1	1	0.11	0.20	0.23
2323493	2024-12-19 04:00:00	37	0	5.10	4.75	1.39	5.70	4.75	1.51	19	14	13	17	13	18	36	27	31	1	10	6	37	1	3	2	3	1	2	1	0	1	0.60	0.00	0.12
2323492	2024-12-19 03:45:00	37	3	1.51	4.05	4.80	1.58	4.35	5.30	5	3	3	4	5	5	9	8	8	0	1	1	9	1	2	2	3	1	1	1	1	1	0.07	0.30	0.50
2106920	2023-11-02 03:30:00	37	3	2.92	3.30	2.11	3.40	3.55	1.99	20	7	43	28	10	23	48	17	66	23	54	5	71	2	3	1	2	1	3	1	1	-1	0.48	0.25	-0.12
2106922	2023-11-02 04:15:00	37	0	2.08	3.25	3.00	2.20	3.45	2.99	1	3	8	5	4	5	6	7	13	10	9	3	16	3	2	1	1	2	3	1	1	-1	0.12	0.20	-0.01
2283944	2024-08-28 03:00:00	37	3	1.41	4.25	6.00	1.38	4.45	5.90	6	7	10	5	9	9	11	16	19	12	7	4	23	3	2	1	1	2	3	-1	1	-1	-0.03	0.20	-0.10
2106924	2023-11-02 03:45:00	37	0	6.10	4.35	1.46	6.80	4.50	1.41	14	6	13	20	10	11	34	16	24	4	22	14	38	1	3	2	3	1	2	1	1	-1	0.70	0.15	-0.05
2106925	2023-11-02 03:45:00	37	3	1.80	3.55	3.55	1.70	3.70	4.50	9	3	6	2	6	10	11	9	16	7	9	2	18	2	3	1	2	1	3	-1	1	1	-0.10	0.15	0.95
2283951	2024-08-29 03:00:00	37	1	2.92	3.65	2.07	2.86	3.60	2.11	6	4	4	9	4	6	15	8	10	1	8	6	16	1	3	2	3	1	2	-1	-1	1	-0.06	-0.05	0.04
2106926	2023-11-01 03:45:00	37	0	3.90	3.75	1.79	4.35	3.95	1.68	2	1	9	10	6	1	12	7	10	1	6	3	13	1	3	2	3	1	2	1	1	-1	0.45	0.20	-0.11
2106927	2023-11-02 03:45:00	37	3	1.17	6.00	11.00	1.18	6.70	13.00	12	7	8	11	13	11	23	20	19	11	14	15	34	1	2	3	3	2	1	1	1	1	0.01	0.70	2.00
2283949	2024-08-28 02:15:00	37	0	1.83	3.30	3.65	1.76	3.55	3.70	10	6	9	6	10	10	16	16	19	12	12	9	28	2	2	1	1	1	3	-1	1	1	-0.07	0.25	0.05
2308593	2024-10-31 03:45:00	37	3	2.37	3.55	2.52	2.50	3.55	2.52	18	3	24	26	3	20	44	6	44	3	41	3	47	1	3	1	2	1	2	1	0	0	0.13	0.00	0.00
2283958	2024-08-29 02:45:00	37	3	2.07	3.30	2.99	2.06	3.55	3.00	4	5	12	4	7	10	8	12	22	18	14	4	26	3	2	1	1	2	3	-1	1	1	-0.01	0.25	0.01
2306423	2024-10-31 04:15:00	37	3	2.42	3.60	2.44	2.55	3.70	2.39	23	0	40	41	1	24	64	1	64	0	63	0	64	1	3	1	2	1	2	1	1	-1	0.13	0.10	-0.05
2306422	2024-10-31 03:45:00	37	3	1.29	5.00	8.20	1.30	5.40	8.10	19	13	23	16	17	32	35	30	55	20	25	0	55	2	3	1	2	1	3	1	1	-1	0.01	0.40	-0.10
2340347	2025-02-07 04:00:00	37	3	1.21	6.50	7.40	1.22	7.30	11.00	18	25	22	23	20	16	41	45	38	20	16	23	61	2	1	3	2	3	1	1	1	1	0.01	0.80	3.60
2340346	2025-01-09 04:00:00	37	3	3.55	3.95	1.71	4.35	4.75	1.64	6	4	6	9	7	3	15	11	9	2	6	8	17	1	2	3	3	2	1	1	1	-1	0.80	0.80	-0.07
2340344	2025-01-08 04:00:00	37	0	1.70	3.60	3.95	1.76	3.80	4.60	4	9	14	9	8	10	13	17	24	15	11	4	28	3	2	1	1	2	3	1	1	1	0.06	0.20	0.65
2292095	2024-09-19 02:45:00	37	3	1.54	3.95	4.65	1.49	4.20	5.70	8	4	11	7	9	12	15	13	23	9	11	1	24	2	3	1	2	1	3	-1	1	1	-0.05	0.25	1.05
2077949	2023-08-31 02:45:00	37	0	2.13	3.30	2.88	2.13	3.30	2.86	3	2	6	5	1	5	8	3	11	3	8	0	11	2	3	1	2	1	3	0	0	-1	0.00	0.00	-0.02
2292096	2024-09-18 02:45:00	37	1	2.08	3.30	2.96	2.13	3.40	3.15	8	5	7	10	3	10	18	8	17	4	14	5	22	1	3	2	3	1	2	1	1	1	0.05	0.10	0.19
2292097	2024-09-25 02:45:00	37	3	1.15	7.40	8.50	1.11	8.10	17.00	13	14	15	8	22	23	21	36	38	27	12	10	48	3	2	1	1	2	3	-1	1	1	-0.04	0.70	8.50
2077945	2023-08-30 02:45:00	37	1	3.55	3.55	1.79	3.70	3.70	1.79	12	10	17	21	12	11	33	22	28	4	15	9	37	1	3	2	3	1	2	1	1	0	0.15	0.15	0.00
2121800	2023-12-20 04:00:00	37	1	1.84	3.50	3.45	1.86	3.80	4.00	22	11	25	24	14	24	46	25	49	15	36	12	61	2	3	1	2	1	3	1	1	1	0.02	0.30	0.55
2121801	2023-12-21 04:00:00	37	3	1.41	4.50	5.30	1.40	4.95	7.50	11	11	18	11	12	18	22	23	36	18	17	4	40	3	2	1	1	2	3	-1	1	1	-0.01	0.45	2.20
2135945	2024-01-10 04:00:00	37	3	4.85	3.95	1.56	5.80	4.55	1.52	8	7	8	12	11	6	20	18	14	1	3	7	21	1	2	3	3	2	1	1	1	-1	0.95	0.60	-0.04
2135946	2024-01-11 04:00:00	37	3	1.39	4.55	6.30	1.39	5.20	7.30	13	6	15	12	7	21	25	13	36	17	29	6	42	2	3	1	2	1	3	0	1	1	0.00	0.65	1.00
2135947	2024-01-25 04:00:00	37	1	3.95	3.85	1.77	4.30	3.95	1.77	9	4	9	13	6	7	22	10	16	3	15	9	25	1	3	2	3	1	2	1	1	0	0.35	0.10	0.00
2292105	2024-09-26 03:00:00	37	3	1.35	4.60	6.30	1.34	5.10	7.60	16	15	25	20	18	21	36	33	46	13	16	3	49	2	3	1	2	1	3	-1	1	1	-0.01	0.50	1.30
2135949	2024-01-24 04:00:00	37	3	1.26	5.90	9.00	1.24	6.50	11.00	14	6	6	13	10	10	27	16	16	6	17	17	33	1	2	2	3	1	1	-1	1	1	-0.02	0.60	2.00
2092976	2023-09-28 02:45:00	37	3	2.38	3.45	2.45	2.33	3.65	2.65	5	2	8	5	3	6	10	5	14	5	10	1	15	2	3	1	2	1	3	-1	1	1	-0.05	0.20	0.20
2155090	2024-02-25 23:00:00	37	1	2.98	3.65	2.13	3.05	3.75	2.19	4	0	1	1	1	3	5	1	4	1	5	2	6	1	3	2	3	1	2	1	1	1	0.07	0.10	0.06
2092970	2023-09-28 02:45:00	37	0	1.68	3.80	4.50	1.70	3.75	4.40	1	1	2	2	1	1	3	2	3	1	2	1	4	1	3	1	2	1	2	1	-1	-1	0.02	-0.05	-0.10
2092967	2023-09-28 02:45:00	37	0	2.84	3.40	2.11	3.25	3.40	2.09	9	2	8	10	2	5	19	4	13	2	17	8	21	1	3	2	3	1	2	1	0	-1	0.41	0.00	-0.02
2092965	2023-09-28 02:45:00	37	3	1.40	4.70	5.20	1.39	4.80	6.60	11	7	8	8	11	15	19	18	23	7	8	3	26	2	3	1	2	1	3	-1	1	1	-0.01	0.10	1.40
2092964	2023-09-28 03:00:00	37	3	2.52	3.35	2.34	2.75	3.40	2.37	13	4	19	23	4	11	36	8	30	1	29	7	37	1	3	2	3	1	2	1	1	1	0.23	0.05	0.03
2092962	2023-09-27 03:00:00	37	3	1.58	3.75	4.50	1.62	3.95	4.80	7	8	9	10	5	10	17	13	19	2	6	0	19	2	3	1	2	1	3	1	1	1	0.04	0.20	0.30
2292451	2024-11-29 04:00:00	38	3	5.60	3.85	1.56	5.30	4.05	1.56	6	2	3	5	7	1	11	9	4	1	3	8	12	1	2	3	3	2	1	-1	1	0	-0.30	0.20	0.00
2292449	2024-12-20 04:00:00	38	3	1.45	4.15	5.20	1.59	4.20	4.70	10	16	17	17	10	13	27	26	30	3	4	0	30	2	3	1	2	1	3	1	1	-1	0.14	0.05	-0.50
2292455	2024-12-13 01:45:00	38	3	1.32	4.95	6.60	1.28	5.40	9.10	11	5	7	5	11	14	16	16	21	6	6	1	22	2	2	1	1	1	3	-1	1	1	-0.04	0.45	2.50
2292388	2024-12-20 04:00:00	38	3	1.13	7.80	15.00	1.15	7.00	15.00	2	9	6	5	8	7	7	17	13	10	0	4	17	3	1	2	1	3	2	1	-1	0	0.02	-0.80	0.00
2292394	2024-12-20 04:00:00	38	3	1.34	4.75	6.10	1.37	4.95	6.60	5	5	8	5	6	11	10	11	19	11	10	2	21	3	2	1	1	2	3	1	1	1	0.03	0.20	0.50
2292456	2024-11-29 04:00:00	38	3	1.33	4.60	6.60	1.35	4.75	7.50	11	9	11	8	9	15	19	18	26	8	9	1	27	2	3	1	2	1	3	1	1	1	0.02	0.15	0.90
2174314	2024-03-15 04:00:00	38	3	1.30	5.10	8.60	1.34	4.95	7.80	6	11	17	10	8	11	16	19	28	13	10	1	29	3	2	1	1	2	3	1	-1	-1	0.04	-0.15	-0.80
2292463	2024-12-20 04:00:00	38	1	1.27	4.65	9.00	1.33	4.75	8.50	7	7	7	6	9	10	13	16	17	4	1	0	17	3	2	1	1	2	3	1	1	-1	0.06	0.10	-0.50
2292402	2024-12-12 21:00:00	38	0	3.50	3.50	1.82	3.20	3.55	2.05	5	3	3	4	3	5	9	6	8	4	7	5	13	1	3	2	3	1	2	-1	1	1	-0.30	0.05	0.23
2292466	2024-12-20 04:00:00	38	1	1.62	4.00	4.70	1.60	4.15	4.70	4	2	5	3	7	7	7	9	12	6	4	1	13	3	2	1	1	2	3	-1	1	0	-0.02	0.15	0.00
2292467	2024-12-13 01:45:00	38	1	4.35	3.70	1.62	4.50	3.80	1.68	4	3	4	6	5	3	10	8	7	0	2	3	10	1	2	3	3	2	1	1	1	1	0.15	0.10	0.06
2292464	2024-11-29 01:45:00	38	0	4.85	4.55	1.44	4.75	4.40	1.55	12	10	2	5	3	11	17	13	13	0	4	4	17	1	2	2	3	1	1	-1	-1	1	-0.10	-0.15	0.11
2292400	2024-12-20 04:00:00	38	1	2.78	3.15	2.25	3.15	3.25	2.20	11	3	11	12	5	8	23	8	19	4	19	8	27	1	3	2	3	1	2	1	1	-1	0.37	0.10	-0.05
2292406	2024-12-20 04:00:00	38	3	1.05	11.00	25.00	1.05	11.00	25.00	0	0	0	1	1	1	1	1	1	0	0	0	1	1	1	1	1	1	1	0	0	0	0.00	0.00	0.00
2203444	2024-05-30 03:00:00	38	1	3.15	3.25	2.36	3.05	3.25	2.40	5	4	2	4	5	3	9	9	5	4	4	8	13	1	1	3	2	2	1	-1	0	1	-0.10	0.00	0.04
2292471	2024-12-20 04:00:00	38	1	2.06	3.10	3.25	2.16	3.20	3.30	2	1	3	2	4	4	4	5	7	4	3	1	8	3	2	1	1	2	3	1	1	1	0.10	0.10	0.05
2292407	2024-12-20 04:00:00	38	3	2.08	3.40	2.88	2.26	3.60	2.77	3	2	9	7	3	6	10	5	15	8	13	3	18	2	3	1	2	1	3	1	1	-1	0.18	0.20	-0.11
2187319	2024-04-12 03:00:00	38	3	1.70	3.60	3.95	1.86	3.60	3.75	1	4	5	6	2	3	7	6	8	2	3	1	9	2	3	1	2	1	3	1	0	-1	0.16	0.00	-0.20
2187321	2024-04-12 03:00:00	38	3	1.63	3.80	4.10	1.65	3.95	4.55	15	6	15	14	7	17	29	13	32	6	22	3	35	2	3	1	2	1	3	1	1	1	0.02	0.15	0.45
2187322	2024-04-12 00:45:00	38	1	3.45	3.30	1.89	3.65	3.40	1.95	4	2	11	8	2	8	12	4	19	8	16	1	20	2	3	1	2	1	3	1	1	1	0.20	0.10	0.06
2292473	2024-12-20 04:00:00	38	3	11.00	6.50	1.14	16.00	6.50	1.16	6	12	5	7	8	6	13	20	11	12	5	14	25	2	1	3	2	3	1	1	0	1	5.00	0.00	0.02
2187325	2024-04-19 00:45:00	38	3	2.24	3.15	2.80	2.51	3.50	2.52	6	2	14	10	4	10	16	6	24	8	18	0	24	2	3	1	2	1	3	1	1	-1	0.27	0.35	-0.28
2292414	2024-10-25 00:45:00	38	0	3.35	3.15	1.99	3.35	3.30	2.08	5	3	3	5	3	3	10	6	6	1	5	5	11	1	2	2	3	1	1	0	1	1	0.00	0.15	0.09
2292478	2024-12-20 04:00:00	38	1	1.66	3.65	4.15	1.77	3.75	4.00	5	5	6	6	4	5	11	9	11	3	5	3	14	1	3	1	2	1	2	1	1	-1	0.11	0.10	-0.15
2093122	2023-11-10 04:00:00	38	3	1.35	4.30	6.90	1.34	4.90	7.90	7	4	7	6	9	11	13	13	18	5	5	0	18	2	2	1	1	1	3	-1	1	1	-0.01	0.60	1.00
2187326	2024-04-19 00:45:00	38	1	1.31	4.20	8.80	1.34	4.70	8.40	8	5	12	7	11	14	15	16	26	13	12	2	28	3	2	1	1	2	3	1	1	-1	0.03	0.50	-0.40
2292419	2024-12-13 04:00:00	38	0	2.78	3.35	2.17	3.05	3.45	2.17	7	2	6	10	2	4	17	4	10	0	13	7	17	1	3	2	3	1	2	1	1	0	0.27	0.10	0.00
2093117	2023-10-27 00:45:00	38	0	2.89	3.40	2.09	2.93	3.45	2.05	2	1	3	4	2	0	6	3	3	0	3	3	6	1	2	2	3	1	1	1	1	-1	0.04	0.05	-0.04
2292416	2024-11-29 01:45:00	38	0	3.50	3.45	1.84	4.20	3.80	1.73	10	7	16	15	9	11	25	16	27	7	16	5	32	2	3	1	2	1	3	1	1	-1	0.70	0.35	-0.11
2292422	2024-12-12 23:30:00	38	0	7.60	4.85	1.28	6.60	4.55	1.41	43	35	41	48	39	32	91	74	73	5	22	23	96	1	2	3	3	2	1	-1	-1	1	-1.00	-0.30	0.13
2292486	2024-12-20 04:00:00	38	3	2.11	3.35	2.89	2.14	3.60	2.99	4	2	7	4	5	8	8	7	15	9	10	2	17	2	3	1	2	1	3	1	1	1	0.03	0.25	0.10
2292484	2024-12-20 04:00:00	38	1	2.08	3.35	2.95	2.26	3.50	2.86	6	5	7	5	6	9	11	11	16	8	8	3	19	2	2	1	1	1	3	1	1	-1	0.18	0.15	-0.09
2093111	2023-12-01 01:45:00	38	0	2.78	3.40	2.14	2.82	3.50	2.17	3	0	3	2	2	2	5	2	5	0	3	0	5	1	3	1	2	1	2	1	1	1	0.04	0.10	0.03
2292489	2024-12-20 04:00:00	38	3	2.50	3.10	2.53	2.69	3.30	2.47	4	2	8	9	4	5	13	6	13	1	8	1	14	1	3	1	2	1	2	1	1	-1	0.19	0.20	-0.06
1986416	2023-06-08 03:00:00	38	0	2.61	3.25	2.58	2.86	3.15	2.61	14	3	14	17	2	15	31	5	29	1	27	3	32	1	3	2	3	1	2	1	-1	1	0.25	-0.10	0.03
2084273	2023-09-01 02:00:00	38	3	1.12	7.30	11.00	1.15	6.60	11.00	3	7	3	5	4	3	8	11	6	3	0	5	11	2	1	3	2	3	1	1	-1	0	0.03	-0.70	0.00
2292306	2024-11-08 04:00:00	38	3	4.35	3.60	1.69	4.75	3.80	1.65	6	4	7	7	7	6	13	11	13	2	4	2	15	1	3	1	2	1	2	1	1	-1	0.40	0.20	-0.04
2203283	2024-05-03 03:00:00	38	3	1.80	3.35	3.75	1.80	3.55	4.10	8	3	14	12	5	8	20	8	22	6	18	4	26	2	3	1	2	1	3	0	1	1	0.00	0.20	0.35
2203282	2024-05-03 03:00:00	38	0	1.39	4.35	6.00	1.31	4.85	8.80	11	5	14	5	11	22	16	16	36	22	22	2	38	2	2	1	1	1	3	-1	1	1	-0.08	0.50	2.80
2292305	2024-12-20 04:00:00	38	1	1.37	4.30	6.30	1.51	4.10	5.70	13	15	22	19	14	16	32	29	38	11	14	5	43	2	3	1	2	1	3	1	-1	-1	0.14	-0.20	-0.60
2203285	2024-05-10 03:00:00	38	3	3.20	3.60	1.88	3.20	3.80	1.99	21	7	18	18	8	22	39	15	40	6	30	5	45	2	3	1	2	1	3	0	1	1	0.00	0.20	0.11
2203284	2024-05-09 00:45:00	38	1	2.30	3.25	2.67	2.47	3.30	2.69	7	2	10	9	4	8	16	6	18	3	13	1	19	2	3	1	2	1	3	1	1	1	0.17	0.05	0.02
2292446	2024-11-29 01:45:00	38	0	1.61	3.75	4.30	1.63	3.80	4.90	3	7	6	6	6	7	9	13	13	8	4	4	17	3	1	1	1	2	2	1	1	1	0.02	0.05	0.60
2292445	2024-11-28 23:30:00	38	1	3.20	3.30	1.99	4.15	3.40	1.84	4	1	9	12	3	3	16	4	12	0	12	4	16	1	3	2	3	1	2	1	1	-1	0.95	0.10	-0.15
2027484	2023-09-09 22:00:00	39	1	1.74	3.35	4.05	1.70	3.40	4.20	1	1	1	1	1	1	2	2	2	0	0	0	2	1	1	1	1	1	1	-1	1	1	-0.04	0.05	0.15
2027613	2023-10-14 22:00:00	39	3	2.14	3.15	2.85	2.02	3.25	3.20	4	0	5	6	2	5	10	2	10	0	8	0	10	1	3	1	2	1	2	-1	1	1	-0.12	0.10	0.35
2027449	2023-09-05 03:00:00	39	3	2.14	3.30	2.86	2.24	3.20	2.94	3	2	4	4	1	5	7	3	9	2	6	0	9	2	3	1	2	1	3	1	-1	1	0.10	-0.10	0.08
2211942	2024-05-18 23:15:00	39	0	1.82	3.40	3.65	1.81	3.50	3.80	2	0	0	0	2	2	2	2	2	1	1	1	3	1	1	1	1	1	1	-1	1	1	-0.01	0.10	0.15
2028151	2024-03-23 23:00:00	39	3	5.30	3.60	1.59	5.50	3.65	1.57	2	1	3	4	2	2	6	3	5	0	3	1	6	1	3	2	3	1	2	1	1	-1	0.20	0.05	-0.02
2027731	2023-11-18 23:00:00	39	3	1.49	3.85	6.00	1.54	3.75	5.40	2	3	4	4	1	2	6	4	6	1	3	1	7	1	3	1	2	1	2	1	-1	-1	0.05	-0.10	-0.60
2028147	2024-03-23 23:00:00	39	1	4.65	3.50	1.67	4.65	3.50	1.67	0	0	1	1	1	0	1	1	1	0	0	0	1	1	1	1	1	1	1	0	0	0	0.00	0.00	0.00
2027760	2023-11-18 23:00:00	39	3	1.70	3.35	4.65	1.74	3.35	4.45	2	1	2	2	2	2	4	3	4	0	1	0	4	1	3	1	2	1	2	1	0	-1	0.04	0.00	-0.20
2028144	2024-03-23 23:00:00	39	0	2.20	3.20	3.00	2.20	3.20	3.00	0	0	1	1	0	0	1	0	1	0	1	0	1	1	3	1	2	1	2	0	0	0	0.00	0.00	0.00
2027469	2023-09-09 22:00:00	39	0	1.68	3.70	3.95	1.71	3.65	4.15	1	1	1	1	1	1	2	2	2	1	1	1	3	1	1	1	1	1	1	1	-1	1	0.03	-0.05	0.20
2125942	2023-11-22 03:45:00	39	0	1.92	3.30	3.60	2.03	3.25	3.35	5	3	8	10	2	4	15	5	12	0	10	3	15	1	3	2	3	1	2	1	-1	-1	0.11	-0.05	-0.25
2250036	2024-10-18 03:00:00	39	0	2.76	3.30	2.29	2.92	3.15	2.28	17	9	16	19	8	16	36	17	32	3	22	7	39	1	3	2	3	1	2	1	-1	-1	0.16	-0.15	-0.01
2027622	2023-10-14 22:00:00	39	0	1.95	3.20	3.40	1.91	3.30	3.65	6	5	7	7	5	7	13	10	14	1	4	0	14	2	3	1	2	1	3	-1	1	1	-0.04	0.10	0.25
2027618	2023-10-14 22:00:00	39	0	2.31	3.25	2.76	2.34	3.25	2.71	0	0	1	2	0	0	2	0	1	0	2	1	2	1	3	2	3	1	2	1	0	-1	0.03	0.00	-0.05
2027587	2023-10-10 03:00:00	39	3	2.29	3.25	2.82	2.21	3.25	2.95	5	1	5	5	1	5	10	2	10	1	9	1	11	1	3	1	2	1	2	-1	0	1	-0.08	0.00	0.13
2027616	2023-10-14 22:00:00	39	1	2.02	3.30	3.30	2.02	3.30	3.30	0	0	0	0	0	1	0	0	1	1	1	0	1	2	2	1	1	1	3	0	0	0	0.00	0.00	0.00
2078110	2023-11-22 03:30:00	40	3	2.58	3.35	2.30	2.70	3.35	2.22	4	0	11	11	0	4	15	0	15	0	15	0	15	1	3	1	2	1	2	1	0	-1	0.12	0.00	-0.08
2249315	2024-09-04 02:00:00	40	0	3.65	3.60	1.75	3.20	3.50	1.99	9	5	3	5	2	7	14	7	10	0	7	4	14	1	3	2	3	1	2	-1	-1	1	-0.45	-0.10	0.24
2249312	2024-09-04 02:45:00	40	1	2.34	3.25	2.60	2.52	3.30	2.50	4	3	7	5	4	4	9	7	11	5	7	3	14	2	3	1	2	1	3	1	1	-1	0.18	0.05	-0.10
2078107	2023-10-18 02:00:00	40	0	1.70	3.80	4.00	1.74	3.80	3.80	2	2	3	3	1	2	5	3	5	0	2	0	5	1	3	1	2	1	2	1	0	-1	0.04	0.00	-0.20
2078097	2023-11-22 03:00:00	40	3	1.65	3.75	4.15	1.66	3.75	4.05	2	1	2	2	1	2	4	2	4	0	2	0	4	1	3	1	2	1	2	1	0	-1	0.01	0.00	-0.10
2249964	2024-10-09 02:00:00	40	0	2.59	3.30	2.25	2.85	3.30	2.09	6	1	9	10	2	7	16	3	16	0	13	0	16	1	3	1	2	1	2	1	0	-1	0.26	0.00	-0.16
2249970	2024-10-09 02:45:00	40	3	2.03	3.50	2.93	1.96	3.55	3.05	4	0	3	3	1	3	7	1	6	0	6	1	7	1	3	2	3	1	2	-1	1	1	-0.07	0.05	0.12
2078092	2023-11-15 03:00:00	40	3	1.92	3.85	3.15	2.07	3.85	2.66	8	2	5	5	3	8	13	5	13	0	8	0	13	1	3	1	2	1	2	1	0	-1	0.15	0.00	-0.49
2250420	2024-11-13 03:00:00	40	3	1.45	4.30	5.10	1.41	4.40	6.20	6	5	5	5	7	8	11	12	13	5	4	3	16	3	2	1	1	2	3	-1	1	1	-0.04	0.10	1.10
2250485	2024-11-13 03:00:00	40	0	2.24	3.35	2.67	2.82	3.35	2.23	5	1	12	15	2	4	20	3	16	0	17	4	20	1	3	2	3	1	2	1	0	-1	0.58	0.00	-0.44
2250490	2024-11-13 03:00:00	40	3	1.58	3.85	4.35	1.74	3.70	3.90	3	6	5	4	4	6	7	10	11	5	2	1	12	3	2	1	1	2	3	1	-1	-1	0.16	-0.15	-0.45
2078081	2023-10-11 02:00:00	40	3	1.48	3.95	5.30	1.54	3.90	5.20	4	3	4	5	5	7	9	8	11	3	4	1	12	2	3	1	2	1	3	1	-1	-1	0.06	-0.05	-0.10
2332035	2024-12-18 03:00:00	40	3	1.58	3.95	4.25	1.58	3.95	4.65	12	7	8	7	8	13	19	15	21	4	8	2	23	2	3	1	2	1	3	0	0	1	0.00	0.00	0.40
2078074	2023-11-22 03:30:00	40	3	2.52	3.35	2.35	2.54	3.35	2.34	1	0	1	1	0	1	2	0	2	1	3	1	3	1	3	1	2	1	2	1	0	-1	0.02	0.00	-0.01
2078070	2023-09-06 02:30:00	40	3	1.84	3.45	3.50	1.82	3.45	3.55	8	4	3	2	5	8	10	9	11	4	5	3	14	2	3	1	2	1	3	-1	0	1	-0.02	0.00	0.05
2078132	2023-10-11 02:30:00	40	0	2.16	3.30	2.83	2.26	3.35	2.79	3	5	7	6	4	8	9	9	15	6	6	0	15	2	2	1	1	1	3	1	1	-1	0.10	0.05	-0.04
2078068	2023-11-15 03:30:00	40	0	2.45	3.35	2.41	2.41	3.35	2.46	15	5	16	16	6	16	31	11	32	4	24	3	35	2	3	1	2	1	3	-1	0	1	-0.04	0.00	0.05
2078130	2023-09-06 02:45:00	40	3	1.62	3.60	4.45	1.66	3.60	4.15	2	2	4	1	3	4	3	5	8	6	4	1	9	3	2	1	1	2	3	1	0	-1	0.04	0.00	-0.30
2249295	2024-09-04 02:45:00	40	0	4.30	3.75	1.59	4.65	3.90	1.60	8	7	10	14	12	5	22	19	15	1	4	8	23	1	2	3	3	2	1	1	1	1	0.35	0.15	0.01
2078065	2023-09-06 02:45:00	40	3	1.68	3.50	4.20	1.59	3.75	4.40	5	5	9	4	8	7	9	13	16	8	4	1	17	3	2	1	1	2	3	-1	1	1	-0.09	0.25	0.20
2078129	2023-11-22 03:00:00	40	0	2.42	3.35	2.45	2.44	3.35	2.44	2	0	1	1	0	2	3	0	3	0	3	0	3	1	3	1	2	1	2	1	0	-1	0.02	0.00	-0.01
2078125	2023-10-11 02:00:00	40	3	1.85	3.70	3.20	1.86	3.65	3.50	6	5	5	5	4	6	11	9	11	1	3	1	12	1	3	1	2	1	2	1	-1	1	0.01	-0.05	0.30
2249302	2024-09-04 02:00:00	40	3	1.40	4.35	5.90	1.35	4.65	6.80	6	6	9	5	6	7	11	12	16	6	5	1	17	3	2	1	1	2	3	-1	1	1	-0.05	0.30	0.90
2078055	2023-11-15 03:00:00	40	3	1.81	3.55	3.50	1.94	3.50	3.15	2	3	5	6	1	3	8	4	8	1	5	1	9	1	3	1	2	1	2	1	-1	-1	0.13	-0.05	-0.35
2078118	2023-09-06 02:00:00	40	0	3.40	3.15	1.97	3.05	3.25	2.07	6	2	4	3	4	3	9	6	7	1	4	3	10	1	3	2	3	1	2	-1	1	1	-0.35	0.10	0.10
2078115	2023-10-11 02:45:00	40	3	1.54	3.80	4.85	1.50	4.15	5.30	9	5	11	10	12	10	19	17	21	2	4	0	21	2	3	1	2	1	3	-1	1	1	-0.04	0.35	0.45
2078051	2023-11-15 03:00:00	40	3	1.52	3.95	4.75	1.51	3.95	4.80	4	4	5	6	4	4	10	8	9	0	2	1	10	1	3	2	3	1	2	-1	0	1	-0.01	0.00	0.05
2249311	2024-09-04 02:00:00	40	3	2.50	3.45	2.24	2.47	3.55	2.42	8	2	5	5	5	9	13	7	14	2	8	1	15	2	3	1	2	1	3	-1	1	1	-0.03	0.10	0.18
2044127	2023-09-10 17:00:00	41	1	2.46	2.95	2.67	2.33	2.98	2.81	4	3	4	2	4	4	6	7	8	3	2	1	9	3	2	1	1	2	3	-1	1	1	-0.13	0.03	0.14
2189985	2024-04-24 18:00:00	41	0	5.00	3.95	1.50	4.95	3.90	1.51	2	2	1	1	1	2	3	3	3	2	2	2	5	1	1	1	1	1	1	-1	-1	1	-0.05	-0.05	0.01
2189984	2024-04-24 18:00:00	41	0	2.33	3.35	2.55	2.37	3.30	2.53	3	1	3	4	0	4	7	1	7	1	7	1	8	1	3	1	2	1	2	1	-1	-1	0.04	-0.05	-0.02
2044125	2023-09-10 18:00:00	41	3	1.95	3.30	3.30	2.02	3.25	3.15	1	1	3	3	0	1	4	1	4	0	3	0	4	1	3	1	2	1	2	1	-1	-1	0.07	-0.05	-0.15
2044124	2023-09-10 18:00:00	41	3	2.49	2.93	2.65	2.53	2.96	2.58	0	1	2	2	1	0	2	2	2	0	0	0	2	1	1	1	1	1	1	1	1	-1	0.04	0.03	-0.07
2111971	2023-10-11 18:00:00	41	3	2.59	2.88	2.59	2.70	2.91	2.46	0	1	3	3	1	1	3	2	4	1	2	0	4	2	3	1	2	1	3	1	1	-1	0.11	0.03	-0.13
2044123	2023-09-06 18:30:00	41	1	2.38	3.00	2.71	2.38	3.00	2.71	0	0	1	0	0	0	0	0	1	1	1	0	1	2	2	1	1	1	3	0	0	0	0.00	0.00	0.00
2111972	2023-10-11 18:00:00	41	3	2.02	3.60	2.89	2.13	3.50	2.75	1	1	4	3	1	1	4	2	5	1	3	0	5	2	3	1	2	1	3	1	-1	-1	0.11	-0.10	-0.14
2114788	2023-11-04 12:05:00	41	3	3.30	3.10	2.19	3.35	3.10	2.19	1	0	0	1	1	0	2	1	0	0	1	2	2	1	2	3	3	2	1	1	0	0	0.05	0.00	0.00
2044122	2023-09-06 18:00:00	41	3	2.44	3.60	2.32	2.40	3.50	2.38	5	2	6	7	1	6	12	3	12	2	11	2	14	1	3	1	2	1	2	-1	-1	1	-0.04	-0.10	0.06
2111973	2023-10-15 14:00:00	41	0	1.96	3.20	3.35	1.97	3.15	3.40	4	1	4	4	0	4	8	1	8	2	9	2	10	1	3	1	2	1	2	1	-1	1	0.01	-0.05	0.05
2044121	2023-09-06 18:00:00	41	0	2.69	3.05	2.37	2.74	3.05	2.33	2	1	3	3	0	2	5	1	5	0	4	0	5	1	3	1	2	1	2	1	0	-1	0.05	0.00	-0.04
2111974	2023-10-15 16:00:00	41	3	2.20	3.35	2.71	2.20	3.35	2.71	0	0	1	1	0	0	1	0	1	0	1	0	1	1	3	1	2	1	2	0	0	0	0.00	0.00	0.00
2297527	2024-10-09 18:00:00	41	3	2.43	3.45	2.38	2.43	3.45	2.38	2	1	0	1	1	0	3	2	0	0	1	3	3	1	2	3	3	2	1	0	0	0	0.00	0.00	0.00
1966534	2023-06-18 17:00:00	41	0	2.58	3.35	2.53	2.65	3.35	2.46	1	0	2	2	0	1	3	0	3	0	3	0	3	1	3	1	2	1	2	1	0	-1	0.07	0.00	-0.07
1966535	2023-06-18 17:00:00	41	0	2.33	3.30	2.87	2.33	3.30	2.87	0	0	1	1	0	0	1	0	1	0	1	0	1	1	3	1	2	1	2	0	0	0	0.00	0.00	0.00
2297530	2024-10-09 18:00:00	41	0	2.33	3.45	2.48	2.33	3.45	2.50	0	2	4	0	2	4	0	4	8	8	4	0	8	3	2	1	1	2	3	0	0	1	0.00	0.00	0.02
2297529	2024-10-13 14:00:00	41	0	2.22	3.35	2.68	2.35	3.35	2.53	1	2	5	3	2	3	4	4	8	6	6	2	10	2	2	1	1	1	3	1	0	-1	0.13	0.00	-0.15
2297528	2024-10-13 14:00:00	41	0	1.91	3.70	3.05	1.90	3.75	3.05	3	0	1	1	1	1	4	1	2	0	3	2	4	1	3	2	3	1	2	-1	1	0	-0.01	0.05	0.00
2217283	2024-06-05 18:00:00	41	0	3.45	3.45	1.85	3.20	3.40	1.95	6	3	7	6	2	6	12	5	13	1	8	0	13	2	3	1	2	1	3	-1	-1	1	-0.25	-0.05	0.10
2217282	2024-06-05 18:00:00	41	1	2.14	3.00	3.15	2.31	3.00	2.82	1	1	2	2	1	1	3	2	3	2	3	2	5	1	3	1	2	1	2	1	0	-1	0.17	0.00	-0.33
2217285	2024-06-05 18:00:00	41	0	2.85	3.15	2.22	2.63	3.15	2.36	3	1	2	1	1	2	4	2	4	0	2	0	4	1	3	1	2	1	2	-1	0	1	-0.22	0.00	0.14
2217284	2024-06-05 18:00:00	41	3	2.09	3.30	2.96	2.07	3.30	2.98	2	1	4	3	1	2	5	2	6	1	4	0	6	2	3	1	2	1	3	-1	0	1	-0.02	0.00	0.02
2217924	2024-06-09 13:00:00	41	1	2.04	3.30	3.05	2.07	3.35	2.97	2	2	6	6	2	1	8	4	7	0	4	1	8	1	3	2	3	1	2	1	1	-1	0.03	0.05	-0.08
1966519	2023-06-18 17:00:00	41	3	1.75	3.55	4.40	1.75	3.55	4.40	1	0	0	0	1	0	1	1	0	0	0	1	1	1	1	3	2	2	1	0	0	0	0.00	0.00	0.00
2217928	2024-06-09 15:00:00	41	3	2.27	3.15	2.77	2.27	3.15	2.77	3	1	2	2	1	3	5	2	5	0	3	0	5	1	3	1	2	1	2	0	0	0	0.00	0.00	0.00
2254091	2024-09-04 18:00:00	41	3	2.97	3.25	2.29	2.66	3.25	2.52	4	0	0	0	0	2	4	0	2	0	4	2	4	1	3	2	3	1	2	-1	0	1	-0.31	0.00	0.23
2316810	2024-11-02 12:05:00	41	1	2.54	2.95	2.59	2.45	2.97	2.66	3	0	2	1	2	2	4	2	4	1	3	1	5	1	3	1	2	1	2	-1	1	1	-0.09	0.02	0.07
2205707	2024-05-22 18:00:00	41	3	2.12	3.20	2.98	2.12	3.20	2.98	0	0	0	0	0	0	0	0	0	1	1	1	1	1	1	1	1	1	1	0	0	0	0.00	0.00	0.00
2217930	2024-06-09 17:00:00	41	1	2.72	3.40	2.19	2.61	3.40	2.26	3	1	0	0	1	2	3	2	2	1	2	2	4	1	2	2	3	1	1	-1	0	1	-0.11	0.00	0.07
2205709	2024-05-22 18:00:00	41	0	5.10	3.85	1.51	4.95	3.90	1.51	2	1	1	1	2	1	3	3	2	1	1	2	4	1	1	3	2	2	1	-1	1	0	-0.15	0.05	0.00
2254094	2024-09-04 18:00:00	41	3	1.37	5.00	6.60	1.39	4.85	6.40	2	4	3	4	1	2	6	5	5	0	1	1	6	1	2	2	3	1	1	1	-1	-1	0.02	-0.15	-0.20
2217932	2024-06-09 17:30:00	41	3	1.45	4.20	5.30	1.47	4.20	5.10	0	1	2	1	0	0	1	1	2	2	2	1	3	2	2	1	1	1	3	1	0	-1	0.02	0.00	-0.20
2254095	2024-09-04 18:00:00	41	0	3.65	3.40	1.96	3.65	3.40	1.96	1	0	3	2	0	3	3	0	6	3	6	0	6	2	3	1	2	1	3	0	0	0	0.00	0.00	0.00
2254092	2024-09-08 17:00:00	41	3	1.90	3.35	3.40	1.96	3.35	3.20	1	1	4	3	2	0	4	3	4	2	3	2	6	1	3	1	2	1	2	1	0	-1	0.06	0.00	-0.20
2254093	2024-09-08 17:00:00	41	1	3.85	3.70	1.70	3.70	3.70	1.73	1	0	0	0	0	1	1	0	1	1	2	1	2	1	3	1	2	1	2	-1	0	1	-0.15	0.00	0.03
2254098	2024-09-04 18:00:00	41	3	1.61	4.40	4.35	1.60	4.45	4.40	5	1	3	2	2	5	7	3	8	1	5	0	8	2	3	1	2	1	3	-1	1	1	-0.01	0.05	0.05
2254096	2024-09-08 17:30:00	41	0	1.57	3.70	4.65	1.56	3.70	4.75	1	1	2	1	1	2	2	2	4	2	2	0	4	2	2	1	1	1	3	-1	0	1	-0.01	0.00	0.10
2254097	2024-09-08 13:00:00	41	3	3.15	3.70	1.88	2.90	3.65	1.99	8	2	2	2	1	8	10	3	10	3	10	3	13	1	3	1	2	1	2	-1	-1	1	-0.25	-0.05	0.11
2189975	2024-04-17 18:00:00	41	0	2.39	3.15	2.60	2.41	3.20	2.56	1	0	2	2	1	1	3	1	3	1	3	1	4	1	3	1	2	1	2	1	1	-1	0.02	0.05	-0.04
2189976	2024-04-17 18:00:00	41	0	2.95	3.15	2.17	2.86	3.15	2.20	2	0	1	1	0	2	3	0	3	1	4	1	4	1	3	1	2	1	2	-1	0	1	-0.09	0.00	0.03
2167643	2024-03-06 18:00:00	41	1	2.62	3.20	2.36	2.62	3.20	2.36	1	0	0	0	1	0	1	1	0	0	0	1	1	1	1	3	2	2	1	0	0	0	0.00	0.00	0.00
2167645	2024-03-06 18:00:00	41	3	3.55	3.35	1.83	3.35	3.35	1.91	1	0	1	1	0	1	2	0	2	0	2	0	2	1	3	1	2	1	2	-1	0	1	-0.20	0.00	0.08
2189980	2024-04-17 18:00:00	41	3	2.17	3.35	2.78	2.33	3.35	2.53	0	0	5	5	0	0	5	0	5	1	6	1	6	1	3	1	2	1	2	1	0	-1	0.16	0.00	-0.25
1966496	2023-06-18 17:00:00	41	1	3.15	3.50	2.11	3.30	3.50	2.03	1	1	2	2	2	1	3	3	3	1	1	1	4	1	1	1	1	1	1	1	0	-1	0.15	0.00	-0.08
2189983	2024-04-24 18:00:00	41	1	2.91	3.10	2.24	2.76	3.05	2.32	3	1	0	0	0	3	3	1	3	1	3	1	4	1	3	1	2	1	2	-1	-1	1	-0.15	-0.05	0.08
1920543	2023-09-12 02:45:00	42	3	3.15	3.10	2.19	3.00	3.20	2.47	13	5	3	10	7	3	23	12	6	1	12	18	24	1	2	3	3	2	1	-1	1	1	-0.15	0.10	0.28
1920542	2023-06-18 02:45:00	42	0	2.64	3.15	2.62	2.63	3.10	2.89	14	3	9	12	2	18	26	5	27	1	22	0	27	2	3	1	2	1	3	-1	-1	1	-0.01	-0.05	0.27
1920537	2023-10-14 02:45:00	42	3	1.24	5.90	9.80	1.22	6.30	14.00	7	4	7	5	9	8	12	13	15	6	5	3	18	3	2	1	1	2	3	-1	1	1	-0.02	0.40	4.20
1920538	2023-10-17 02:45:00	42	0	6.60	4.15	1.52	6.60	4.25	1.51	5	2	3	5	5	4	10	7	7	0	3	3	10	1	2	2	3	1	1	0	1	-1	0.00	0.10	-0.01
1920535	2023-09-09 02:45:00	42	0	6.80	4.35	1.42	7.00	4.30	1.48	11	8	10	14	9	12	25	17	22	1	9	4	26	1	3	2	3	1	2	1	-1	1	0.20	-0.05	0.06
1920534	2023-06-21 02:45:00	42	0	8.90	5.50	1.28	11.00	5.40	1.29	9	9	7	7	8	7	16	17	14	7	6	9	23	2	1	3	2	3	1	1	-1	1	2.10	-0.10	0.01
1920317	2023-06-18 02:45:00	42	3	1.15	7.00	15.00	1.14	7.00	16.00	5	9	7	5	12	9	10	21	16	16	5	10	26	3	1	2	1	3	2	-1	0	1	-0.01	0.00	1.00
1920568	2023-09-13 02:45:00	42	3	1.28	4.80	9.10	1.37	5.10	8.40	5	3	12	6	5	9	11	8	21	11	14	1	22	2	3	1	2	1	3	1	1	-1	0.09	0.30	-0.70
1920315	2023-09-13 02:45:00	42	3	1.92	3.25	3.65	2.07	3.35	3.75	6	4	10	10	5	8	16	9	18	2	9	0	18	2	3	1	2	1	3	1	1	1	0.15	0.10	0.10
1920565	2023-06-17 02:45:00	42	0	5.40	3.70	1.60	5.30	3.90	1.66	7	2	2	4	3	6	11	5	8	1	7	4	12	1	3	2	3	1	2	-1	1	1	-0.10	0.20	0.06
1920567	2023-09-10 02:45:00	42	1	1.89	3.40	3.90	2.04	3.55	3.60	8	5	9	7	9	8	15	14	17	9	10	7	24	2	3	1	2	1	3	1	1	-1	0.15	0.15	-0.30
1920563	2023-11-22 03:45:00	42	3	3.30	3.40	2.07	3.60	3.50	2.06	15	6	20	17	7	19	32	13	39	15	34	8	47	2	3	1	2	1	3	1	1	-1	0.30	0.10	-0.01
1920562	2023-11-19 03:45:00	42	1	1.30	5.20	9.10	1.29	5.50	10.00	9	5	9	8	7	11	17	12	20	8	13	5	25	2	3	1	2	1	3	-1	1	1	-0.01	0.30	0.90
1920559	2023-09-10 02:45:00	42	1	5.60	3.85	1.56	5.60	3.90	1.63	4	3	1	2	4	3	6	7	4	4	3	6	10	2	1	3	2	3	1	0	1	1	0.00	0.05	0.07
1920551	2023-11-20 03:45:00	42	0	2.75	3.25	2.64	2.67	3.30	2.69	13	2	11	17	3	15	30	5	26	1	26	5	31	1	3	2	3	1	2	-1	1	1	-0.08	0.05	0.05
1920546	2023-09-09 02:45:00	42	3	2.50	3.15	2.75	2.70	3.10	2.79	8	2	8	11	1	10	19	3	18	0	16	1	19	1	3	2	3	1	2	1	-1	1	0.20	-0.05	0.04
1920604	2023-06-18 02:45:00	42	1	1.64	3.70	5.10	1.61	4.00	5.60	4	2	4	3	4	4	7	6	8	3	4	2	10	2	3	1	2	1	3	-1	1	1	-0.03	0.30	0.50
1920602	2023-06-18 00:00:00	42	0	2.04	3.25	3.55	2.04	3.25	3.55	3	0	1	2	0	2	5	0	3	0	5	2	5	1	3	2	3	1	2	0	0	0	0.00	0.00	0.00
1920341	2023-11-20 03:45:00	42	3	1.12	8.10	12.00	1.13	9.00	20.00	7	14	6	7	15	7	14	29	13	19	4	20	33	2	1	3	2	3	1	1	1	1	0.01	0.90	8.00
1920343	2023-06-20 02:45:00	42	1	1.38	4.55	7.40	1.39	4.65	8.70	3	4	4	3	4	4	6	8	8	4	2	2	10	3	1	1	1	2	2	1	1	1	0.01	0.10	1.30
1920598	2023-06-17 02:45:00	42	0	1.40	4.50	7.20	1.39	4.55	8.80	2	3	6	2	3	5	4	6	11	7	5	0	11	3	2	1	1	2	3	-1	1	1	-0.01	0.05	1.60
1920336	2023-11-18 03:45:00	42	3	1.52	3.85	6.20	1.58	3.85	6.40	1	4	5	4	4	5	5	8	10	8	5	3	13	3	2	1	1	2	3	1	0	1	0.06	0.00	0.20
1920595	2023-06-17 02:45:00	42	0	9.70	4.85	1.30	9.30	4.90	1.35	6	6	4	3	5	7	9	11	11	3	1	1	12	3	1	1	1	2	2	-1	1	1	-0.40	0.05	0.05
1920594	2023-06-17 00:00:00	42	3	2.51	3.05	2.82	2.51	3.05	2.84	0	1	1	0	0	3	0	1	4	4	3	0	4	3	2	1	1	2	3	0	0	1	0.00	0.00	0.02
1920585	2023-10-15 02:45:00	42	3	1.12	7.90	17.00	1.13	8.70	20.00	9	18	13	9	16	11	18	34	24	19	3	13	37	3	1	2	1	3	2	1	1	1	0.01	0.80	3.00
1920584	2023-09-11 00:00:00	42	0	5.60	3.60	1.60	6.20	3.80	1.60	1	0	0	1	1	0	2	1	0	0	1	2	2	1	2	3	3	2	1	1	1	0	0.60	0.20	0.00
1920587	2023-11-21 03:45:00	42	3	6.70	3.85	1.55	6.70	3.80	1.56	8	6	3	8	5	4	16	11	7	4	9	13	20	1	2	3	3	2	1	0	-1	1	0.00	-0.05	0.01
1920581	2023-06-17 02:45:00	42	3	1.27	5.00	12.00	1.28	5.00	10.00	5	7	5	7	6	5	12	13	10	4	3	6	16	2	1	3	2	3	1	1	0	-1	0.01	0.00	-2.00
1920324	2023-06-17 02:45:00	42	3	2.20	2.99	3.45	2.21	3.05	3.70	1	4	5	1	5	8	2	9	13	13	6	2	15	3	2	1	1	2	3	1	1	1	0.01	0.06	0.25
1920582	2023-06-20 02:45:00	42	1	4.05	3.35	1.88	4.55	3.40	1.87	1	1	5	5	2	2	6	3	7	4	7	3	10	2	3	1	2	1	3	1	1	-1	0.50	0.05	-0.01
1920321	2023-10-14 02:45:00	42	1	1.87	3.35	4.00	1.91	3.40	4.30	7	6	9	8	4	11	15	10	20	5	10	0	20	2	3	1	2	1	3	1	1	1	0.04	0.05	0.30
1920636	2023-09-09 21:00:00	42	0	12.00	6.30	1.19	12.00	6.30	1.19	0	1	0	0	0	0	0	1	0	1	0	1	1	2	1	2	1	3	1	0	0	0	0.00	0.00	0.00
1920639	2023-09-10 21:00:00	42	3	3.05	2.95	2.42	3.05	2.96	2.42	0	1	0	0	1	0	0	2	0	2	0	2	2	2	1	2	1	3	1	0	1	0	0.00	0.01	0.00
1920638	2023-09-10 02:45:00	42	1	9.50	5.20	1.28	10.00	5.00	1.33	13	11	9	11	11	12	24	22	21	8	10	11	32	1	2	3	3	2	1	1	-1	1	0.50	-0.20	0.05
1920632	2023-09-09 02:45:00	42	3	1.06	11.00	20.00	1.09	12.00	21.00	3	2	7	4	3	8	7	5	15	9	11	1	16	2	3	1	2	1	3	1	1	1	0.03	1.00	1.00
1920635	2023-09-10 00:00:00	42	0	8.20	4.65	1.35	7.90	4.80	1.35	3	3	5	5	5	4	8	8	9	1	1	0	9	2	2	1	1	1	3	-1	1	0	-0.30	0.15	0.00
1920634	2023-09-09 02:45:00	42	1	1.30	5.20	8.00	1.33	5.30	9.30	2	1	2	2	3	5	4	4	7	3	3	0	7	2	2	1	1	1	3	1	1	1	0.03	0.10	1.30
1920628	2023-09-08 02:45:00	42	0	1.79	3.35	4.45	1.77	3.50	5.00	2	2	5	2	4	3	4	6	8	4	2	0	8	3	2	1	1	2	3	-1	1	1	-0.02	0.15	0.55
1920631	2023-09-09 02:45:00	42	0	8.40	4.85	1.33	11.00	5.20	1.30	3	3	7	6	5	4	9	8	11	5	6	3	14	2	3	1	2	1	3	1	1	-1	2.60	0.35	-0.03
1920630	2023-09-09 00:00:00	42	0	7.80	4.90	1.33	9.30	5.10	1.34	3	3	8	9	8	2	12	11	10	1	2	3	13	1	2	3	3	2	1	1	1	1	1.50	0.20	0.01
1920627	2023-09-08 02:45:00	42	3	1.40	4.50	7.10	1.43	4.50	7.90	4	3	4	4	4	7	8	7	11	3	4	0	11	2	3	1	2	1	3	1	0	1	0.03	0.00	0.80
1920621	2023-06-21 02:45:00	42	3	1.50	3.95	6.30	1.49	4.15	7.30	1	1	2	1	5	3	2	6	5	5	1	2	7	3	1	2	1	3	2	-1	1	1	-0.01	0.20	1.00
1920620	2023-06-21 02:45:00	42	3	1.12	8.10	15.00	1.12	8.80	24.00	18	19	20	15	24	22	33	43	42	14	4	5	47	3	1	2	1	3	2	0	1	1	0.00	0.70	9.00
1920616	2023-06-21 02:45:00	42	0	9.40	5.70	1.25	14.00	6.00	1.24	11	8	7	16	10	6	27	18	13	4	13	18	31	1	2	3	3	2	1	1	1	-1	4.60	0.30	-0.01
1920619	2023-06-21 02:45:00	42	3	10.00	5.40	1.25	11.00	5.50	1.28	6	6	3	3	5	6	9	11	9	4	2	4	13	2	1	2	1	3	1	1	1	1	1.00	0.10	0.03
1920357	2023-11-21 03:45:00	42	1	14.00	7.30	1.12	15.00	6.70	1.19	9	22	7	7	14	12	16	36	19	31	11	28	47	3	1	2	1	3	2	1	-1	1	1.00	-0.60	0.07
1920612	2023-06-20 02:45:00	42	3	1.85	3.35	4.15	1.86	3.45	4.50	5	1	5	5	2	6	10	3	11	1	8	0	11	2	3	1	2	1	3	1	1	1	0.01	0.10	0.35
1920615	2023-06-21 02:45:00	42	3	2.08	3.30	3.35	2.08	3.45	3.60	7	4	9	13	7	6	20	11	15	3	12	8	23	1	3	2	3	1	2	0	1	1	0.00	0.15	0.25
1920614	2023-06-21 02:45:00	42	1	5.70	3.95	1.53	7.80	4.35	1.45	6	4	3	8	7	3	14	11	6	1	4	9	15	1	2	3	3	2	1	1	1	-1	2.10	0.40	-0.08
1920353	2023-06-20 02:45:00	42	3	1.12	8.70	13.00	1.11	9.10	14.00	3	6	6	3	7	5	6	13	11	8	1	3	14	3	1	2	1	3	2	-1	1	1	-0.01	0.40	1.00
1920611	2023-06-20 02:45:00	42	0	1.62	3.60	5.50	1.66	3.60	5.90	0	2	5	2	3	2	2	5	7	7	4	2	9	3	2	1	1	2	3	1	0	1	0.04	0.00	0.40
1920355	2023-10-18 02:45:00	42	3	1.66	3.55	4.20	1.70	3.60	5.40	1	4	7	7	3	3	8	7	10	7	8	5	15	2	3	1	2	1	3	1	1	1	0.04	0.05	1.20
1920354	2023-09-10 00:00:00	42	1	7.20	4.55	1.39	6.80	4.65	1.39	8	2	4	5	4	4	13	6	8	2	9	7	15	1	3	2	3	1	2	-1	1	0	-0.40	0.10	0.00
1920669	2023-10-15 02:45:00	42	3	2.58	3.15	2.66	2.79	3.25	2.61	17	4	19	16	6	17	33	10	36	6	29	3	39	2	3	1	2	1	3	1	1	-1	0.21	0.10	-0.05
1920665	2023-10-14 02:45:00	42	0	2.44	3.00	2.96	2.56	3.00	3.05	0	2	4	3	2	3	3	4	7	4	3	0	7	3	2	1	1	2	3	1	0	1	0.12	0.00	0.09
1920664	2023-10-14 00:00:00	42	0	2.29	2.98	3.25	2.29	3.05	3.50	0	2	2	1	2	2	1	4	4	3	0	0	4	3	1	1	1	2	2	0	1	1	0.00	0.07	0.25
1920661	2023-10-14 02:45:00	42	0	2.72	3.35	2.42	2.67	3.40	2.63	24	8	20	22	9	22	46	17	42	5	34	9	51	1	3	2	3	1	2	-1	1	1	-0.05	0.05	0.21
1920660	2023-10-13 02:45:00	42	3	1.24	5.60	11.00	1.25	5.80	13.00	2	4	7	8	3	3	10	7	10	3	6	3	13	1	3	1	2	1	2	1	1	1	0.01	0.20	2.00
1920657	2023-10-13 02:45:00	42	0	13.00	6.50	1.18	17.00	6.60	1.19	7	4	7	9	4	7	16	8	14	5	13	7	21	1	3	2	3	1	2	1	1	1	4.00	0.10	0.01
1920656	2023-10-13 02:45:00	42	0	1.60	3.80	6.10	1.65	3.75	5.60	1	1	2	2	1	2	3	2	4	1	2	0	4	2	3	1	2	1	3	1	-1	-1	0.05	-0.05	-0.50
1920659	2023-10-13 00:00:00	42	3	4.15	3.30	1.87	4.45	3.65	1.81	9	3	7	9	7	6	18	10	13	1	9	6	19	1	3	2	3	1	2	1	1	-1	0.30	0.35	-0.06
1920652	2023-09-13 02:45:00	42	3	1.48	4.30	7.10	1.48	4.30	7.00	0	0	1	1	1	1	1	1	2	1	1	0	2	2	2	1	1	1	3	0	0	-1	0.00	0.00	-0.10
1920654	2023-09-13 02:45:00	42	0	2.31	3.15	2.88	2.47	3.25	2.95	1	3	7	2	4	5	3	7	12	9	5	0	12	3	2	1	1	2	3	1	1	1	0.16	0.10	0.07
1920649	2023-09-13 02:45:00	42	3	1.23	5.10	12.00	1.26	5.80	12.00	12	9	7	12	13	9	24	22	16	0	2	8	24	1	2	3	3	2	1	1	1	0	0.03	0.70	0.00
1920651	2023-09-13 02:45:00	42	3	1.04	12.00	18.00	1.09	11.00	22.00	3	3	8	5	3	9	8	6	17	10	12	1	18	2	3	1	2	1	3	1	-1	1	0.05	-1.00	4.00
1920644	2023-09-11 02:45:00	42	0	5.40	4.05	1.62	5.20	3.75	1.69	6	9	1	4	6	5	10	15	6	6	1	10	16	2	1	3	2	3	1	-1	-1	1	-0.20	-0.30	0.07
1920647	2023-09-12 00:00:00	42	0	7.90	4.55	1.33	8.10	4.75	1.40	3	2	3	3	2	4	6	4	7	2	4	1	8	2	3	1	2	1	3	1	1	1	0.20	0.20	0.07
1920641	2023-09-11 00:00:00	42	3	1.76	3.25	4.85	1.69	3.50	5.80	2	1	1	0	3	4	2	4	5	3	1	0	5	3	2	1	1	2	3	-1	1	1	-0.07	0.25	0.95
1920642	2023-09-11 02:45:00	42	3	3.40	3.10	2.16	3.20	3.15	2.38	5	3	0	1	3	3	6	6	3	2	2	5	8	1	1	3	2	2	1	-1	1	1	-0.20	0.05	0.22
1920701	2023-11-18 01:00:00	42	3	1.92	3.25	4.00	1.98	3.30	4.10	9	4	7	8	3	10	17	7	17	3	13	3	20	1	3	1	2	1	2	1	1	1	0.06	0.05	0.10
1920702	2023-11-18 03:45:00	42	3	1.13	7.50	17.00	1.16	7.60	19.00	5	11	12	6	10	11	11	21	23	17	7	5	28	3	2	1	1	2	3	1	1	1	0.03	0.10	2.00
1920696	2023-11-17 01:00:00	42	1	3.50	3.40	2.13	3.35	3.35	2.21	2	1	1	3	1	1	5	2	2	0	3	3	5	1	2	2	3	1	1	-1	-1	1	-0.15	-0.05	0.08
1920698	2023-11-17 01:00:00	42	0	36.00	16.00	1.04	36.00	16.00	1.04	0	0	0	0	0	0	0	0	0	1	1	1	1	1	1	1	1	1	1	0	0	0	0.00	0.00	0.00
1920695	2023-11-17 01:00:00	42	3	6.90	4.35	1.42	7.70	4.55	1.44	7	7	4	9	6	6	16	13	10	2	5	8	18	1	2	3	3	2	1	1	1	1	0.80	0.20	0.02
1920685	2023-10-18 00:00:00	42	0	1.63	3.50	4.55	1.62	3.65	6.30	1	1	2	0	1	5	1	2	7	6	5	0	7	3	2	1	1	2	3	-1	1	1	-0.01	0.15	1.75
1920684	2023-10-17 02:45:00	42	0	3.40	3.15	1.96	4.15	3.45	1.92	14	8	20	24	10	10	38	18	30	1	21	9	39	1	3	2	3	1	2	1	1	-1	0.75	0.30	-0.04
2135187	2024-03-27 03:45:00	42	3	1.46	4.10	6.90	1.54	4.05	6.40	4	8	9	8	7	7	12	15	16	4	1	0	16	3	2	1	1	2	3	1	-1	-1	0.08	-0.05	-0.50
1920681	2023-10-16 02:45:00	42	3	3.55	3.15	1.93	4.30	3.40	1.92	9	3	12	11	5	8	20	8	20	4	16	4	24	1	3	1	2	1	2	1	1	-1	0.75	0.25	-0.01
2135188	2024-03-27 01:00:00	42	1	3.25	3.10	2.23	3.30	3.10	2.35	5	3	0	5	4	2	10	7	2	4	7	12	14	1	2	3	3	2	1	1	0	1	0.05	0.00	0.12
1920680	2023-10-16 02:45:00	42	3	1.11	7.90	12.00	1.16	7.60	17.00	3	13	9	9	8	6	12	21	15	10	1	7	22	3	1	2	1	3	2	1	-1	1	0.05	-0.30	5.00
2135189	2024-03-27 03:45:00	42	1	2.40	2.99	2.71	2.60	3.10	2.92	6	3	14	12	4	14	18	7	28	11	22	1	29	2	3	1	2	1	3	1	1	1	0.20	0.11	0.21
1920679	2023-10-16 02:45:00	42	1	1.18	6.00	9.50	1.25	5.70	13.00	12	14	14	18	10	10	30	24	24	6	12	12	36	1	2	2	3	1	1	1	-1	1	0.07	-0.30	3.50
1920678	2023-10-16 02:45:00	42	0	3.10	3.45	1.96	3.75	3.60	1.98	25	13	33	29	15	25	54	28	58	17	43	13	71	2	3	1	2	1	3	1	1	1	0.65	0.15	0.02
1920674	2023-11-20 01:00:00	42	3	1.02	13.00	25.00	1.06	13.00	34.00	2	2	0	3	3	2	5	5	2	2	2	5	7	1	1	3	2	2	1	1	0	1	0.04	0.00	9.00
1920720	2023-11-22 03:45:00	42	1	2.19	3.45	3.30	2.38	3.40	2.99	0	2	5	3	2	5	3	4	10	7	6	0	10	3	2	1	1	2	3	1	-1	-1	0.19	-0.05	-0.31
1920717	2023-11-21 03:45:00	42	1	4.60	3.55	1.81	4.45	3.60	1.83	15	5	15	13	6	16	28	11	31	6	23	3	34	2	3	1	2	1	3	-1	1	1	-0.15	0.05	0.02
1920461	2023-11-22 03:45:00	42	1	6.00	4.00	1.58	5.60	4.00	1.61	7	4	2	5	5	4	12	9	6	0	3	6	12	1	2	3	3	2	1	-1	0	1	-0.40	0.00	0.03
1920716	2023-11-21 03:45:00	42	3	1.49	3.85	5.90	1.50	4.05	7.40	2	2	3	2	5	3	4	7	6	4	1	2	8	3	1	2	1	3	2	1	1	1	0.01	0.20	1.50
1920718	2023-11-22 03:45:00	42	3	1.17	7.20	18.00	1.17	7.40	17.00	5	7	5	7	7	4	12	14	9	6	4	9	18	2	1	3	2	3	1	0	1	-1	0.00	0.20	-1.00
1920457	2023-06-20 02:45:00	42	3	1.23	6.00	10.00	1.22	6.20	15.00	4	2	2	3	4	4	7	6	6	3	4	4	10	1	2	2	3	1	1	-1	1	1	-0.01	0.20	5.00
1920712	2023-11-20 03:45:00	42	3	1.06	11.00	20.00	1.07	12.00	31.00	0	0	0	2	1	2	2	1	2	0	1	0	2	1	3	1	2	1	2	1	1	1	0.01	1.00	11.00
1920459	2023-10-14 02:45:00	42	0	2.95	3.35	2.25	3.15	3.45	2.25	8	8	3	11	7	3	19	15	6	6	10	19	25	1	2	3	3	2	1	1	1	0	0.20	0.10	0.00
1920458	2023-09-08 02:45:00	42	3	1.19	6.30	12.00	1.21	6.40	17.00	4	5	2	4	9	5	8	14	7	8	2	9	16	2	1	3	2	3	1	1	1	1	0.02	0.10	5.00
1920714	2023-11-21 03:45:00	42	3	1.21	5.80	9.60	1.25	5.70	14.00	8	6	5	11	6	5	19	12	10	6	13	15	25	1	2	3	3	2	1	1	-1	1	0.04	-0.10	4.40
1920709	2023-11-19 22:00:00	42	1	1.21	6.20	9.00	1.22	6.60	13.00	5	6	9	4	6	7	9	12	16	9	6	2	18	3	2	1	1	2	3	1	1	1	0.01	0.40	4.00
1920708	2023-11-19 22:00:00	42	3	1.72	3.55	4.25	1.69	3.60	5.20	1	1	2	1	1	1	2	2	3	3	3	2	5	2	2	1	1	1	3	-1	1	1	-0.03	0.05	0.95
1920711	2023-11-20 03:45:00	42	1	2.17	3.25	3.00	2.23	3.25	3.40	0	5	5	1	4	6	1	9	11	10	2	0	11	3	2	1	1	2	3	1	0	1	0.06	0.00	0.40
1920710	2023-11-20 01:00:00	42	3	1.13	7.10	15.00	1.16	8.00	18.00	1	7	3	4	6	4	5	13	7	9	1	7	14	3	1	2	1	3	2	1	1	1	0.03	0.90	3.00
1920705	2023-11-18 22:00:00	42	1	4.10	3.40	1.84	4.35	3.45	1.89	7	6	8	8	5	7	15	11	15	3	7	3	18	1	3	1	2	1	2	1	1	1	0.25	0.05	0.05
1920704	2023-11-18 03:45:00	42	1	2.40	3.20	2.87	2.51	3.20	2.93	2	5	7	1	3	13	3	8	20	17	12	0	20	3	2	1	1	2	3	1	0	1	0.11	0.00	0.06
1920706	2023-11-19 01:00:00	42	0	14.00	8.20	1.13	24.00	8.60	1.12	6	8	7	8	9	7	14	17	14	9	6	9	23	2	1	2	1	3	1	1	1	-1	10.00	0.40	-0.01
2128847	2024-03-22 03:45:00	42	3	1.17	6.70	8.40	1.17	6.90	18.00	3	9	9	4	8	10	7	17	19	18	8	6	25	3	2	1	1	2	3	0	1	1	0.00	0.20	9.60
2128848	2024-03-22 03:45:00	42	3	1.86	3.05	3.95	1.89	3.30	4.65	12	2	12	12	4	16	24	6	28	7	25	3	31	2	3	1	2	1	3	1	1	1	0.03	0.25	0.70
2128849	2024-03-22 03:45:00	42	0	3.40	3.25	1.92	3.70	3.40	2.06	11	4	13	11	4	12	22	8	25	5	19	2	27	2	3	1	2	1	3	1	1	1	0.30	0.15	0.14
2128851	2024-03-22 01:00:00	42	3	1.78	3.15	4.15	1.81	3.40	4.90	5	3	8	5	5	9	10	8	17	8	10	1	18	2	3	1	2	1	3	1	1	1	0.03	0.25	0.75
2128852	2024-03-22 03:45:00	42	3	1.34	4.50	6.90	1.35	4.65	11.00	6	8	8	6	11	11	12	19	19	11	4	4	23	3	1	1	1	2	2	1	1	1	0.01	0.15	4.10
2095120	2024-11-20 08:00:00	43	3	2.08	3.10	3.60	2.00	3.10	3.90	16	7	11	7	7	19	23	14	30	12	21	5	35	2	3	1	2	1	3	-1	0	1	-0.08	0.00	0.30
2095119	2024-11-20 07:00:00	43	0	1.57	3.55	5.00	1.63	3.50	5.50	7	6	10	7	5	9	14	11	19	8	11	3	22	2	3	1	2	1	3	1	-1	1	0.06	-0.05	0.50
2095118	2024-11-16 09:30:00	43	1	2.26	2.90	3.40	2.42	2.63	3.50	20	28	17	24	22	20	44	50	37	24	18	31	68	2	1	3	2	3	1	1	-1	1	0.16	-0.27	0.10
2095117	2024-11-16 08:00:00	43	3	2.26	2.96	3.35	2.26	2.96	3.35	4	12	9	4	11	9	8	23	18	15	0	5	23	3	1	2	1	3	2	0	0	0	0.00	0.00	0.00
2095116	2024-10-16 07:30:00	43	1	1.71	3.35	5.10	1.75	3.25	5.90	3	5	7	3	3	9	6	8	16	12	10	2	18	3	2	1	1	2	3	1	-1	1	0.04	-0.10	0.80
2095115	2024-11-15 05:00:00	43	1	5.30	3.75	1.52	6.10	3.85	1.60	16	14	9	15	11	16	31	25	25	10	16	16	41	1	2	2	3	1	1	1	1	1	0.80	0.10	0.08
2095114	2024-11-15 07:30:00	43	3	5.10	3.55	1.66	5.50	3.35	1.75	13	8	3	11	3	10	24	11	13	2	15	13	26	1	3	2	3	1	2	1	-1	1	0.40	-0.20	0.09
2095113	2024-10-16 08:45:00	43	3	1.19	6.20	13.00	1.20	6.30	17.00	9	10	8	8	12	11	17	22	19	10	5	8	27	3	1	2	1	3	2	1	1	1	0.01	0.10	4.00
2095112	2024-10-16 08:00:00	43	3	1.05	12.00	23.00	1.07	13.00	23.00	4	3	9	6	4	6	10	7	15	10	13	5	20	2	3	1	2	1	3	1	1	0	0.02	1.00	0.00
2232890	2024-09-06 00:00:00	43	0	1.70	3.45	4.15	1.65	3.55	4.35	2	1	2	2	3	3	4	4	5	2	2	1	6	2	2	1	1	1	3	-1	1	1	-0.05	0.10	0.20
2095111	2024-10-16 04:30:00	43	3	1.38	4.20	8.50	1.40	4.40	9.40	9	7	12	10	9	13	19	16	25	8	11	2	27	2	3	1	2	1	3	1	1	1	0.02	0.20	0.90
2232891	2024-09-06 00:00:00	43	3	1.04	9.70	20.00	1.04	9.50	20.00	3	5	4	2	4	4	5	9	8	5	1	2	10	3	1	2	1	3	2	0	-1	0	0.00	-0.20	0.00
2095110	2024-10-16 07:00:00	43	3	2.01	2.91	3.60	2.09	2.99	4.20	5	13	12	11	7	8	16	20	20	7	3	3	23	3	1	1	1	2	2	1	1	1	0.08	0.08	0.60
2095109	2024-10-12 09:30:00	43	3	3.70	3.15	2.03	3.90	3.05	2.01	10	4	17	15	3	14	25	7	31	8	26	2	33	2	3	1	2	1	3	1	-1	-1	0.20	-0.10	-0.02
2095108	2024-10-11 08:00:00	43	0	6.80	3.85	1.48	6.00	3.55	1.58	9	9	8	10	6	7	19	15	15	2	6	6	21	1	2	2	3	1	1	-1	-1	1	-0.80	-0.30	0.10
2232894	2024-09-10 22:00:00	43	0	6.30	3.70	1.45	5.90	3.80	1.47	4	2	1	1	4	2	5	6	3	3	2	5	8	2	1	3	2	3	1	-1	1	1	-0.40	0.10	0.02
2095107	2024-10-11 05:00:00	43	1	7.70	4.05	1.42	7.20	3.80	1.47	2	2	0	2	1	2	4	3	2	0	1	2	4	1	2	3	3	2	1	-1	-1	1	-0.50	-0.25	0.05
2232893	2024-09-11 00:00:00	43	0	4.00	3.30	1.77	4.45	3.60	1.62	5	2	9	12	6	4	17	8	13	0	9	4	17	1	3	2	3	1	2	1	1	-1	0.45	0.30	-0.15
2095104	2024-09-11 08:30:00	43	3	7.30	3.85	1.54	7.00	3.80	1.56	15	10	12	18	13	8	33	23	20	4	14	17	37	1	2	3	3	2	1	-1	-1	1	-0.30	-0.05	0.02
2095151	2024-11-20 08:00:00	43	3	1.17	7.00	13.00	1.18	6.40	13.00	6	11	8	7	9	9	13	20	17	18	11	14	31	3	1	2	1	3	2	1	-1	0	0.01	-0.60	0.00
2095149	2024-11-20 04:00:00	43	1	1.54	3.70	4.85	1.95	3.05	4.20	13	18	22	24	6	17	37	24	39	9	22	7	46	2	3	1	2	1	3	1	-1	-1	0.41	-0.65	-0.65
2095144	2024-11-20 08:45:00	43	1	1.64	3.55	5.30	1.64	3.50	5.40	7	9	8	6	10	11	13	19	19	12	6	6	25	3	1	1	1	2	2	0	-1	1	0.00	-0.05	0.10
2232930	2024-10-16 00:00:00	43	3	1.78	3.25	3.95	1.67	3.30	4.55	6	3	2	2	6	7	8	9	9	1	0	0	9	3	1	1	1	2	2	-1	1	1	-0.11	0.05	0.60
2232929	2024-10-15 19:00:00	43	3	1.44	3.55	6.90	1.47	3.45	6.60	3	5	2	2	4	3	5	9	5	4	0	4	9	2	1	2	1	3	1	1	-1	-1	0.03	-0.10	-0.30
2232934	2024-11-14 22:00:00	43	0	9.50	6.20	1.17	14.00	6.30	1.18	5	2	3	5	4	3	10	6	6	1	5	5	11	1	2	2	3	1	1	1	1	1	4.50	0.10	0.01
2232937	2024-11-20 02:15:00	43	1	4.60	3.60	1.60	4.75	3.60	1.64	7	4	2	8	3	3	15	7	5	1	9	11	16	1	2	3	3	2	1	1	0	1	0.15	0.00	0.04
2232954	2024-09-06 02:00:00	43	1	1.29	4.70	7.90	1.27	4.95	7.80	11	7	14	7	13	12	18	20	26	8	6	0	26	3	2	1	1	2	3	-1	1	-1	-0.02	0.25	-0.10
2232955	2024-09-11 00:00:00	43	0	8.60	6.10	1.20	8.00	5.80	1.22	19	7	8	17	6	10	36	13	18	2	25	20	38	1	3	2	3	1	2	-1	-1	1	-0.60	-0.30	0.02
2232952	2024-09-05 18:35:00	43	3	1.08	8.40	14.00	1.08	7.90	15.00	10	16	14	8	24	14	18	40	28	26	4	16	44	3	1	2	1	3	2	0	-1	1	0.00	-0.50	1.00
2232953	2024-09-05 18:10:00	43	0	1.20	5.20	11.00	1.16	5.60	13.00	4	4	5	3	6	5	7	10	10	6	3	3	13	3	1	1	1	2	2	-1	1	1	-0.04	0.40	2.00
2232958	2024-10-10 17:10:00	43	3	1.07	7.80	18.00	1.11	7.10	13.00	4	7	11	6	9	4	10	16	15	9	3	4	19	3	1	2	1	3	2	1	-1	-1	0.04	-0.70	-5.00
2232959	2024-10-11 02:00:00	43	0	5.30	3.60	1.53	4.70	3.55	1.59	8	4	6	8	3	6	16	7	12	1	10	5	17	1	3	2	3	1	2	-1	-1	1	-0.60	-0.05	0.06
2123390	2023-11-21 21:30:00	43	0	5.40	4.00	1.46	5.50	4.00	1.46	0	0	0	1	0	0	1	0	0	1	2	2	2	1	2	2	3	1	1	1	0	0	0.10	0.00	0.00
2232956	2024-09-10 20:00:00	43	0	6.90	4.00	1.37	6.20	4.10	1.40	30	21	30	32	24	26	62	45	56	7	24	13	69	1	3	2	3	1	2	-1	1	1	-0.70	0.10	0.03
2232957	2024-09-10 20:00:00	43	1	4.40	3.35	1.67	4.80	3.75	1.55	12	6	9	9	9	9	21	15	18	3	9	6	24	1	3	2	3	1	2	1	1	-1	0.40	0.40	-0.12
2232897	2024-10-10 22:00:00	43	1	3.30	3.00	2.06	3.15	2.99	2.14	2	1	1	0	0	3	2	1	4	3	4	1	5	2	3	1	2	1	3	-1	-1	1	-0.15	-0.01	0.08
2232902	2024-11-15 00:15:00	43	3	2.71	2.94	2.44	2.81	3.05	2.53	6	0	3	4	2	7	10	2	10	0	8	0	10	1	3	1	2	1	2	1	1	1	0.10	0.11	0.09
2232900	2024-10-15 22:00:00	43	3	1.56	3.50	5.10	1.46	3.70	6.10	5	1	2	0	4	7	5	5	9	5	5	1	10	2	2	1	1	1	3	-1	1	1	-0.10	0.20	1.00
2232906	2024-11-20 00:00:00	43	3	2.37	3.25	2.58	2.62	3.30	2.41	7	3	10	11	4	8	18	7	18	3	14	3	21	1	3	1	2	1	2	1	1	-1	0.25	0.05	-0.17
2089078	2023-09-09 07:00:00	43	3	1.66	3.70	5.60	1.67	3.65	5.60	4	5	6	4	6	8	8	11	14	6	3	0	14	3	2	1	1	2	3	1	-1	0	0.01	-0.05	0.00
2089077	2023-09-08 08:00:00	43	3	1.32	4.85	8.50	1.43	4.20	8.60	6	17	32	13	8	30	19	25	62	45	39	2	64	3	2	1	1	2	3	1	-1	1	0.11	-0.65	0.10
2232904	2024-11-15 00:15:00	43	3	1.34	4.35	6.90	1.37	4.35	8.20	3	7	8	6	5	4	9	12	12	5	2	2	14	3	1	1	1	2	2	1	0	1	0.03	0.00	1.30
2089076	2023-09-08 07:00:00	43	3	1.32	4.70	9.10	1.31	4.90	12.00	5	1	2	2	4	3	7	5	5	2	4	4	9	1	2	2	3	1	1	-1	1	1	-0.01	0.20	2.90
2089075	2023-09-08 06:30:00	43	1	1.91	3.25	4.05	1.81	3.40	4.90	21	2	16	16	6	21	37	8	37	2	31	2	39	1	3	1	2	1	2	-1	1	1	-0.10	0.15	0.85
2232922	2024-09-06 02:00:00	43	1	1.39	4.05	6.30	1.34	4.20	7.50	6	4	5	2	7	10	8	11	15	9	6	2	17	3	2	1	1	2	3	-1	1	1	-0.05	0.15	1.20
2232923	2024-09-10 22:00:00	43	0	7.00	4.40	1.33	6.50	4.50	1.35	14	10	8	11	9	9	25	19	17	1	7	9	26	1	2	3	3	2	1	-1	1	1	-0.50	0.10	0.02
2232921	2024-09-06 00:00:00	43	3	1.55	3.50	5.20	1.57	3.50	5.10	2	6	7	5	5	5	7	11	12	6	2	1	13	3	2	1	1	2	3	1	0	-1	0.02	0.00	-0.10
2232925	2024-09-11 02:00:00	43	1	4.85	3.60	1.58	4.65	3.65	1.58	8	6	6	9	8	6	17	14	12	4	7	9	21	1	2	3	3	2	1	-1	1	0	-0.20	0.05	0.00
2123425	2024-06-11 20:10:00	43	3	1.21	5.20	9.90	1.17	5.60	12.00	3	4	3	3	4	3	6	8	6	3	1	3	9	2	1	2	1	3	1	-1	1	1	-0.04	0.40	2.10
2123427	2024-03-22 02:30:00	43	3	1.35	4.40	6.50	1.31	4.60	7.10	12	7	9	8	10	12	20	17	21	3	6	2	23	2	3	1	2	1	3	-1	1	1	-0.04	0.20	0.60
2123428	2024-03-27 03:00:00	43	0	6.00	3.75	1.46	5.70	3.70	1.53	5	3	1	2	2	4	7	5	5	0	2	2	7	1	2	2	3	1	1	-1	-1	1	-0.30	-0.05	0.07
2123435	2024-06-11 18:10:00	43	3	1.08	8.90	11.00	1.13	6.90	11.00	9	18	16	11	12	14	20	30	30	16	6	6	36	3	1	1	1	2	2	1	-1	0	0.05	-2.00	0.00
2123438	2023-11-16 20:30:00	43	0	2.29	3.05	2.83	2.20	3.10	2.90	3	0	4	3	1	2	6	1	6	0	5	0	6	1	3	1	2	1	2	-1	1	1	-0.09	0.05	0.07
2123439	2023-11-21 20:00:00	43	0	10.00	5.10	1.21	9.60	5.30	1.22	9	5	5	5	5	7	14	10	12	0	4	2	14	1	3	2	3	1	2	-1	1	1	-0.40	0.20	0.01
2123440	2023-11-21 20:00:00	43	0	10.00	6.10	1.17	8.70	6.10	1.19	16	12	15	16	13	15	32	25	30	6	13	8	38	1	3	2	3	1	2	-1	0	1	-1.30	0.00	0.02
2123442	2024-03-26 20:30:00	43	0	6.10	5.10	1.33	5.60	4.30	1.41	14	11	14	19	10	13	33	21	27	0	12	6	33	1	3	2	3	1	2	-1	-1	1	-0.50	-0.80	0.08
2123443	2024-03-26 20:00:00	43	3	1.10	7.00	15.00	1.14	6.20	12.00	7	16	11	12	9	8	19	25	19	11	5	11	30	2	1	2	1	3	1	1	-1	-1	0.04	-0.80	-3.00
2123444	2024-03-21 20:30:00	43	1	7.70	4.95	1.26	9.80	5.10	1.25	18	11	11	17	10	11	35	21	22	0	14	13	35	1	3	2	3	1	2	1	1	-1	2.10	0.15	-0.01
2123445	2024-06-06 20:00:00	43	1	1.91	3.15	3.55	1.91	3.20	3.55	24	8	17	18	8	19	42	16	36	3	29	9	45	1	3	2	3	1	2	0	1	0	0.00	0.05	0.00
2123447	2024-06-11 19:00:00	43	3	1.17	6.40	9.10	1.22	5.60	8.40	14	17	24	15	14	23	29	31	47	20	18	2	49	3	2	1	1	2	3	1	-1	-1	0.05	-0.80	-0.70
2232962	2024-10-16 02:00:00	43	1	1.41	3.95	6.40	1.39	4.00	6.60	6	5	9	5	6	6	11	11	15	4	4	0	15	2	2	1	1	1	3	-1	1	1	-0.02	0.05	0.20
2232963	2024-10-15 20:00:00	43	3	3.20	3.35	1.97	3.15	3.35	1.99	10	5	16	14	6	9	24	11	25	4	17	3	28	2	3	1	2	1	3	-1	0	1	-0.05	0.00	0.02
2123395	2024-06-11 23:45:00	43	3	1.62	3.50	4.65	1.64	3.50	4.50	31	21	21	22	22	29	53	43	50	4	14	7	57	1	3	2	3	1	2	1	0	-1	0.02	0.00	-0.15
2232961	2024-10-15 18:35:00	43	1	1.33	4.30	7.20	1.31	4.30	8.00	7	7	8	8	8	10	15	15	18	4	4	1	19	2	2	1	1	1	3	-1	0	1	-0.02	0.00	0.80
2232966	2024-11-14 22:00:00	43	0	1.69	3.45	4.15	1.70	3.60	4.65	10	5	9	6	6	12	16	11	21	6	11	1	22	2	3	1	2	1	3	1	1	1	0.01	0.15	0.50
2232964	2024-11-14 17:10:00	43	1	1.96	3.20	3.40	1.99	3.15	3.35	10	2	9	9	1	10	19	3	19	1	17	1	20	1	3	1	2	1	2	1	-1	-1	0.03	-0.05	-0.05
2232965	2024-11-15 20:00:00	43	0	8.00	5.70	1.22	7.30	5.70	1.26	22	18	15	21	16	19	43	34	34	1	10	10	44	1	2	2	3	1	1	-1	0	1	-0.70	0.00	0.04
2123400	2024-03-26 20:00:00	43	0	2.04	3.00	3.35	2.03	3.05	3.35	25	16	36	32	16	28	57	32	64	9	34	2	66	2	3	1	2	1	3	-1	1	0	-0.01	0.05	0.00
2232970	2024-11-19 20:00:00	43	0	11.00	6.60	1.14	10.00	7.10	1.16	17	17	7	15	12	10	32	29	17	6	9	21	38	1	2	3	3	2	1	-1	1	1	-1.00	0.50	0.02
2123401	2024-06-12 02:00:00	43	3	1.44	4.05	5.80	1.50	3.75	5.50	19	19	16	13	16	26	32	35	42	14	11	4	46	3	2	1	1	2	3	1	-1	-1	0.06	-0.30	-0.30
2232971	2024-11-19 20:00:00	43	3	3.55	3.25	1.89	3.50	3.40	1.92	27	16	26	28	16	25	55	32	51	4	27	8	59	1	3	2	3	1	2	-1	1	1	-0.05	0.15	0.03
2123402	2024-06-11 20:30:00	43	3	1.05	7.90	20.00	1.16	5.80	11.00	12	13	14	13	10	11	25	23	25	8	10	8	33	1	3	1	2	1	2	1	-1	-1	0.11	-2.10	-9.00
2123403	2023-11-22 00:00:00	43	0	3.45	3.20	1.92	3.40	3.25	1.94	5	3	8	8	4	5	13	7	13	1	7	1	14	1	3	1	2	1	2	-1	1	1	-0.05	0.05	0.02
2232969	2024-11-20 02:15:00	43	1	5.10	3.45	1.57	4.40	3.20	1.79	13	12	3	13	6	9	26	18	12	3	11	17	29	1	2	3	3	2	1	-1	-1	1	-0.70	-0.25	0.22
2123404	2024-03-21 17:00:00	43	0	19.00	10.00	1.03	20.00	10.00	1.04	5	6	3	6	6	3	11	12	6	2	1	7	13	2	1	3	2	3	1	1	0	1	1.00	0.00	0.01
2123407	2024-06-12 02:00:00	43	0	1.67	3.40	4.40	1.78	3.35	3.85	1	4	6	4	4	2	5	8	8	3	0	0	8	3	1	1	1	2	2	1	-1	-1	0.11	-0.05	-0.55
2123408	2023-11-21 23:45:00	43	0	2.59	2.95	2.54	2.43	2.96	2.70	10	8	10	12	7	12	22	15	22	0	7	0	22	1	3	1	2	1	2	-1	1	1	-0.16	0.01	0.16
2123413	2024-06-12 01:00:00	43	1	1.81	3.15	4.00	1.82	3.15	3.90	16	10	19	19	10	15	35	20	34	2	17	3	37	1	3	2	3	1	2	1	0	-1	0.01	0.00	-0.10
2123414	2024-06-06 17:00:00	43	0	3.60	3.20	1.88	3.45	3.05	1.99	26	14	41	37	13	26	63	27	67	8	44	4	71	2	3	1	2	1	3	-1	-1	1	-0.15	-0.15	0.11
2123417	2023-11-21 19:45:00	43	1	6.10	4.00	1.41	7.90	4.30	1.32	2	1	3	3	3	2	5	4	5	0	1	0	5	1	3	1	2	1	2	1	1	-1	1.80	0.30	-0.09
2123419	2024-03-21 17:10:00	43	3	1.10	7.40	12.00	1.10	7.20	15.00	10	17	9	11	14	13	21	31	22	13	3	12	34	3	1	2	1	3	2	0	-1	1	0.00	-0.20	3.00
2123420	2024-03-26 17:30:00	43	0	9.10	5.90	1.18	12.00	6.10	1.16	12	10	9	14	11	8	26	21	17	3	8	12	29	1	2	3	3	2	1	1	1	-1	2.90	0.20	-0.02
2123421	2024-03-26 16:45:00	43	3	1.09	7.10	16.00	1.15	5.90	12.00	8	8	9	8	7	8	16	15	17	6	7	5	22	2	3	1	2	1	3	1	-1	-1	0.06	-1.20	-4.00
2123422	2024-06-07 01:30:00	43	3	1.46	3.80	5.60	1.46	3.85	5.70	2	2	2	1	4	3	3	6	5	4	1	2	7	3	1	2	1	3	2	0	1	1	0.00	0.05	0.10
2095071	2023-09-13 05:00:00	43	3	1.89	3.40	3.60	2.06	3.20	3.95	13	15	22	25	11	17	38	26	39	11	23	10	49	2	3	1	2	1	3	1	-1	1	0.17	-0.20	0.35
2095070	2023-09-13 04:00:00	43	0	5.70	4.20	1.57	6.80	4.50	1.47	3	2	4	8	6	3	11	8	7	2	5	6	13	1	2	3	3	2	1	1	1	-1	1.10	0.30	-0.10
2123490	2024-03-22 03:00:00	43	3	1.36	4.35	6.30	1.32	4.70	6.80	11	8	10	9	11	11	20	19	21	1	2	0	21	2	3	1	2	1	3	-1	1	1	-0.04	0.35	0.50
2123493	2024-03-27 03:00:00	43	0	11.00	5.70	1.18	12.00	5.30	1.21	13	9	11	17	13	9	30	22	20	5	13	15	35	1	2	3	3	2	1	1	-1	1	1.00	-0.40	0.03
2123456	2024-03-26 22:00:00	43	0	3.45	3.15	1.95	3.30	3.15	2.01	2	1	2	1	2	2	3	3	4	1	1	0	4	2	2	1	1	1	3	-1	0	1	-0.15	0.00	0.06
2095103	2024-09-11 05:00:00	43	0	1.19	5.50	11.00	1.28	5.30	12.00	7	9	6	10	8	6	17	17	12	8	8	13	25	1	1	3	2	2	1	1	-1	1	0.09	-0.20	1.00
2095102	2024-09-11 04:30:00	43	3	2.54	2.88	2.64	2.83	3.00	2.74	17	4	18	21	3	19	38	7	37	1	32	2	39	1	3	2	3	1	2	1	1	1	0.29	0.12	0.10
2123458	2024-06-06 23:00:00	43	1	1.92	3.20	3.50	1.78	3.35	3.85	11	4	7	4	6	11	15	10	18	7	12	4	22	2	3	1	2	1	3	-1	1	1	-0.14	0.15	0.35
2095101	2024-09-11 06:00:00	43	1	2.77	2.92	2.40	3.35	3.00	2.38	9	5	5	11	5	4	20	10	9	4	14	15	24	1	2	3	3	2	1	1	1	-1	0.58	0.08	-0.02
2123459	2024-06-12 00:00:00	43	1	1.91	3.10	3.70	1.74	3.35	4.05	12	9	12	11	12	13	23	21	25	4	6	2	27	2	3	1	2	1	3	-1	1	1	-0.17	0.25	0.35
2095100	2024-09-11 05:00:00	43	3	1.36	4.25	7.10	1.44	4.00	9.20	5	10	13	8	7	16	13	17	29	17	13	1	30	3	2	1	1	2	3	1	-1	1	0.08	-0.25	2.10
2095099	2024-09-07 09:00:00	43	3	1.38	4.75	8.60	1.34	4.95	9.90	20	18	33	14	21	45	34	39	78	46	41	2	80	3	2	1	1	2	3	-1	1	1	-0.04	0.20	1.30
2095098	2024-09-07 09:30:00	43	1	5.60	3.65	1.67	5.20	3.25	1.82	22	16	24	32	8	19	54	24	43	13	43	24	67	1	3	2	3	1	2	-1	-1	1	-0.40	-0.40	0.15
2123462	2024-03-21 20:00:00	43	0	7.70	5.10	1.26	11.00	5.70	1.20	10	9	8	13	8	8	23	17	16	0	6	7	23	1	2	3	3	2	1	1	1	-1	3.30	0.60	-0.06
2095097	2024-09-06 08:00:00	43	3	1.32	4.65	9.40	1.26	5.00	12.00	13	14	17	9	17	25	22	31	42	31	22	11	53	3	2	1	1	2	3	-1	1	1	-0.06	0.35	2.60
2095096	2024-09-07 07:30:00	43	1	1.52	4.10	6.60	1.48	4.05	7.70	14	9	14	11	12	19	25	21	33	10	14	2	35	2	3	1	2	1	3	-1	-1	1	-0.04	-0.05	1.10
2095095	2024-09-06 04:00:00	43	3	1.68	3.40	4.35	1.78	3.50	4.30	8	12	22	15	11	15	23	23	37	16	16	2	39	2	2	1	1	1	3	1	1	-1	0.10	0.10	-0.05
2095094	2023-11-22 10:00:00	43	1	2.33	3.15	3.30	2.53	3.05	3.05	8	4	17	11	3	14	19	7	31	15	27	3	34	2	3	1	2	1	3	1	-1	-1	0.20	-0.10	-0.25
2095093	2023-11-22 07:30:00	43	3	1.08	11.00	30.00	1.09	11.00	22.00	2	1	13	4	0	10	6	1	23	18	23	1	24	2	3	1	2	1	3	1	0	-1	0.01	0.00	-8.00
2123466	2024-06-06 22:30:00	43	3	1.11	7.50	11.00	1.09	8.30	12.00	4	4	2	4	4	2	8	8	4	2	2	6	10	1	1	3	2	2	1	-1	1	1	-0.02	0.80	1.00
2095092	2023-11-22 07:00:00	43	0	3.40	3.15	2.28	3.20	3.20	2.35	9	7	0	8	9	1	17	16	1	6	7	22	23	1	2	3	3	2	1	-1	1	1	-0.20	0.05	0.07
2095091	2023-11-22 07:30:00	43	3	1.57	3.75	6.80	1.61	3.65	6.50	2	4	6	4	3	7	6	7	13	7	6	0	13	3	2	1	1	2	3	1	-1	-1	0.04	-0.10	-0.30
2123468	2024-03-26 23:00:00	43	0	15.00	8.40	1.07	16.00	8.40	1.07	1	2	1	1	1	1	2	3	2	1	0	1	3	2	1	2	1	3	1	1	0	0	1.00	0.00	0.00
2123469	2023-11-21 20:00:00	43	1	2.37	3.10	2.66	2.35	3.10	2.70	6	0	10	10	0	6	16	0	16	0	16	0	16	1	3	1	2	1	2	-1	0	1	-0.02	0.00	0.04
2095090	2023-11-22 08:30:00	43	0	2.48	3.15	3.05	2.58	3.10	2.96	10	10	27	9	9	26	19	19	53	39	39	5	58	2	2	1	1	1	3	1	-1	-1	0.10	-0.05	-0.09
2123470	2023-11-16 19:00:00	43	0	4.30	3.30	1.71	4.45	3.25	1.71	2	2	1	3	2	0	5	4	1	0	1	4	5	1	2	3	3	2	1	1	-1	0	0.15	-0.05	0.00
2095089	2023-11-17 08:30:00	43	1	1.98	3.15	4.35	1.91	3.20	4.65	18	6	14	14	7	19	32	13	33	1	20	0	33	2	3	1	2	1	3	-1	1	1	-0.07	0.05	0.30
2095088	2023-11-17 08:00:00	43	0	1.58	3.85	6.30	1.60	3.85	6.20	4	5	6	7	4	5	11	9	11	4	6	4	15	1	3	1	2	1	2	1	0	-1	0.02	0.00	-0.10
2123471	2024-06-11 23:00:00	43	1	1.72	3.25	4.30	1.82	3.10	4.00	3	10	11	7	9	14	10	19	25	16	7	1	26	3	2	1	1	2	3	1	-1	-1	0.10	-0.15	-0.30
2095087	2023-11-17 08:00:00	43	3	3.50	3.15	2.23	3.35	3.15	2.29	4	1	3	3	1	3	7	2	6	1	6	2	8	1	3	2	3	1	2	-1	0	1	-0.15	0.00	0.06
2123472	2023-11-21 19:00:00	43	1	4.45	3.55	1.62	4.95	3.55	1.57	3	2	3	4	2	3	7	4	6	0	3	1	7	1	3	2	3	1	2	1	0	-1	0.50	0.00	-0.05
2123473	2023-11-16 22:45:00	43	3	1.23	4.80	11.00	1.29	4.50	8.70	7	6	7	7	7	6	14	13	13	0	1	1	14	1	2	2	3	1	1	1	-1	-1	0.06	-0.30	-2.30
2095086	2023-11-17 06:00:00	43	1	3.45	3.10	2.29	3.05	3.10	2.51	5	1	0	1	2	4	6	3	4	0	3	2	6	1	3	2	3	1	2	-1	0	1	-0.40	0.00	0.22
2123474	2023-11-21 20:00:00	43	0	4.15	3.50	1.68	4.75	3.50	1.60	7	10	9	13	8	6	20	18	15	2	4	7	22	1	2	3	3	2	1	1	0	-1	0.60	0.00	-0.08
2095084	2023-10-18 10:00:00	43	0	10.00	4.55	1.35	9.80	4.25	1.39	14	26	26	17	25	25	31	51	51	34	14	14	65	3	1	1	1	2	2	-1	-1	1	-0.20	-0.30	0.04
2123475	2024-06-12 01:00:00	43	1	1.63	3.45	4.60	1.59	3.40	4.80	13	13	19	15	11	15	28	24	34	7	11	1	35	2	3	1	2	1	3	-1	-1	1	-0.04	-0.05	0.20
2095083	2023-10-18 08:00:00	43	3	3.15	3.35	1.98	4.00	3.40	1.98	25	10	29	26	10	27	51	20	56	11	42	6	62	2	3	1	2	1	3	1	1	0	0.85	0.05	0.00
2123476	2024-03-22 03:00:00	43	3	1.05	10.00	21.00	1.04	11.00	15.00	1	0	1	1	2	2	2	2	3	1	1	0	3	2	2	1	1	1	3	-1	1	-1	-0.01	1.00	-6.00
2095082	2023-10-18 07:30:00	43	1	1.97	3.30	4.15	2.04	3.20	4.10	13	9	15	16	8	18	29	17	33	12	24	8	41	2	3	1	2	1	3	1	-1	-1	0.07	-0.10	-0.05
2123477	2024-03-21 21:30:00	43	3	1.95	3.05	3.55	1.94	3.15	3.70	37	21	34	32	24	36	69	45	70	6	30	5	75	2	3	1	2	1	3	-1	1	1	-0.01	0.10	0.15
2095081	2023-10-13 08:00:00	43	3	1.79	3.45	5.00	1.70	3.55	5.50	9	6	7	5	7	11	14	13	18	6	7	2	20	2	3	1	2	1	3	-1	1	1	-0.09	0.10	0.50
2123478	2024-03-26 19:00:00	43	0	9.50	5.70	1.19	9.10	5.70	1.19	8	6	5	7	6	5	15	12	10	0	3	5	15	1	2	3	3	2	1	-1	0	0	-0.40	0.00	0.00
2095080	2023-10-18 06:30:00	43	3	1.22	5.50	8.70	1.28	5.60	11.00	10	14	9	15	10	9	25	24	18	9	10	16	34	1	2	3	3	2	1	1	1	1	0.06	0.10	2.30
2123479	2023-11-21 21:00:00	43	1	3.35	2.85	2.10	3.35	2.79	2.15	2	4	2	2	2	3	4	6	5	3	1	2	7	3	1	2	1	3	2	0	-1	1	0.00	-0.06	0.05
2095079	2023-10-18 05:00:00	43	3	2.50	3.05	2.55	2.58	3.15	2.90	16	3	11	13	3	17	29	6	28	1	24	2	30	1	3	2	3	1	2	1	1	1	0.08	0.10	0.35
2123480	2024-06-06 20:00:00	43	3	1.36	4.30	6.40	1.32	4.45	7.20	13	14	15	13	11	17	26	25	32	8	9	2	34	2	3	1	2	1	3	-1	1	1	-0.04	0.15	0.80
2095078	2023-10-13 07:00:00	43	3	1.24	5.80	14.00	1.25	5.60	13.00	3	6	5	4	5	5	7	11	10	5	1	2	12	3	1	2	1	3	2	1	-1	-1	0.01	-0.20	-1.00
2095077	2023-10-13 08:30:00	43	1	1.09	11.00	24.00	1.11	9.90	19.00	3	6	6	7	3	5	10	9	11	4	5	3	14	2	3	1	2	1	3	1	-1	-1	0.02	-1.10	-5.00
2095076	2023-10-13 07:00:00	43	0	3.80	3.45	2.01	4.50	3.70	1.80	11	5	15	17	11	12	28	16	27	5	17	6	33	1	3	2	3	1	2	1	1	-1	0.70	0.25	-0.21
2123483	2024-03-26 23:00:00	43	1	4.75	3.35	1.63	4.45	3.30	1.69	7	4	1	6	3	3	13	7	4	0	6	9	13	1	2	3	3	2	1	-1	-1	1	-0.30	-0.05	0.06
2095075	2023-10-13 04:30:00	43	1	2.03	3.25	3.95	2.09	3.30	3.75	4	2	5	4	4	7	8	6	12	4	6	0	12	2	3	1	2	1	3	1	1	-1	0.06	0.05	-0.20
2095074	2023-09-13 10:00:00	43	0	9.40	5.10	1.34	9.30	4.90	1.36	13	11	10	17	10	9	30	21	19	1	10	12	31	1	2	3	3	2	1	-1	-1	1	-0.10	-0.20	0.02
2095073	2023-09-13 08:30:00	43	1	3.00	3.10	2.53	3.15	3.10	2.44	9	3	10	12	4	8	21	7	18	2	16	5	23	1	3	2	3	1	2	1	0	-1	0.15	0.00	-0.09
2095072	2023-09-13 06:00:00	43	3	2.94	3.10	2.58	2.70	3.00	2.88	21	2	9	12	1	25	33	3	34	1	31	0	34	2	3	1	2	1	3	-1	-1	1	-0.24	-0.10	0.30
2214947	2024-06-11 02:45:00	44	3	1.18	6.30	8.50	1.19	6.70	12.00	7	14	8	11	10	10	18	24	18	12	6	12	30	2	1	2	1	3	1	1	1	1	0.01	0.40	3.50
2218795	2024-06-08 02:45:00	44	3	1.28	4.75	8.00	1.28	5.20	9.30	8	5	8	7	7	13	15	12	21	8	11	2	23	2	3	1	2	1	3	0	1	1	0.00	0.45	1.30
2218794	2024-06-08 02:45:00	44	0	1.09	8.20	12.00	1.11	8.80	15.00	7	9	6	8	10	7	15	19	13	6	2	8	21	2	1	3	2	3	1	1	1	1	0.02	0.60	3.00
2188205	2024-03-24 01:00:00	44	0	2.88	3.15	2.20	2.82	3.15	2.23	4	1	0	1	1	2	5	2	2	0	3	3	5	1	2	2	3	1	1	-1	0	1	-0.06	0.00	0.03
2218796	2024-06-08 02:45:00	44	3	2.58	3.10	2.43	2.44	3.10	2.86	21	4	10	10	4	23	31	8	33	3	26	1	34	2	3	1	2	1	3	-1	0	1	-0.14	0.00	0.43
2025744	2023-10-15 03:00:00	44	0	3.50	3.85	1.74	3.25	3.75	1.83	6	3	4	4	3	5	10	6	9	0	4	1	10	1	3	2	3	1	2	-1	-1	1	-0.25	-0.10	0.09
2218805	2024-06-09 00:00:00	44	1	2.12	3.15	3.05	2.13	3.30	3.25	2	4	4	1	5	5	3	9	9	8	2	2	11	3	1	1	1	2	2	1	1	1	0.01	0.15	0.20
2089737	2023-10-16 19:35:00	44	0	3.25	3.15	2.02	3.25	3.15	2.02	2	1	2	2	1	1	4	2	3	1	3	2	5	1	3	2	3	1	2	0	0	0	0.00	0.00	0.00
2218807	2024-06-09 01:30:00	44	3	2.16	3.40	3.10	2.26	3.35	2.95	2	1	2	1	1	4	3	2	6	3	4	0	6	2	3	1	2	1	3	1	-1	-1	0.10	-0.05	-0.15
2218806	2024-06-09 00:45:00	44	0	1.63	3.55	4.45	1.68	3.75	4.60	2	1	3	1	4	3	3	5	6	4	2	1	7	3	2	1	1	2	3	1	1	1	0.05	0.20	0.15
2133176	2024-03-24 03:00:00	44	0	1.89	3.25	3.50	1.95	3.25	3.35	14	10	20	21	9	15	35	19	35	7	23	7	42	1	3	1	2	1	2	1	0	-1	0.06	0.00	-0.15
2218809	2024-06-09 03:30:00	44	3	1.07	8.30	18.00	1.09	8.90	20.00	6	15	16	9	13	13	15	28	29	21	8	7	36	3	2	1	1	2	3	1	1	1	0.02	0.60	2.00
2190270	2024-03-27 03:45:00	44	0	1.51	3.60	5.50	1.48	3.65	5.90	5	1	1	2	2	6	7	3	7	1	5	1	8	1	3	1	2	1	2	-1	1	1	-0.03	0.05	0.40
2187905	2024-03-23 01:00:00	44	0	2.02	3.25	3.15	2.05	3.25	3.05	7	3	5	5	4	7	12	7	12	1	6	1	13	1	3	1	2	1	2	1	0	-1	0.03	0.00	-0.10
2108801	2023-10-13 19:00:00	44	3	1.76	3.40	3.85	1.74	3.30	4.15	2	2	0	0	1	4	2	3	4	2	1	0	4	3	2	1	1	2	3	-1	-1	1	-0.02	-0.10	0.30
1995962	2023-06-16 10:00:00	44	3	2.23	3.15	3.00	2.12	3.10	3.55	8	8	10	4	10	13	12	18	23	18	12	7	30	3	2	1	1	2	3	-1	-1	1	-0.11	-0.05	0.55
2108804	2023-10-17 18:10:00	44	3	1.40	4.15	6.00	1.41	4.10	5.80	4	4	6	4	3	4	8	7	10	3	4	1	11	2	3	1	2	1	3	1	-1	-1	0.01	-0.05	-0.20
2180871	2024-03-27 04:30:00	44	1	2.13	3.30	2.87	2.23	3.30	2.72	0	0	4	2	0	2	2	0	6	4	6	0	6	2	3	1	2	1	3	1	0	-1	0.10	0.00	-0.15
2214920	2024-06-04 02:45:00	44	1	1.41	4.25	5.60	1.41	4.65	6.40	9	7	8	9	9	9	18	16	17	2	4	3	20	1	3	2	3	1	2	0	1	1	0.00	0.40	0.80
2108810	2023-10-13 21:00:00	44	3	1.63	3.65	4.30	1.63	3.65	4.30	0	0	0	0	0	0	0	0	0	1	1	1	1	1	1	1	1	1	1	0	0	0	0.00	0.00	0.00
2214923	2024-06-04 02:45:00	44	3	1.14	6.60	11.00	1.13	7.90	13.00	3	5	8	4	6	8	7	11	16	12	8	3	19	3	2	1	1	2	3	-1	1	1	-0.01	1.30	2.00
2214925	2024-06-10 03:15:00	44	1	1.18	6.30	8.80	1.20	6.70	9.70	6	6	10	6	10	12	12	16	22	13	9	3	25	3	2	1	1	2	3	1	1	1	0.02	0.40	0.90
2187921	2024-03-23 03:45:00	44	3	2.11	3.25	2.94	2.44	3.20	2.80	2	1	6	5	1	1	7	2	7	1	6	1	8	1	3	1	2	1	2	1	-1	-1	0.33	-0.05	-0.14
2218385	2024-06-13 07:00:00	44	1	6.00	4.45	1.45	6.40	4.50	1.42	21	15	21	28	20	18	49	35	39	6	20	16	55	1	3	2	3	1	2	1	1	-1	0.40	0.05	-0.03
2214931	2024-06-11 00:00:00	44	3	1.42	4.25	5.60	1.42	4.40	6.60	4	4	5	3	5	6	7	9	11	6	4	2	13	3	2	1	1	2	3	0	1	1	0.00	0.15	1.00
2187922	2024-03-23 03:45:00	44	1	1.77	3.25	4.05	1.82	3.30	4.45	5	3	7	4	5	8	9	8	15	9	10	3	18	2	3	1	2	1	3	1	1	1	0.05	0.05	0.40
2187925	2024-03-23 04:30:00	44	0	1.72	3.45	4.00	1.78	3.40	4.45	1	3	6	2	2	7	3	5	13	10	8	0	13	3	2	1	1	2	3	1	-1	1	0.06	-0.05	0.45
2214935	2024-06-11 02:45:00	44	3	2.17	3.20	2.86	2.35	3.30	2.84	8	5	7	9	4	9	17	9	16	4	12	5	21	1	3	2	3	1	2	1	1	-1	0.18	0.10	-0.02
2214934	2024-06-10 02:45:00	44	3	1.25	5.00	7.90	1.21	5.90	12.00	7	4	5	4	8	9	11	12	14	9	8	6	20	3	2	1	1	2	3	-1	1	1	-0.04	0.90	4.10
2110744	2023-10-10 19:35:00	44	3	1.41	4.40	5.80	1.49	4.05	4.85	1	4	5	4	1	2	5	5	7	3	3	1	8	2	2	1	1	1	3	1	-1	-1	0.08	-0.35	-0.95
2110747	2023-10-13 18:35:00	44	3	1.52	3.85	4.90	1.53	3.90	4.80	1	2	4	2	4	2	3	6	6	3	0	0	6	3	1	1	1	2	2	1	1	-1	0.01	0.05	-0.10
2023073	2023-10-14 02:45:00	44	3	1.19	6.00	9.20	1.21	5.70	8.70	5	5	8	6	5	12	11	10	20	11	12	2	22	2	3	1	2	1	3	1	-1	-1	0.02	-0.30	-0.50
2112353	2023-10-18 02:45:00	44	3	1.53	3.80	4.90	1.54	3.75	4.90	0	1	2	1	1	1	1	2	3	2	1	0	3	3	2	1	1	2	3	1	-1	0	0.01	-0.05	0.00
2112355	2023-10-18 03:00:00	44	3	1.27	5.30	6.60	1.28	5.20	6.60	3	4	5	4	3	5	7	7	10	3	3	0	10	2	2	1	1	1	3	1	-1	0	0.01	-0.10	0.00
2112361	2023-10-18 08:00:00	44	1	3.70	3.75	1.72	3.95	3.90	1.64	4	2	3	5	5	2	9	7	5	0	2	4	9	1	2	3	3	2	1	1	1	-1	0.25	0.15	-0.08
2184690	2024-03-24 03:00:00	44	1	2.04	3.10	3.25	2.06	3.10	3.20	4	3	5	5	3	4	9	6	9	4	7	4	13	1	3	1	2	1	2	1	0	-1	0.02	0.00	-0.05
2184693	2024-03-24 01:00:00	44	1	3.30	3.15	2.00	3.35	3.25	1.95	16	8	16	17	11	14	33	19	30	1	15	4	34	1	3	2	3	1	2	1	1	-1	0.05	0.10	-0.05
2184694	2024-03-23 03:45:00	44	3	1.40	4.05	6.20	1.41	4.25	7.40	11	7	16	8	13	17	19	20	33	17	16	3	36	3	2	1	1	2	3	1	1	1	0.01	0.20	1.20
2001607	2023-06-20 19:35:00	44	3	1.55	3.70	4.90	1.58	3.65	4.70	2	1	2	2	1	2	4	2	4	1	3	1	5	1	3	1	2	1	2	1	-1	-1	0.03	-0.05	-0.20
2017218	2023-06-15 20:00:00	44	3	1.17	6.00	10.00	1.19	5.90	8.80	2	1	3	3	3	2	5	4	5	1	2	1	6	1	3	1	2	1	2	1	-1	-1	0.02	-0.10	-1.20
2134398	2024-03-24 04:00:00	44	0	1.79	3.60	3.50	1.79	3.65	3.45	5	8	14	8	8	9	13	16	23	13	10	3	26	3	2	1	1	2	3	0	1	-1	0.00	0.05	-0.05
2134399	2024-03-27 03:45:00	44	3	1.93	3.60	3.10	1.93	3.60	3.05	12	3	10	10	4	11	22	7	21	0	15	1	22	1	3	2	3	1	2	0	0	-1	0.00	0.00	-0.05
2108864	2023-10-15 01:00:00	44	1	2.51	3.15	2.46	2.56	3.15	2.44	2	0	3	3	0	2	5	0	5	0	5	0	5	1	3	1	2	1	2	1	0	-1	0.05	0.00	-0.02
2133825	2024-03-27 03:45:00	44	1	1.74	3.45	3.90	1.72	3.50	3.95	6	4	5	4	4	9	10	8	14	7	9	3	17	2	3	1	2	1	3	-1	1	1	-0.02	0.05	0.05
2108870	2023-10-15 08:30:00	44	3	1.67	3.45	4.30	1.71	3.45	4.05	4	3	5	4	5	4	8	8	9	4	4	3	12	2	2	1	1	1	3	1	0	-1	0.04	0.00	-0.25
2217286	2024-06-05 02:45:00	44	3	2.65	3.10	2.39	2.81	3.05	2.53	10	2	11	13	1	11	23	3	22	0	20	1	23	1	3	2	3	1	2	1	-1	1	0.16	-0.05	0.14
2217289	2024-06-05 02:45:00	44	3	2.21	3.20	2.81	2.19	3.30	3.10	4	3	5	1	3	7	5	6	12	8	7	1	13	3	2	1	1	2	3	-1	1	1	-0.02	0.10	0.29
2217288	2024-06-05 02:45:00	44	3	1.13	6.50	12.00	1.14	7.00	16.00	9	13	11	10	14	11	19	27	22	13	5	10	32	3	1	2	1	3	2	1	1	1	0.01	0.50	4.00
2217290	2024-06-05 03:00:00	44	1	1.55	3.75	4.85	1.56	4.00	5.30	4	5	6	4	6	8	8	11	14	8	5	2	16	3	2	1	1	2	3	1	1	1	0.01	0.25	0.45
2024178	2023-06-19 08:30:00	44	3	2.04	3.20	3.60	2.03	3.25	3.55	4	1	3	2	3	5	6	4	8	3	5	1	9	2	3	1	2	1	3	-1	1	-1	-0.01	0.05	-0.05
2217293	2024-06-06 02:30:00	44	3	1.21	5.30	9.40	1.24	5.80	9.80	11	10	18	14	10	18	25	20	36	12	17	1	37	2	3	1	2	1	3	1	1	1	0.03	0.50	0.40
2092396	2023-09-13 02:45:00	44	0	3.90	3.45	1.75	3.55	3.40	1.84	3	1	0	0	1	3	3	2	3	0	1	0	3	1	3	1	2	1	2	-1	-1	1	-0.35	-0.05	0.09
2092395	2023-09-13 03:00:00	44	3	2.71	3.45	2.17	2.58	3.45	2.26	6	2	1	4	2	2	10	4	3	1	7	8	11	1	2	3	3	2	1	-1	0	1	-0.13	0.00	0.09
2095334	2023-09-10 05:30:00	44	3	1.22	5.30	9.10	1.27	5.40	9.30	3	4	8	5	5	7	8	9	15	7	6	0	15	3	2	1	1	2	3	1	1	1	0.05	0.10	0.20
2095333	2023-09-10 02:45:00	44	0	1.55	4.00	4.35	1.44	4.45	6.30	6	6	7	3	10	11	9	16	18	11	4	2	20	3	2	1	1	2	3	-1	1	1	-0.11	0.45	1.95
2095332	2023-09-09 19:35:00	44	1	1.41	4.20	5.60	1.50	3.85	5.10	6	6	7	7	7	6	13	13	13	0	0	0	13	1	1	1	1	1	1	1	-1	-1	0.09	-0.35	-0.50
2188893	2024-03-27 03:45:00	44	0	2.94	3.15	2.16	2.76	3.15	2.28	3	2	0	1	1	2	4	3	2	0	1	2	4	1	2	3	3	2	1	-1	0	1	-0.18	0.00	0.12
2189533	2024-03-27 03:45:00	44	3	1.81	3.45	3.60	1.84	3.50	3.45	6	3	7	7	5	5	13	8	12	1	6	2	14	1	3	2	3	1	2	1	1	-1	0.03	0.05	-0.15
2188895	2024-03-27 04:00:00	44	3	1.28	5.10	7.20	1.25	5.20	8.10	6	5	8	6	5	8	12	10	16	4	6	0	16	2	3	1	2	1	3	-1	1	1	-0.03	0.10	0.90
2151519	2024-03-27 03:45:00	44	3	6.00	4.00	1.43	6.60	4.10	1.39	6	6	9	12	7	6	18	13	15	1	6	4	19	1	3	2	3	1	2	1	1	-1	0.60	0.10	-0.04
2077083	2023-09-19 19:30:00	45	3	1.24	4.90	9.30	1.19	5.40	11.00	5	2	3	2	5	3	7	7	6	1	1	2	8	1	1	3	2	2	1	-1	1	1	-0.05	0.50	1.70
2077082	2023-09-19 16:00:00	45	1	3.15	3.20	2.04	3.20	3.20	2.02	4	1	3	3	1	4	7	2	7	0	5	0	7	1	3	1	2	1	2	1	0	-1	0.05	0.00	-0.02
2077114	2023-09-27 16:30:00	45	3	1.13	7.10	11.00	1.16	6.40	9.90	4	5	6	5	4	4	9	9	10	2	2	1	11	2	2	1	1	1	3	1	-1	-1	0.03	-0.70	-1.10
2077081	2023-09-19 19:30:00	45	1	3.00	2.95	2.23	2.48	2.93	2.67	5	3	0	0	0	5	5	3	5	0	2	0	5	1	3	1	2	1	2	-1	-1	1	-0.52	-0.02	0.44
2077113	2023-09-27 19:30:00	45	3	1.80	3.30	3.80	1.55	3.65	5.00	11	3	4	4	7	11	15	10	15	1	6	1	16	1	3	1	2	1	2	-1	1	1	-0.25	0.35	1.20
2077078	2023-09-19 19:30:00	45	3	1.26	4.75	8.50	1.22	5.00	10.00	3	0	0	0	3	4	3	3	4	1	1	0	4	2	2	1	1	1	3	-1	1	1	-0.04	0.25	1.50
2077108	2023-09-24 19:30:00	45	1	1.96	3.25	3.35	1.97	3.25	3.30	1	1	1	1	1	1	2	2	2	1	1	1	3	1	1	1	1	1	1	1	0	-1	0.01	0.00	-0.05
2077103	2023-09-24 19:30:00	45	0	11.00	6.00	1.16	11.00	5.90	1.16	1	1	1	1	1	1	2	2	2	1	1	1	3	1	1	1	1	1	1	0	-1	0	0.00	-0.10	0.00
2077095	2023-09-21 19:30:00	45	0	12.00	6.70	1.13	12.00	7.00	1.13	4	2	5	4	6	3	8	8	8	3	3	3	11	1	1	1	1	1	1	0	1	0	0.00	0.30	0.00
2077094	2023-09-21 16:00:00	45	1	3.20	3.20	2.02	3.25	3.25	1.98	0	0	2	1	1	0	1	1	2	2	2	1	3	2	2	1	1	1	3	1	1	-1	0.05	0.05	-0.04
2077093	2023-09-21 19:30:00	45	3	1.32	4.35	7.70	1.33	4.40	7.30	4	5	7	6	5	5	10	10	12	3	3	1	13	2	2	1	1	1	3	1	1	-1	0.01	0.05	-0.40
2077091	2023-09-21 16:00:00	45	3	1.35	4.15	7.20	1.26	4.55	9.40	4	0	0	0	4	4	4	4	4	1	1	1	5	1	1	1	1	1	1	-1	1	1	-0.09	0.40	2.20
2077088	2023-09-20 19:30:00	45	3	1.45	3.90	5.70	1.39	4.10	6.60	5	3	6	7	5	5	12	8	11	0	4	1	12	1	3	2	3	1	2	-1	1	1	-0.06	0.20	0.90
2349859	2025-02-09 23:00:00	46	3	10.00	7.20	1.12	13.00	7.60	1.15	5	4	3	7	7	4	12	11	7	4	5	9	16	1	2	3	3	2	1	1	1	1	3.00	0.40	0.03
2166820	2024-02-29 04:00:00	46	3	1.65	3.90	3.90	1.51	4.50	5.10	11	2	6	1	11	14	12	13	20	11	10	3	23	3	2	1	1	2	3	-1	1	1	-0.14	0.60	1.20
2349861	2025-02-08 04:00:00	46	3	1.28	5.10	7.00	1.36	5.00	6.50	12	14	18	16	11	20	28	25	38	15	18	5	43	2	3	1	2	1	3	1	-1	-1	0.08	-0.10	-0.50
2349860	2025-02-08 23:00:00	46	0	2.70	3.30	2.24	2.74	3.60	2.29	7	0	4	5	1	6	12	1	10	0	11	2	12	1	3	2	3	1	2	1	1	1	0.04	0.30	0.05
2132265	2024-01-06 20:30:00	46	0	3.65	3.55	1.78	4.05	3.65	1.78	2	2	2	3	3	3	5	5	5	2	2	2	7	1	1	1	1	1	1	1	1	0	0.40	0.10	0.00
2132266	2024-01-06 03:30:00	46	3	1.17	6.40	8.90	1.18	6.40	14.00	7	11	8	9	9	11	16	20	19	13	9	10	29	3	1	2	1	3	2	1	0	1	0.01	0.00	5.10
2150698	2024-01-27 03:45:00	46	1	2.77	3.30	2.20	3.05	3.25	2.26	4	7	0	4	7	1	8	14	1	9	3	16	17	2	1	3	2	3	1	1	-1	1	0.28	-0.05	0.06
2132267	2024-01-06 23:00:00	46	0	5.00	4.00	1.50	5.40	4.20	1.52	1	1	0	1	1	2	2	2	2	0	0	0	2	1	1	1	1	1	1	1	1	1	0.40	0.20	0.02
2150699	2024-01-27 23:00:00	46	0	1.45	4.00	5.60	1.47	4.20	6.20	1	1	1	2	2	2	3	3	3	0	0	0	3	1	1	1	1	1	1	1	1	1	0.02	0.20	0.60
2132268	2024-01-09 04:15:00	46	0	9.30	5.90	1.18	11.00	6.20	1.21	15	13	13	16	16	17	31	29	30	18	20	19	49	1	3	2	3	1	2	1	1	1	1.70	0.30	0.03
2150700	2024-01-27 23:00:00	46	3	1.37	4.25	6.50	1.44	4.40	6.30	0	2	4	3	1	1	3	3	5	2	2	0	5	2	2	1	1	1	3	1	1	-1	0.07	0.15	-0.20
2132269	2024-01-07 22:00:00	46	1	1.67	3.50	4.15	1.72	3.60	4.50	1	1	3	2	3	4	3	4	7	4	3	0	7	3	2	1	1	2	3	1	1	1	0.05	0.10	0.35
2150701	2024-01-28 19:45:00	46	0	3.15	3.25	2.03	3.50	3.40	2.01	2	0	3	3	1	2	5	1	5	1	5	1	6	1	3	1	2	1	2	1	1	-1	0.35	0.15	-0.02
2132270	2024-01-06 04:00:00	46	3	1.40	4.55	5.60	1.42	4.75	6.00	11	8	18	10	12	18	21	20	36	20	21	5	41	2	3	1	2	1	3	1	1	1	0.02	0.20	0.40
2132271	2024-01-07 22:00:00	46	0	3.95	3.80	1.64	4.40	4.00	1.66	2	1	5	5	4	4	7	5	9	3	5	1	10	2	3	1	2	1	3	1	1	1	0.45	0.20	0.02
2132272	2024-01-06 23:00:00	46	0	5.60	4.35	1.40	5.90	4.50	1.45	1	1	1	2	1	2	3	2	3	0	1	0	3	1	3	1	2	1	2	1	1	1	0.30	0.15	0.05
2150704	2024-01-28 22:30:00	46	3	1.11	7.70	11.00	1.14	8.40	11.00	2	8	3	4	7	3	6	15	6	12	3	12	18	2	1	2	1	3	1	1	1	0	0.03	0.70	0.00
2132273	2024-01-07 01:30:00	46	0	4.55	4.10	1.54	5.60	4.20	1.52	1	3	3	5	5	1	6	8	4	2	0	4	8	2	1	3	2	3	1	1	1	-1	1.05	0.10	-0.02
2132274	2024-01-06 23:00:00	46	3	1.38	4.55	5.50	1.38	4.65	7.30	2	1	1	1	4	2	3	5	3	2	0	2	5	2	1	2	1	3	1	0	1	1	0.00	0.10	1.80
2132275	2024-01-08 00:30:00	46	0	1.98	3.55	2.99	2.02	3.70	3.20	9	3	12	15	4	8	24	7	20	4	21	8	28	1	3	2	3	1	2	1	1	1	0.04	0.15	0.21
2132276	2024-01-07 01:30:00	46	3	1.11	7.50	13.00	1.16	7.10	12.00	5	12	6	7	11	5	12	23	11	13	2	14	25	2	1	3	2	3	1	1	-1	-1	0.05	-0.40	-1.00
2132277	2024-01-06 20:45:00	46	0	3.85	3.80	1.68	4.35	3.95	1.68	0	1	0	2	1	0	2	2	0	1	1	3	3	1	1	3	2	2	1	1	1	0	0.50	0.15	0.00
2132278	2024-01-07 22:00:00	46	3	1.02	14.00	15.00	1.02	14.00	13.00	2	0	1	1	0	2	3	0	3	0	3	0	3	1	3	1	2	1	2	0	0	-1	0.00	0.00	-2.00
2132279	2024-01-06 03:15:00	46	1	2.38	3.10	2.65	2.54	3.15	2.70	18	5	26	28	5	22	46	10	48	5	41	3	51	2	3	1	2	1	3	1	1	1	0.16	0.05	0.05
2132280	2024-01-06 20:30:00	46	3	1.57	3.85	4.60	1.52	4.20	5.70	6	1	2	1	6	6	7	7	8	2	2	1	9	2	2	1	1	1	3	-1	1	1	-0.05	0.35	1.10
2132281	2024-01-07 22:00:00	46	1	1.40	4.30	5.90	1.36	4.65	7.80	5	3	4	4	6	9	9	9	13	4	4	0	13	2	2	1	1	1	3	-1	1	1	-0.04	0.35	1.90
2132283	2024-01-05 04:00:00	46	1	2.47	3.25	2.58	2.51	3.25	2.67	24	6	19	18	5	26	42	11	45	5	36	2	47	2	3	1	2	1	3	1	0	1	0.04	0.00	0.09
2161470	2024-02-08 03:45:00	46	1	1.53	3.85	4.85	1.51	4.00	6.00	2	8	6	0	7	10	2	15	16	17	4	3	19	3	2	1	1	2	3	-1	1	1	-0.02	0.15	1.15
2161471	2024-02-08 04:00:00	46	0	2.07	3.50	2.85	2.05	3.70	3.10	24	12	25	24	14	23	48	26	48	19	41	19	67	1	3	1	2	1	2	-1	1	1	-0.02	0.20	0.25
2334723	2025-01-12 23:00:00	46	1	1.69	3.65	3.95	1.72	3.60	4.55	3	3	8	3	3	5	6	6	13	9	9	2	15	2	2	1	1	1	3	1	-1	1	0.03	-0.05	0.60
2334721	2025-01-11 23:00:00	46	3	1.38	4.30	6.20	1.39	4.50	6.40	7	4	6	5	7	7	12	11	13	1	2	0	13	2	3	1	2	1	3	1	1	1	0.01	0.20	0.20
2334720	2025-01-11 23:00:00	46	3	1.47	4.10	5.30	1.47	4.25	5.40	4	1	1	2	3	5	6	4	6	1	3	1	7	1	3	1	2	1	2	0	1	1	0.00	0.15	0.10
2147332	2024-01-18 03:45:00	46	0	2.53	3.55	2.26	2.59	3.55	2.42	6	2	1	4	2	3	10	4	4	0	6	6	10	1	2	2	3	1	1	1	0	1	0.06	0.00	0.16
2147333	2024-01-18 03:45:00	46	3	1.91	3.25	3.45	1.97	3.35	3.65	15	8	11	16	8	15	31	16	26	4	19	9	35	1	3	2	3	1	2	1	1	1	0.06	0.10	0.20
2147335	2024-01-17 03:30:00	46	1	1.86	3.35	3.50	1.91	3.50	3.70	28	10	20	20	13	25	48	23	45	9	34	12	57	1	3	2	3	1	2	1	1	1	0.05	0.15	0.20
2147336	2024-01-17 03:45:00	46	3	2.14	3.40	2.79	2.28	3.55	2.78	1	0	5	2	2	5	3	2	10	7	8	0	10	2	3	1	2	1	3	1	1	-1	0.14	0.15	-0.01
2334731	2025-01-10 03:00:00	46	0	1.84	3.50	3.45	1.88	3.40	3.65	26	14	29	27	11	28	53	25	57	6	34	2	59	2	3	1	2	1	3	1	-1	1	0.04	-0.10	0.20
2161417	2024-02-07 03:45:00	46	3	1.47	4.35	5.90	1.54	4.15	5.30	1	6	8	7	3	4	8	9	12	7	6	3	15	3	2	1	1	2	3	1	-1	-1	0.07	-0.20	-0.60
2334730	2025-01-11 20:00:00	46	0	2.66	3.30	2.26	2.70	3.40	2.30	2	0	4	6	1	4	8	1	8	0	7	0	8	1	3	1	2	1	2	1	1	1	0.04	0.10	0.04
2188299	2024-04-21 22:30:00	46	1	5.00	4.40	1.51	5.50	4.60	1.46	3	1	8	7	6	2	10	7	10	1	4	1	11	1	3	1	2	1	2	1	1	-1	0.50	0.20	-0.05
2334728	2025-01-10 03:45:00	46	3	1.31	4.90	6.20	1.27	5.10	8.50	18	18	24	16	17	22	34	35	46	13	12	1	47	3	2	1	1	2	3	-1	1	1	-0.04	0.20	2.30
2161420	2024-02-07 03:45:00	46	3	1.51	3.95	4.95	1.51	4.15	5.90	2	1	2	2	4	3	4	5	5	2	1	1	6	3	1	1	1	2	2	0	1	1	0.00	0.20	0.95
2334733	2025-01-11 23:00:00	46	1	1.56	3.90	4.65	1.58	3.90	4.75	0	2	2	2	1	2	2	3	4	2	1	0	4	3	2	1	1	2	3	1	0	1	0.02	0.00	0.10
2334732	2025-01-11 23:00:00	46	0	1.16	6.60	9.50	1.15	6.70	12.00	3	1	0	1	4	5	4	5	5	2	1	1	6	3	1	1	1	2	2	-1	1	1	-0.01	0.10	2.50
2350988	2025-02-08 20:15:00	46	0	1.43	3.90	6.00	1.45	4.15	6.70	4	1	2	2	5	4	6	6	6	1	1	1	7	1	1	1	1	1	1	1	1	1	0.02	0.25	0.70
2334738	2025-01-11 22:00:00	46	3	1.58	3.75	4.50	1.62	3.80	4.50	2	3	3	2	2	4	4	5	7	3	2	0	7	3	2	1	1	2	3	1	1	0	0.04	0.05	0.00
2161426	2024-02-07 03:45:00	46	1	4.25	3.90	1.60	4.75	4.15	1.59	7	3	3	7	4	4	14	7	7	0	7	7	14	1	2	2	3	1	1	1	1	-1	0.50	0.25	-0.01
2147603	2024-01-30 03:30:00	46	3	1.75	4.00	3.90	1.70	4.10	4.05	1	0	1	0	3	2	1	3	3	3	1	1	4	3	1	1	1	2	2	-1	1	1	-0.05	0.10	0.15
2147604	2024-01-26 03:45:00	46	3	1.25	5.40	7.70	1.29	5.50	8.10	3	7	19	6	7	15	9	14	34	26	21	1	35	3	2	1	1	2	3	1	1	1	0.04	0.10	0.40
2147605	2024-01-27 03:45:00	46	1	2.09	3.55	3.10	2.04	3.65	3.15	16	5	12	9	8	16	25	13	28	11	23	8	36	2	3	1	2	1	3	-1	1	1	-0.05	0.10	0.05
2147606	2024-01-28 03:00:00	46	0	2.55	3.35	2.33	2.63	3.55	2.40	8	1	0	3	3	2	11	4	2	0	7	9	11	1	2	3	3	2	1	1	1	1	0.08	0.20	0.07
2188567	2024-04-21 00:15:00	46	3	1.62	4.10	4.60	1.66	4.05	4.30	5	3	7	6	2	4	11	5	11	1	7	1	12	1	3	1	2	1	2	1	-1	-1	0.04	-0.05	-0.30
2147607	2024-01-27 23:00:00	46	1	1.33	4.70	6.40	1.32	5.30	7.60	3	0	0	1	4	5	4	4	5	1	1	0	5	2	2	1	1	1	3	-1	1	1	-0.01	0.60	1.20
2147608	2024-01-27 23:00:00	46	0	4.75	3.90	1.53	5.30	4.00	1.56	1	1	0	2	1	2	3	2	2	0	1	1	3	1	2	2	3	1	1	1	1	1	0.55	0.10	0.03
2147609	2024-01-27 03:45:00	46	1	3.05	3.45	2.16	3.05	3.45	2.16	4	4	1	4	5	3	8	9	4	5	4	9	13	2	1	3	2	3	1	0	0	0	0.00	0.00	0.00
2147610	2024-01-27 04:00:00	46	0	3.80	3.90	1.67	4.00	4.10	1.70	7	3	2	6	4	3	13	7	5	4	10	12	17	1	2	3	3	2	1	1	1	1	0.20	0.20	0.03
2349855	2025-02-09 04:00:00	46	3	2.80	3.50	2.09	2.82	3.70	2.20	8	2	7	11	3	5	19	5	12	0	14	7	19	1	3	2	3	1	2	1	1	1	0.02	0.20	0.11
2349854	2025-02-09 20:30:00	46	0	4.25	3.55	1.67	4.60	3.65	1.70	5	1	0	1	1	4	6	2	4	0	4	2	6	1	3	2	3	1	2	1	1	1	0.35	0.10	0.03
2349852	2025-02-10 01:35:00	46	3	1.67	4.05	3.65	1.74	4.15	3.75	7	10	11	9	8	11	16	18	22	7	5	1	23	3	2	1	1	2	3	1	1	1	0.07	0.10	0.10
2177635	2024-03-16 20:15:00	46	0	1.65	3.40	4.55	1.65	3.40	4.50	0	0	1	0	0	1	0	0	2	2	2	0	2	2	2	1	1	1	3	0	0	-1	0.00	0.00	-0.05
2177636	2024-03-17 01:30:00	46	3	1.21	5.90	8.20	1.24	6.50	11.00	2	4	3	4	4	5	6	8	8	7	5	5	13	3	1	1	1	2	2	1	1	1	0.03	0.60	2.80
2177638	2024-03-17 20:45:00	46	3	1.38	4.35	6.10	1.42	4.85	7.00	5	4	6	5	6	6	10	10	12	4	4	2	14	2	2	1	1	1	3	1	1	1	0.04	0.50	0.90
2334707	2025-01-13 00:30:00	46	3	1.71	3.65	3.85	1.79	3.65	4.05	1	1	2	2	2	2	3	3	4	1	1	0	4	2	2	1	1	1	3	1	0	1	0.08	0.00	0.20
2334705	2025-01-11 23:00:00	46	0	4.60	4.15	1.50	4.75	4.15	1.54	3	2	4	5	4	3	8	6	7	1	3	2	9	1	3	2	3	1	2	1	0	1	0.15	0.00	0.04
2167029	2024-02-29 03:45:00	46	0	2.65	3.40	2.23	2.77	3.55	2.29	6	2	3	4	3	3	10	5	6	3	8	7	13	1	3	2	3	1	2	1	1	1	0.12	0.15	0.06
2334711	2025-01-10 03:45:00	46	3	1.26	5.20	7.70	1.25	5.80	8.00	14	9	20	11	13	26	25	22	46	21	24	0	46	2	3	1	2	1	3	-1	1	1	-0.01	0.60	0.30
2167028	2024-02-29 03:30:00	46	3	1.42	4.10	5.80	1.47	4.40	6.00	4	3	6	7	5	6	11	8	12	6	9	5	17	2	3	1	2	1	3	1	1	1	0.05	0.30	0.20
2334709	2025-01-12 02:00:00	46	1	1.94	3.50	3.15	1.99	3.50	3.20	4	1	4	5	2	4	9	3	8	1	7	2	10	1	3	2	3	1	2	1	0	1	0.05	0.00	0.05
2334708	2025-01-11 20:00:00	46	0	1.78	3.65	3.50	1.78	3.70	3.75	0	0	2	0	2	2	0	2	4	4	2	0	4	3	2	1	1	2	3	0	1	1	0.00	0.05	0.25
2204793	2024-05-25 22:00:00	46	0	1.32	5.10	6.10	1.32	5.60	8.80	10	6	15	12	7	14	22	13	29	10	19	3	32	2	3	1	2	1	3	0	1	1	0.00	0.50	2.70
2334719	2025-01-11 04:00:00	46	3	1.64	3.85	3.95	1.82	3.70	3.55	5	12	18	15	7	10	20	19	28	10	11	2	30	2	3	1	2	1	3	1	-1	-1	0.18	-0.15	-0.40
2161472	2024-02-28 03:30:00	46	1	1.62	3.95	4.10	1.57	4.05	5.10	5	6	6	3	7	7	8	13	13	11	6	6	19	3	1	1	1	2	2	-1	1	1	-0.05	0.10	1.00
1987839	2023-06-03 22:00:00	46	3	1.50	4.35	5.40	1.49	4.45	6.40	4	1	1	1	3	3	5	4	4	0	1	1	5	1	2	2	3	1	1	-1	1	1	-0.01	0.10	1.00
2161473	2024-02-29 03:45:00	46	3	2.29	3.30	2.63	2.42	3.55	2.60	16	4	20	17	5	17	33	9	37	5	29	1	38	2	3	1	2	1	3	1	1	-1	0.13	0.25	-0.03
2161474	2024-02-28 04:00:00	46	0	9.10	5.20	1.23	8.70	5.70	1.26	21	5	10	18	8	10	39	13	20	3	29	22	42	1	3	2	3	1	2	-1	1	1	-0.40	0.50	0.03
2135753	2024-01-07 22:00:00	46	1	1.36	4.60	6.00	1.39	4.65	6.70	4	1	1	2	5	6	6	6	7	1	1	0	7	2	2	1	1	1	3	1	1	1	0.03	0.05	0.70
2161485	2024-02-28 03:45:00	46	1	4.55	4.30	1.49	5.90	4.60	1.44	5	2	12	12	6	5	17	8	17	10	19	10	27	1	3	1	2	1	2	1	1	-1	1.35	0.30	-0.05
2350157	2025-02-08 23:00:00	46	0	1.67	3.45	4.30	1.66	3.65	4.90	5	5	6	7	5	6	12	10	12	1	3	1	13	1	3	1	2	1	2	-1	1	1	-0.01	0.20	0.60
2134740	2024-01-06 23:00:00	46	1	1.51	4.05	4.80	1.51	4.20	5.80	0	2	0	0	1	2	0	3	2	3	0	1	3	3	1	2	1	3	2	0	1	1	0.00	0.15	1.00
2088479	2024-04-27 15:15:00	47	0	3.65	3.80	1.84	3.25	3.80	1.96	8	3	2	1	2	8	9	5	10	4	8	3	13	2	3	1	2	1	3	-1	0	1	-0.40	0.00	0.12
2088478	2024-04-27 17:45:00	47	0	1.86	3.80	3.60	1.87	3.85	3.50	3	0	1	1	2	0	4	2	1	0	2	3	4	1	2	3	3	2	1	1	1	-1	0.01	0.05	-0.10
2128162	2024-01-12 14:30:00	47	1	2.26	3.70	2.73	2.28	3.75	2.68	1	0	3	1	1	1	2	1	4	2	3	0	4	2	3	1	2	1	3	1	1	-1	0.02	0.05	-0.05
2088477	2024-04-26 17:45:00	47	0	2.22	3.95	2.67	2.11	4.00	2.80	9	6	12	6	9	11	15	15	23	11	11	3	26	2	2	1	1	1	3	-1	1	1	-0.11	0.05	0.13
2088476	2024-04-20 17:45:00	47	3	3.85	4.40	1.69	3.85	4.35	1.69	0	1	1	1	1	0	1	2	1	1	0	1	2	2	1	2	1	3	1	0	-1	0	0.00	-0.05	0.00
2088475	2024-04-21 15:00:00	47	0	2.33	3.65	2.65	2.31	3.70	2.66	2	0	2	1	1	1	3	1	3	0	2	0	3	1	3	1	2	1	2	-1	1	1	-0.02	0.05	0.01
2088473	2024-04-20 13:30:00	47	0	2.98	3.80	2.08	3.05	3.90	2.02	4	1	5	6	3	1	10	4	6	2	8	6	12	1	3	2	3	1	2	1	1	-1	0.07	0.10	-0.06
2088472	2024-04-19 17:45:00	47	1	2.84	3.80	2.15	2.80	3.70	2.21	2	1	4	4	0	2	6	1	6	2	7	2	8	1	3	1	2	1	2	-1	-1	1	-0.04	-0.10	0.06
2088471	2024-04-20 15:30:00	47	1	1.60	4.20	4.55	1.58	4.25	4.75	1	0	1	0	1	1	1	1	2	1	1	0	2	2	2	1	1	1	3	-1	1	1	-0.02	0.05	0.20
2088468	2024-04-13 17:45:00	47	3	1.64	4.30	4.25	1.64	4.30	4.20	0	0	2	0	1	1	0	1	3	4	3	1	4	3	2	1	1	2	3	0	0	-1	0.00	0.00	-0.05
2088466	2024-04-12 17:45:00	47	0	1.73	4.30	3.70	1.73	4.35	3.70	0	0	1	0	1	0	0	1	1	2	1	1	2	3	1	1	1	2	2	0	1	0	0.00	0.05	0.00
2088464	2024-04-07 15:00:00	47	0	2.59	3.95	2.28	2.48	3.95	2.36	3	2	1	2	3	1	5	5	2	1	1	4	6	1	1	3	2	2	1	-1	0	1	-0.11	0.00	0.08
2088460	2024-03-29 16:45:00	47	3	1.93	4.00	3.20	1.91	4.00	3.25	2	2	1	2	2	1	4	4	2	3	3	5	7	1	1	3	2	2	1	-1	0	1	-0.02	0.00	0.05
2088457	2024-04-06 16:45:00	47	3	2.19	3.70	2.84	2.19	3.70	2.84	0	0	2	0	1	1	0	1	3	3	2	0	3	3	2	1	1	2	3	0	0	0	0.00	0.00	0.00
2088456	2024-04-05 16:45:00	47	0	1.93	3.90	3.25	2.05	3.85	3.00	6	3	6	9	2	5	15	5	11	0	10	4	15	1	3	2	3	1	2	1	-1	-1	0.12	-0.05	-0.25
2125624	2024-01-13 14:15:00	47	1	2.53	3.60	2.46	2.48	3.55	2.53	2	1	1	2	0	4	4	1	5	1	4	0	5	2	3	1	2	1	3	-1	-1	1	-0.05	-0.05	0.07
2088454	2024-03-30 16:45:00	47	3	2.16	3.65	2.93	2.16	3.60	2.94	0	1	0	0	0	2	0	1	2	3	2	1	3	3	2	1	1	2	3	0	-1	1	0.00	-0.05	0.01
2125626	2024-01-14 16:45:00	47	3	2.33	3.65	2.65	2.33	3.65	2.64	0	0	2	1	0	0	1	0	2	1	2	0	2	2	3	1	2	1	3	0	0	-1	0.00	0.00	-0.01
2088453	2024-03-30 14:30:00	47	1	1.55	4.35	4.95	1.55	4.35	4.95	0	0	0	0	0	1	0	0	1	1	1	0	1	2	2	1	1	1	3	0	0	0	0.00	0.00	0.00
2125627	2024-01-14 16:45:00	47	0	2.72	3.55	2.31	2.73	3.55	2.31	2	0	0	1	0	0	3	0	0	0	3	3	3	1	2	2	3	1	1	1	0	0	0.01	0.00	0.00
2088450	2024-03-16 16:45:00	47	0	2.46	3.70	2.48	2.45	3.75	2.48	4	0	5	5	1	3	9	1	8	1	9	2	10	1	3	2	3	1	2	-1	1	0	-0.01	0.05	0.00
2088449	2024-03-16 13:00:00	47	0	1.90	4.00	3.30	1.90	4.05	3.25	6	2	4	6	3	4	12	5	8	0	7	4	12	1	3	2	3	1	2	0	1	-1	0.00	0.05	-0.05
2088482	2024-04-28 13:00:00	47	3	1.39	5.10	6.10	1.34	5.50	6.90	4	1	3	1	4	5	5	5	8	3	3	0	8	2	2	1	1	1	3	-1	1	1	-0.05	0.40	0.80
2088481	2024-04-28 15:00:00	47	3	1.41	4.90	6.00	1.41	4.90	5.90	13	15	14	11	14	15	24	29	29	9	4	4	33	3	1	1	1	2	2	0	0	-1	0.00	0.00	-0.10
2088480	2024-04-27 15:15:00	47	3	1.68	4.05	4.25	1.64	4.05	4.45	3	1	2	0	2	4	3	3	6	3	3	0	6	2	2	1	1	1	3	-1	0	1	-0.04	0.00	0.20
2265442	2024-12-07 15:00:00	47	0	3.45	3.85	1.89	3.45	3.85	1.88	3	0	3	3	0	4	6	0	7	1	7	0	7	2	3	1	2	1	3	0	0	-1	0.00	0.00	-0.01
2265440	2024-12-01 13:00:00	47	0	4.10	4.00	1.71	4.10	4.00	1.71	1	0	0	0	0	1	1	0	1	0	1	0	1	1	3	1	2	1	2	0	0	0	0.00	0.00	0.00
2128229	2024-02-20 16:00:00	47	3	1.52	4.25	5.30	1.52	4.35	5.30	0	1	2	0	3	1	0	4	3	6	2	3	6	3	1	2	1	3	2	0	1	0	0.00	0.10	0.00
2128230	2024-03-12 16:00:00	47	3	1.95	3.80	3.30	1.94	3.80	3.30	4	2	3	4	1	2	8	3	5	0	5	3	8	1	3	2	3	1	2	-1	0	0	-0.01	0.00	0.00
2265444	2024-12-08 15:00:00	47	3	3.35	3.65	1.97	3.30	3.65	1.98	1	1	0	0	1	2	1	2	2	2	1	1	3	3	1	1	1	2	2	-1	0	1	-0.05	0.00	0.01
2265445	2024-12-08 14:00:00	47	3	1.27	5.70	8.70	1.27	5.80	8.80	1	0	0	0	2	2	1	2	2	1	0	0	2	3	1	1	1	2	2	0	1	1	0.00	0.10	0.10
2265450	2024-12-15 14:00:00	47	1	2.21	3.50	2.93	2.21	3.50	2.93	0	1	2	1	1	1	1	2	3	2	1	0	3	3	2	1	1	2	3	0	0	0	0.00	0.00	0.00
2265451	2024-12-14 18:45:00	47	0	2.38	3.55	2.64	2.47	3.60	2.52	9	4	13	12	5	8	21	9	21	0	12	0	21	1	3	1	2	1	2	1	1	-1	0.09	0.05	-0.12
2265449	2024-12-14 14:00:00	47	0	1.49	4.50	5.20	1.48	4.60	5.40	3	2	3	1	4	4	4	6	7	5	3	2	9	3	2	1	1	2	3	-1	1	1	-0.01	0.10	0.20
2265454	2024-12-20 16:35:00	47	1	2.19	4.00	2.68	2.19	4.10	2.64	0	1	4	0	3	2	0	4	6	6	2	0	6	3	2	1	1	2	3	0	1	-1	0.00	0.10	-0.04
2265455	2024-12-21 16:35:00	47	1	2.06	3.65	3.15	2.07	3.65	3.10	2	0	3	2	0	2	4	0	5	1	5	0	5	2	3	1	2	1	3	1	0	-1	0.01	0.00	-0.05
2265452	2024-12-06 16:35:00	47	0	2.80	3.60	2.25	2.81	3.60	2.25	1	0	0	1	0	0	2	0	0	0	2	2	2	1	2	2	3	1	1	1	0	0	0.01	0.00	0.00
2265453	2024-12-21 12:00:00	47	0	1.58	4.35	4.55	1.58	4.35	4.55	0	0	1	0	1	0	0	1	1	1	0	0	1	3	1	1	1	2	2	0	0	0	0.00	0.00	0.00
2265458	2024-12-22 14:00:00	47	3	2.13	3.60	3.00	2.13	3.55	3.05	0	1	1	1	0	1	1	1	2	1	1	0	2	2	2	1	1	1	3	0	-1	1	0.00	-0.05	0.05
2265459	2024-12-21 14:00:00	47	0	1.55	4.45	4.75	1.55	4.40	4.80	1	1	0	0	1	2	1	2	2	1	0	0	2	3	1	1	1	2	2	0	-1	1	0.00	-0.05	0.05
2265457	2024-12-14 16:35:00	47	1	1.85	3.95	3.50	1.85	3.95	3.50	2	3	3	2	3	3	4	6	6	6	4	4	10	3	1	1	1	2	2	0	0	0	0.00	0.00	0.00
2265462	2024-12-27 16:35:00	47	0	1.70	4.05	3.75	1.70	4.00	3.80	0	2	1	0	1	1	0	3	2	5	2	3	5	3	1	2	1	3	2	0	-1	1	0.00	-0.05	0.05
2265463	2024-12-28 14:00:00	47	0	2.78	3.25	2.31	2.78	3.25	2.31	1	0	0	0	0	1	1	0	1	0	1	0	1	1	3	1	2	1	2	0	0	0	0.00	0.00	0.00
2265466	2024-12-29 14:00:00	47	3	1.84	3.80	3.40	1.84	3.95	3.55	4	2	4	4	3	4	8	5	8	2	5	2	10	1	3	1	2	1	2	0	1	1	0.00	0.15	0.15
2265467	2024-12-31 16:00:00	47	1	2.86	3.55	2.23	3.20	3.65	1.87	12	3	7	11	4	4	23	7	11	0	16	12	23	1	3	2	3	1	2	1	1	-1	0.34	0.10	-0.36
2265464	2024-12-28 12:00:00	47	3	1.83	3.55	3.65	1.82	3.70	3.60	4	0	2	2	3	2	6	3	4	2	5	4	8	1	3	2	3	1	2	-1	1	-1	-0.01	0.15	-0.05
2265465	2024-12-28 16:35:00	47	3	2.43	3.45	2.50	2.36	3.50	2.57	5	0	3	3	1	6	8	1	9	2	9	1	10	2	3	1	2	1	3	-1	1	1	-0.07	0.05	0.07
2265471	2025-01-03 14:00:00	47	3	1.79	3.90	3.80	1.84	3.75	3.70	1	4	2	2	1	3	3	5	5	5	3	3	8	3	1	1	1	2	2	1	-1	-1	0.05	-0.15	-0.10
2265468	2025-01-01 12:00:00	47	1	2.36	3.45	2.74	2.28	3.40	2.88	2	2	2	1	1	4	3	3	6	3	3	0	6	2	2	1	1	1	3	-1	-1	1	-0.08	-0.05	0.14
2265413	2024-10-26 16:35:00	47	0	2.73	3.45	2.35	2.69	3.50	2.37	1	0	1	1	1	1	2	1	2	0	1	0	2	1	3	1	2	1	2	-1	1	1	-0.04	0.05	0.02
2265416	2024-11-01 16:35:00	47	0	3.10	3.70	2.07	2.96	3.65	2.13	3	1	1	1	0	3	4	1	4	0	3	0	4	1	3	1	2	1	2	-1	-1	1	-0.14	-0.05	0.06
2265425	2024-11-08 16:35:00	47	3	1.82	4.00	3.60	1.81	4.00	3.60	1	0	1	0	0	2	1	0	3	2	3	0	3	2	3	1	2	1	3	-1	0	0	-0.01	0.00	0.00
2265431	2024-11-22 14:30:00	47	0	3.30	3.75	1.96	3.20	3.75	1.99	4	0	2	2	0	6	6	0	8	2	8	0	8	2	3	1	2	1	3	-1	0	1	-0.10	0.00	0.03
2265434	2024-11-23 14:00:00	47	0	2.83	3.70	2.19	2.82	3.80	2.17	4	0	1	2	2	1	6	2	2	1	5	5	7	1	2	2	3	1	1	-1	1	-1	-0.01	0.10	-0.02
2265432	2024-11-23 16:35:00	47	3	1.74	4.05	3.85	1.74	4.10	3.80	0	0	2	0	2	0	0	2	2	3	1	1	3	3	1	1	1	2	2	0	1	-1	0.00	0.05	-0.05
2265438	2024-11-30 12:00:00	47	3	1.53	4.30	5.20	1.53	4.25	5.20	1	2	0	0	2	0	1	4	0	3	0	4	4	2	1	3	2	3	1	0	-1	0	0.00	-0.05	0.00
2265439	2024-11-30 14:00:00	47	0	1.80	4.00	3.65	1.81	4.00	3.60	0	0	1	1	1	0	1	1	1	1	1	1	2	1	1	1	1	1	1	1	0	-1	0.01	0.00	-0.05
2265437	2024-11-29 16:35:00	47	1	1.37	5.20	6.30	1.37	5.30	6.40	3	1	1	2	2	3	5	3	4	0	2	1	5	1	3	2	3	1	2	0	1	1	0.00	0.10	0.10
2088351	2023-12-02 14:30:00	47	0	2.19	3.60	2.89	2.08	3.60	3.10	3	5	4	0	5	8	3	10	12	12	5	3	15	3	2	1	1	2	3	-1	0	1	-0.11	0.00	0.21
2209953	2024-05-12 14:00:00	47	1	1.82	3.70	3.85	1.82	3.70	3.85	0	1	2	1	1	1	1	2	3	3	2	1	4	3	2	1	1	2	3	0	0	0	0.00	0.00	0.00
2088350	2023-12-01 16:45:00	47	1	2.43	3.60	2.56	2.42	3.60	2.58	2	2	1	2	1	3	4	3	4	1	2	1	5	1	3	1	2	1	2	-1	0	1	-0.01	0.00	0.02
2209955	2024-05-18 17:45:00	47	1	2.31	3.50	2.78	2.31	3.50	2.78	0	0	0	0	0	1	0	0	1	1	1	0	1	2	2	1	1	1	3	0	0	0	0.00	0.00	0.00
2088347	2023-11-25 16:45:00	47	0	2.33	3.40	2.67	2.33	3.40	2.67	0	0	0	0	0	1	0	0	1	1	1	0	1	2	2	1	1	1	3	0	0	0	0.00	0.00	0.00
2265510	2025-02-06 12:00:00	47	1	2.31	3.50	2.77	2.31	3.45	2.79	0	3	3	1	2	3	1	5	6	6	2	1	7	3	2	1	1	2	3	0	-1	1	0.00	-0.05	0.02
2209956	2024-05-18 14:30:00	47	1	2.44	3.40	2.65	2.53	3.40	2.56	3	1	2	2	0	3	5	1	5	1	5	1	6	1	3	1	2	1	2	1	0	-1	0.09	0.00	-0.09
2265511	2025-02-07 16:35:00	47	3	2.02	3.75	3.15	2.00	3.70	3.20	2	1	0	0	1	1	2	2	1	3	3	4	5	1	1	3	2	2	1	-1	-1	1	-0.02	-0.05	0.05
2265514	2025-02-08 14:00:00	47	3	3.60	3.85	1.85	3.60	3.85	1.85	1	0	0	1	0	1	2	0	1	1	3	2	3	1	3	2	3	1	2	0	0	0	0.00	0.00	0.00
2088342	2023-11-11 16:45:00	47	0	2.12	3.55	2.88	2.19	3.50	2.80	2	3	5	5	1	2	7	4	7	0	3	0	7	1	3	1	2	1	2	1	-1	-1	0.07	-0.05	-0.08
2265512	2025-02-07 18:45:00	47	1	2.91	3.65	2.17	3.15	3.70	2.17	3	2	1	4	3	1	7	5	2	0	2	5	7	1	2	3	3	2	1	1	1	0	0.24	0.05	0.00
2265513	2025-02-08 16:35:00	47	1	1.69	4.20	4.00	1.71	4.15	3.90	0	2	2	1	2	1	1	4	3	4	1	2	5	3	1	2	1	3	2	1	-1	-1	0.02	-0.05	-0.10
2088338	2023-10-28 16:45:00	47	3	1.91	3.55	3.40	1.92	3.50	3.40	1	2	3	3	0	1	4	2	4	1	3	1	5	1	3	1	2	1	2	1	-1	0	0.01	-0.05	0.00
2088383	2023-12-30 14:30:00	47	3	2.13	3.75	2.92	2.13	3.75	2.92	0	0	1	1	0	0	1	0	1	0	1	0	1	1	3	1	2	1	2	0	0	0	0.00	0.00	0.00
2265474	2025-01-03 18:45:00	47	0	3.50	3.85	1.86	4.10	4.05	1.79	2	1	4	6	4	2	8	5	6	3	6	5	11	1	3	2	3	1	2	1	1	-1	0.60	0.20	-0.07
2088382	2023-12-29 16:45:00	47	3	1.84	3.95	3.55	1.85	3.90	3.50	1	1	2	1	1	2	2	2	4	4	4	2	6	2	2	1	1	1	3	1	-1	-1	0.01	-0.05	-0.05
2265475	2025-01-04 14:00:00	47	1	3.65	4.15	1.77	3.60	4.20	1.77	3	1	0	1	2	1	4	3	1	0	1	3	4	1	2	3	3	2	1	-1	1	0	-0.05	0.05	0.00
2088381	2023-12-28 16:45:00	47	3	1.70	4.05	4.10	1.69	4.05	4.15	1	0	1	0	1	2	1	1	3	3	3	1	4	2	2	1	1	1	3	-1	0	1	-0.01	0.00	0.05
2088380	2023-12-23 19:30:00	47	3	2.32	3.70	2.64	2.32	3.70	2.64	1	0	0	0	0	1	1	0	1	0	1	0	1	1	3	1	2	1	2	0	0	0	0.00	0.00	0.00
2265473	2025-01-03 16:35:00	47	0	2.35	3.50	2.72	2.35	3.50	2.72	0	2	7	0	3	8	0	5	15	15	10	0	15	3	2	1	1	2	3	0	0	0	0.00	0.00	0.00
2265478	2025-01-08 16:00:00	47	3	1.23	6.20	9.40	1.22	6.50	9.60	2	0	4	1	3	7	3	3	11	9	9	1	12	2	2	1	1	1	3	-1	1	1	-0.01	0.30	0.20
2088378	2023-12-23 14:30:00	47	3	1.66	4.10	4.30	1.66	4.10	4.25	0	2	2	1	1	1	1	3	3	4	2	2	5	3	1	1	1	2	2	0	0	-1	0.00	0.00	-0.05
2265479	2025-01-07 17:00:00	47	0	2.29	3.60	2.73	2.29	3.65	2.72	0	0	2	1	1	0	1	1	2	1	1	0	2	2	2	1	1	1	3	0	1	-1	0.00	0.05	-0.01
2265476	2025-01-04 16:35:00	47	1	1.63	4.10	4.50	1.63	4.20	4.40	0	1	2	0	2	1	0	3	3	4	1	1	4	3	1	1	1	2	2	0	1	-1	0.00	0.10	-0.10
2265482	2025-01-11 18:45:00	47	3	6.50	4.60	1.41	6.80	4.80	1.44	2	2	4	7	3	3	9	5	7	1	5	3	10	1	3	2	3	1	2	1	1	1	0.30	0.20	0.03
2088374	2023-12-18 16:00:00	47	0	2.28	3.65	2.72	2.28	3.65	2.72	0	0	2	0	0	1	0	0	3	3	3	0	3	2	2	1	1	1	3	0	0	0	0.00	0.00	0.00
2265483	2025-01-11 16:35:00	47	3	1.60	4.10	4.80	1.57	4.10	5.00	3	0	1	0	0	5	3	0	6	4	7	1	7	2	3	1	2	1	3	-1	0	1	-0.03	0.00	0.20
2088373	2023-12-17 14:00:00	47	1	1.92	3.85	3.35	1.91	3.85	3.35	1	0	2	3	0	1	4	0	3	1	5	2	5	1	3	2	3	1	2	-1	0	0	-0.01	0.00	0.00
2265480	2025-01-07 15:00:00	47	3	2.16	3.60	2.93	2.12	3.55	3.05	1	2	4	1	1	7	2	3	11	10	9	1	12	3	2	1	1	2	3	-1	-1	1	-0.04	-0.05	0.12
2265481	2025-01-10 16:35:00	47	0	1.75	3.90	3.95	1.75	4.00	3.90	0	3	3	0	4	2	0	7	5	11	4	6	11	3	1	2	1	3	2	0	1	-1	0.00	0.10	-0.05
2088371	2023-12-16 15:00:00	47	1	2.06	3.65	3.10	2.06	3.65	3.15	0	0	0	0	0	1	0	0	1	2	2	1	2	2	2	1	1	1	3	0	0	1	0.00	0.00	0.05
2265486	2025-01-11 14:00:00	47	3	1.49	4.30	5.80	1.49	4.30	5.80	1	0	0	0	1	1	1	1	1	0	0	0	1	1	1	1	1	1	1	0	0	0	0.00	0.00	0.00
2265487	2025-01-15 14:00:00	47	1	3.40	3.65	1.95	3.40	3.70	1.94	2	2	9	5	3	3	7	5	12	7	9	2	14	2	3	1	2	1	3	0	1	-1	0.00	0.05	-0.01
2088369	2023-12-15 16:45:00	47	3	1.89	3.95	3.35	1.86	4.00	3.45	2	1	2	2	2	2	4	3	4	0	1	0	4	1	3	1	2	1	2	-1	1	1	-0.03	0.05	0.10
2265484	2025-01-11 12:00:00	47	0	2.98	3.65	2.13	2.98	3.60	2.14	2	1	0	1	1	1	3	2	1	0	1	2	3	1	2	3	3	2	1	0	-1	1	0.00	-0.05	0.01
2088368	2023-12-10 14:00:00	47	0	2.40	3.55	2.61	2.40	3.55	2.61	0	0	2	0	0	1	0	0	3	4	4	1	4	2	2	1	1	1	3	0	0	0	0.00	0.00	0.00
2265490	2025-01-18 12:00:00	47	3	2.05	3.35	3.40	2.05	3.35	3.45	0	0	1	1	0	1	1	0	2	1	2	0	2	2	3	1	2	1	3	0	0	1	0.00	0.00	0.05
2088366	2023-12-08 18:45:00	47	0	3.35	3.70	1.95	3.55	3.75	1.88	4	2	6	5	3	4	9	5	10	2	6	1	11	2	3	1	2	1	3	1	1	-1	0.20	0.05	-0.07
2265491	2025-01-18 14:00:00	47	0	1.43	4.70	6.00	1.40	4.90	6.30	3	0	2	2	3	3	5	3	5	1	3	1	6	1	3	1	2	1	2	-1	1	1	-0.03	0.20	0.30
2088365	2023-10-27 16:45:00	47	3	2.75	3.30	2.31	2.69	3.30	2.36	2	0	0	0	0	2	2	0	2	0	2	0	2	1	3	1	2	1	2	-1	0	1	-0.06	0.00	0.05
2265488	2025-01-17 16:35:00	47	0	1.83	3.80	3.70	1.83	3.75	3.75	0	1	1	1	0	1	1	1	2	1	1	0	2	2	2	1	1	1	3	0	-1	1	0.00	-0.05	0.05
2265489	2025-01-14 18:45:00	47	0	4.60	4.25	1.59	4.75	4.50	1.62	2	5	1	3	3	2	5	8	3	4	1	6	9	2	1	3	2	3	1	1	1	1	0.15	0.25	0.03
2265494	2025-01-22 16:30:00	47	1	2.01	3.70	3.20	1.98	3.70	3.25	2	0	0	1	0	1	3	0	1	0	3	2	3	1	3	2	3	1	2	-1	0	1	-0.03	0.00	0.05
2088362	2023-12-09 16:45:00	47	0	1.70	4.05	4.05	1.69	4.10	4.10	1	1	1	0	1	2	1	2	3	3	2	1	4	3	2	1	1	2	3	-1	1	1	-0.01	0.05	0.05
2265495	2025-01-18 16:35:00	47	3	2.11	4.00	2.81	2.12	3.95	2.82	0	1	2	1	0	1	1	1	3	2	2	0	3	2	2	1	1	1	3	1	-1	1	0.01	-0.05	0.01
2265493	2025-01-17 14:00:00	47	3	1.82	4.00	3.55	1.82	4.05	3.55	0	0	1	1	1	0	1	1	1	1	1	1	2	1	1	1	1	1	1	0	1	0	0.00	0.05	0.00
2088358	2023-11-10 16:45:00	47	1	1.68	3.75	4.20	1.60	3.90	4.55	2	1	3	0	4	3	2	5	6	5	2	1	7	3	2	1	1	2	3	-1	1	1	-0.08	0.15	0.35
2265497	2025-01-24 16:35:00	47	3	2.14	3.75	2.89	2.13	3.75	2.90	1	0	1	0	0	1	1	0	2	2	3	1	3	2	3	1	2	1	3	-1	0	1	-0.01	0.00	0.01
2088354	2023-11-12 14:00:00	47	0	2.02	3.55	3.10	2.09	3.50	2.98	0	2	4	3	0	1	3	2	5	2	3	0	5	2	3	1	2	1	3	1	-1	-1	0.07	-0.05	-0.12
2265503	2025-01-26 14:00:00	47	0	2.61	3.50	2.43	2.63	3.50	2.42	1	0	1	1	0	0	2	0	1	0	2	1	2	1	3	2	3	1	2	1	0	-1	0.02	0.00	-0.01
2088352	2023-12-03 14:00:00	47	0	3.50	3.80	1.89	3.55	3.80	1.87	0	0	1	1	0	1	1	0	2	2	3	1	3	2	3	1	2	1	3	1	0	-1	0.05	0.00	-0.02
2088415	2024-02-03 16:45:00	47	0	2.49	3.85	2.39	2.51	3.85	2.36	4	0	5	4	0	3	8	0	8	0	8	0	8	1	3	1	2	1	2	1	0	-1	0.02	0.00	-0.03
2088414	2024-02-03 15:00:00	47	1	3.15	3.60	2.05	3.40	3.70	1.94	7	2	15	11	3	11	18	5	26	9	22	1	27	2	3	1	2	1	3	1	1	-1	0.25	0.10	-0.11
2088413	2024-02-03 14:00:00	47	1	3.55	3.95	1.83	3.60	4.00	1.81	2	0	2	2	1	2	4	1	4	0	3	0	4	1	3	1	2	1	2	1	1	-1	0.05	0.05	-0.02
2088411	2024-02-02 18:45:00	47	3	3.45	3.90	1.88	3.45	3.90	1.88	2	1	2	1	0	4	3	1	6	3	5	0	6	2	3	1	2	1	3	0	0	0	0.00	0.00	0.00
2088410	2024-01-28 14:00:00	47	1	1.89	4.00	3.30	1.86	4.05	3.40	4	2	5	5	3	4	9	5	9	0	4	0	9	1	3	1	2	1	2	-1	1	1	-0.03	0.05	0.10
2088409	2024-01-27 16:45:00	47	3	1.38	4.90	6.90	1.39	4.85	6.60	3	2	6	4	2	5	7	4	11	4	7	0	11	2	3	1	2	1	3	1	-1	-1	0.01	-0.05	-0.30
2088408	2024-01-27 14:00:00	47	0	2.89	3.65	2.17	2.89	3.65	2.17	3	0	0	2	0	1	5	0	1	0	5	4	5	1	3	2	3	1	2	0	0	0	0.00	0.00	0.00
2088407	2024-01-27 15:00:00	47	0	2.28	3.60	2.74	2.28	3.60	2.74	0	0	1	1	0	0	1	0	1	0	1	0	1	1	3	1	2	1	2	0	0	0	0.00	0.00	0.00
2088406	2024-01-26 16:45:00	47	1	2.23	3.65	2.81	2.23	3.65	2.80	0	1	1	0	2	0	0	3	1	3	0	2	3	3	1	2	1	3	2	0	0	-1	0.00	0.00	-0.01
2088405	2024-01-21 15:00:00	47	3	2.35	3.65	2.62	2.35	3.65	2.62	0	0	1	1	0	0	1	0	1	0	1	0	1	1	3	1	2	1	2	0	0	0	0.00	0.00	0.00
2088404	2024-01-25 16:45:00	47	3	1.82	4.05	3.50	1.84	4.10	3.40	1	2	3	1	2	2	2	4	5	5	3	2	7	3	2	1	1	2	3	1	1	-1	0.02	0.05	-0.10
2088403	2024-04-16 17:00:00	47	1	2.41	4.05	2.39	2.45	4.05	2.35	3	0	4	4	0	3	7	0	7	0	7	0	7	1	3	1	2	1	2	1	0	-1	0.04	0.00	-0.04
2088402	2024-01-20 16:45:00	47	0	1.56	4.35	4.75	1.56	4.35	4.70	0	0	1	0	0	1	0	0	2	2	2	0	2	2	2	1	1	1	3	0	0	-1	0.00	0.00	-0.05
2088401	2024-01-19 16:45:00	47	3	1.65	4.30	4.15	1.65	4.30	4.15	0	0	1	0	0	0	0	0	1	1	1	0	1	2	2	1	1	1	3	0	0	0	0.00	0.00	0.00
2088399	2024-01-18 16:45:00	47	0	2.02	3.90	3.05	2.06	3.90	2.96	7	3	3	5	3	3	12	6	6	0	6	6	12	1	2	2	3	1	1	1	0	-1	0.04	0.00	-0.09
2088397	2024-01-08 16:45:00	47	1	1.88	4.00	3.35	1.83	4.05	3.50	5	2	2	2	3	3	7	5	5	1	3	3	8	1	2	2	3	1	1	-1	1	1	-0.05	0.05	0.15
2088395	2024-01-23 16:00:00	47	3	2.16	3.75	2.84	2.17	3.75	2.83	1	0	1	1	0	1	2	0	2	0	2	0	2	1	3	1	2	1	2	1	0	-1	0.01	0.00	-0.01
2088394	2024-04-03 18:45:00	47	1	3.40	4.00	1.86	3.60	4.10	1.79	4	1	9	7	3	4	11	4	13	2	9	0	13	2	3	1	2	1	3	1	1	-1	0.20	0.10	-0.07
2088392	2024-01-07 14:00:00	47	0	3.95	4.00	1.74	3.90	4.00	1.74	2	1	0	0	1	1	2	2	1	2	2	3	4	1	1	3	2	2	1	-1	0	0	-0.05	0.00	0.00
2088388	2024-01-05 16:45:00	47	1	2.12	3.80	2.91	2.12	3.80	2.89	0	0	2	0	0	1	0	0	3	3	3	0	3	2	2	1	1	1	3	0	0	-1	0.00	0.00	-0.02
2088385	2023-12-31 16:00:00	47	3	1.59	4.20	4.65	1.53	4.35	5.10	3	1	0	0	3	4	3	4	4	1	0	0	4	3	1	1	1	2	2	-1	1	1	-0.06	0.15	0.45
2088447	2024-03-15 16:45:00	47	0	2.21	3.80	2.76	2.21	3.80	2.76	0	0	0	0	1	0	0	1	0	1	0	1	1	2	1	2	1	3	1	0	0	0	0.00	0.00	0.00
2088446	2024-03-10 14:00:00	47	1	1.54	4.50	4.70	1.54	4.50	4.70	0	0	0	1	0	0	1	0	0	0	1	1	1	1	2	2	3	1	1	0	0	0	0.00	0.00	0.00
2264003	2024-10-18 16:35:00	47	1	2.39	3.30	2.78	2.52	3.25	2.68	6	2	7	8	1	7	14	3	14	2	13	2	16	1	3	1	2	1	2	1	-1	-1	0.13	-0.05	-0.10
2088445	2024-03-09 18:45:00	47	1	2.12	3.80	2.89	2.12	3.80	2.89	0	0	1	0	0	0	0	0	1	1	1	0	1	2	2	1	1	1	3	0	0	0	0.00	0.00	0.00
2016762	2023-06-03 17:45:00	47	0	2.04	3.75	3.10	2.05	3.70	3.10	2	1	1	1	1	2	3	2	3	0	1	0	3	1	3	1	2	1	2	1	-1	0	0.01	-0.05	0.00
2088443	2024-03-09 16:00:00	47	3	1.94	3.75	3.35	1.90	3.75	3.50	5	0	1	1	1	4	6	1	5	0	5	1	6	1	3	2	3	1	2	-1	0	1	-0.04	0.00	0.15
2088442	2024-03-10 14:00:00	47	0	2.73	3.55	2.31	2.74	3.55	2.31	1	0	0	1	0	1	2	0	1	0	2	1	2	1	3	2	3	1	2	1	0	0	0.01	0.00	0.00
2088441	2024-03-08 16:45:00	47	0	1.75	4.05	3.85	1.75	4.05	3.85	0	1	1	0	2	0	0	3	1	3	0	2	3	3	1	2	1	3	2	0	0	0	0.00	0.00	0.00
2088440	2024-03-03 14:00:00	47	3	3.00	3.55	2.14	3.00	3.55	2.14	1	0	0	0	0	1	1	0	1	0	1	0	1	1	3	1	2	1	2	0	0	0	0.00	0.00	0.00
2088438	2024-03-02 16:45:00	47	0	2.48	3.60	2.51	2.41	3.60	2.57	2	0	0	0	0	3	2	0	3	1	3	0	3	2	3	1	2	1	3	-1	0	1	-0.07	0.00	0.06
2088437	2024-03-02 14:00:00	47	3	2.13	3.70	2.95	2.13	3.70	2.95	0	0	1	1	0	0	1	0	1	0	1	0	1	1	3	1	2	1	2	0	0	0	0.00	0.00	0.00
2088436	2024-03-02 15:00:00	47	0	3.15	3.55	2.09	3.15	3.55	2.08	0	0	1	0	0	1	0	0	2	2	2	0	2	2	2	1	1	1	3	0	0	-1	0.00	0.00	-0.01
2088435	2024-03-01 16:45:00	47	3	2.82	3.70	2.19	2.80	3.75	2.19	1	1	0	1	1	0	2	2	0	0	0	2	2	1	1	3	2	2	1	-1	1	0	-0.02	0.05	0.00
2088434	2024-02-25 14:00:00	47	0	1.92	3.60	3.55	1.87	3.65	3.70	4	0	1	1	1	3	5	1	4	0	4	1	5	1	3	2	3	1	2	-1	1	1	-0.05	0.05	0.15
2088433	2024-02-24 18:45:00	47	1	2.30	3.65	2.71	2.27	3.65	2.74	3	1	2	1	1	3	4	2	5	1	3	0	5	2	3	1	2	1	3	-1	0	1	-0.03	0.00	0.03
2088432	2024-02-24 16:45:00	47	0	2.35	3.80	2.55	2.36	3.80	2.54	0	0	2	2	0	0	2	0	2	0	2	0	2	1	3	1	2	1	2	1	0	-1	0.01	0.00	-0.01
2088431	2024-02-25 14:00:00	47	1	1.97	3.90	3.15	1.94	3.90	3.25	2	0	1	1	0	2	3	0	3	0	3	0	3	1	3	1	2	1	2	-1	0	1	-0.03	0.00	0.10
2088430	2024-02-24 14:30:00	47	1	1.85	4.00	3.45	1.87	4.05	3.35	0	2	3	3	3	0	3	5	3	4	2	4	7	2	1	2	1	3	1	1	1	-1	0.02	0.05	-0.10
2088429	2024-02-23 16:45:00	47	1	1.91	3.95	3.30	1.90	3.90	3.35	5	3	4	3	3	4	8	6	8	7	9	7	15	1	3	1	2	1	2	-1	-1	1	-0.01	-0.05	0.05
2207191	2024-05-05 15:00:00	47	1	2.42	3.60	2.58	2.42	3.60	2.57	0	3	5	0	4	4	0	7	9	9	2	0	9	3	2	1	1	2	3	0	0	-1	0.00	0.00	-0.01
2207190	2024-05-04 17:45:00	47	3	1.43	4.75	6.00	1.42	4.80	6.00	7	7	7	5	9	8	12	16	15	6	2	3	18	3	1	2	1	3	2	-1	1	0	-0.01	0.05	0.00
2088423	2024-02-18 14:00:00	47	0	2.28	3.65	2.73	2.28	3.65	2.73	0	0	1	1	0	0	1	0	1	0	1	0	1	1	3	1	2	1	2	0	0	0	0.00	0.00	0.00
2337121	2025-01-05 00:30:00	48	3	2.88	3.35	2.20	2.92	3.25	2.33	3	1	0	3	1	3	6	2	3	0	4	3	6	1	3	2	3	1	2	1	-1	1	0.04	-0.10	0.13
2361568	2025-02-07 02:30:00	48	3	1.73	3.35	4.10	1.79	3.45	4.95	3	3	6	7	3	5	10	6	11	2	6	1	12	2	3	1	2	1	3	1	1	1	0.06	0.10	0.85
2361569	2025-02-07 04:30:00	48	0	5.90	4.75	1.35	8.90	5.20	1.34	20	7	11	23	8	11	43	15	22	1	29	22	44	1	3	2	3	1	2	1	1	-1	3.00	0.45	-0.01
2337125	2025-01-05 19:00:00	48	3	2.27	3.10	2.81	2.27	3.10	2.81	0	0	2	1	0	1	1	0	3	2	3	0	3	2	3	1	2	1	3	0	0	0	0.00	0.00	0.00
2337124	2025-01-08 04:00:00	48	0	3.05	3.35	2.02	3.50	3.20	2.08	19	7	23	23	4	22	42	11	45	12	43	9	54	2	3	1	2	1	3	1	-1	1	0.45	-0.15	0.06
2337130	2025-01-04 22:30:00	48	0	4.05	3.35	1.74	4.35	3.40	1.73	2	0	2	3	2	0	5	2	2	0	3	3	5	1	2	2	3	1	1	1	1	-1	0.30	0.05	-0.01
2337129	2025-01-04 02:00:00	48	1	2.90	2.91	2.32	2.92	2.91	2.54	7	4	2	3	5	7	10	9	9	1	2	2	11	1	2	2	3	1	1	1	0	1	0.02	0.00	0.22
2183210	2024-04-07 04:00:00	48	1	1.64	3.55	5.30	1.70	3.45	5.90	2	6	7	5	5	10	7	11	17	12	8	2	19	3	2	1	1	2	3	1	-1	1	0.06	-0.10	0.60
2347565	2025-01-16 04:00:00	48	3	1.20	5.70	9.60	1.31	5.50	7.30	7	13	25	12	11	20	19	24	45	28	23	2	47	3	2	1	1	2	3	1	-1	-1	0.11	-0.20	-2.30
2347564	2025-01-17 02:30:00	48	0	1.50	3.60	5.60	1.63	3.65	5.20	10	10	14	14	7	12	24	17	26	6	13	4	30	2	3	1	2	1	3	1	1	-1	0.13	0.05	-0.40
2347571	2025-01-17 04:30:00	48	1	1.27	5.10	7.20	1.32	5.60	7.00	19	14	27	20	12	29	39	26	56	24	37	7	63	2	3	1	2	1	3	1	1	-1	0.05	0.50	-0.20
2147441	2024-01-18 04:30:00	48	3	1.71	3.80	4.30	1.71	3.90	4.20	3	1	5	1	3	5	4	4	10	7	7	1	11	2	2	1	1	1	3	0	1	-1	0.00	0.10	-0.10
2151921	2024-01-26 04:00:00	48	3	1.50	4.15	5.40	1.49	4.60	6.40	6	3	2	2	8	8	8	11	10	8	5	6	16	3	1	2	1	3	2	-1	1	1	-0.01	0.45	1.00
2151922	2024-01-25 04:30:00	48	1	2.54	3.35	2.44	2.65	3.65	2.51	17	3	14	17	4	13	34	7	27	0	27	7	34	1	3	2	3	1	2	1	1	1	0.11	0.30	0.07
2151923	2024-01-25 02:30:00	48	3	3.05	3.15	2.21	3.55	3.35	2.14	18	5	24	22	8	22	40	13	46	9	36	3	49	2	3	1	2	1	3	1	1	-1	0.50	0.20	-0.07
2337136	2025-01-05 22:30:00	48	0	3.15	3.40	1.97	3.45	3.65	1.94	1	1	2	2	2	1	3	3	3	1	1	1	4	1	1	1	1	1	1	1	1	-1	0.30	0.25	-0.03
2147445	2024-01-18 03:00:00	48	0	2.20	3.15	3.25	2.20	3.10	3.30	3	1	2	1	1	3	4	2	5	2	4	1	6	2	3	1	2	1	3	0	-1	1	0.00	-0.05	0.05
2347572	2025-01-17 02:30:00	48	3	1.65	3.40	4.60	1.73	3.35	4.95	1	4	5	4	3	5	5	7	10	7	5	2	12	3	2	1	1	2	3	1	-1	1	0.08	-0.05	0.35
2147457	2024-01-19 04:30:00	48	1	2.67	3.45	2.40	2.64	3.50	2.40	11	0	10	9	1	8	20	1	18	1	20	3	21	1	3	2	3	1	2	-1	1	0	-0.03	0.05	0.00
2134341	2024-01-07 00:00:00	48	0	2.72	3.15	2.31	2.81	3.15	2.36	1	1	2	5	0	3	6	1	5	0	5	1	6	1	3	2	3	1	2	1	0	1	0.09	0.00	0.05
2134344	2024-01-07 19:00:00	48	0	2.84	3.00	2.30	2.85	2.94	2.33	3	5	2	4	3	3	7	8	5	1	0	3	8	2	1	3	2	3	1	1	-1	1	0.01	-0.06	0.03
2134345	2024-01-07 01:00:00	48	0	3.45	3.50	1.84	3.60	3.55	1.85	15	9	17	15	10	16	30	19	33	5	16	2	35	2	3	1	2	1	3	1	1	1	0.15	0.05	0.01
2134346	2024-01-07 03:00:00	48	3	2.50	3.10	2.53	2.63	3.10	2.52	3	1	5	5	1	3	8	2	8	0	6	0	8	1	3	1	2	1	2	1	0	-1	0.13	0.00	-0.01
2134347	2024-01-08 02:00:00	48	0	2.84	3.30	2.16	3.15	3.40	1.97	4	1	6	7	4	2	11	5	8	1	7	4	12	1	3	2	3	1	2	1	1	-1	0.31	0.10	-0.19
2134348	2024-01-07 23:00:00	48	0	3.30	3.25	1.96	3.50	3.30	1.89	5	3	8	9	5	5	14	8	13	2	8	3	16	1	3	2	3	1	2	1	1	-1	0.20	0.05	-0.07
2162509	2024-02-08 04:30:00	48	0	1.99	3.40	3.55	2.06	3.40	3.70	12	5	10	11	5	10	23	10	20	6	19	9	29	1	3	2	3	1	2	1	0	1	0.07	0.00	0.15
2162510	2024-02-28 04:30:00	48	1	1.62	3.55	6.60	1.61	3.55	6.80	2	1	4	2	2	7	4	3	11	7	8	0	11	2	3	1	2	1	3	-1	0	1	-0.01	0.00	0.20
2162511	2024-02-07 04:00:00	48	1	3.45	2.90	2.25	3.55	2.89	2.36	4	11	0	4	7	3	8	18	3	11	1	16	19	2	1	3	2	3	1	1	-1	1	0.10	-0.01	0.11
2162512	2024-03-01 04:30:00	48	3	2.40	3.25	3.05	2.47	3.25	2.96	0	0	6	3	1	4	3	1	10	8	10	1	11	2	3	1	2	1	3	1	0	-1	0.07	0.00	-0.09
2147617	2024-01-21 00:30:00	49	0	3.30	3.20	2.06	3.35	3.25	2.04	0	0	1	2	2	0	2	2	1	0	0	1	2	1	1	3	2	2	1	1	1	-1	0.05	0.05	-0.02
2147619	2024-01-21 00:30:00	49	0	4.25	4.10	1.56	5.10	4.05	1.52	1	1	1	1	1	0	2	2	1	0	0	1	2	1	1	3	2	2	1	1	-1	-1	0.85	-0.05	-0.04
2147622	2024-01-21 03:45:00	49	0	15.00	8.70	1.09	15.00	9.60	1.07	5	7	7	6	7	5	11	14	12	5	2	4	16	3	1	2	1	3	2	0	1	-1	0.00	0.90	-0.02
2135367	2024-01-07 21:30:00	49	1	2.13	3.40	2.81	2.13	3.40	2.81	0	0	0	0	0	1	0	0	1	1	1	0	1	2	2	1	1	1	3	0	0	0	0.00	0.00	0.00
2339140	2024-12-23 00:30:00	49	3	1.88	3.35	3.45	1.96	3.30	3.25	0	1	1	1	0	0	1	1	1	1	1	1	2	1	1	1	1	1	1	1	-1	-1	0.08	-0.05	-0.20
2147624	2024-01-22 00:30:00	49	0	2.34	3.05	2.76	2.36	3.15	2.78	3	2	3	4	3	4	7	5	7	0	2	0	7	1	3	1	2	1	2	1	1	1	0.02	0.10	0.02
2173291	2024-03-14 04:10:00	49	3	1.37	4.35	6.20	1.50	4.45	6.40	11	14	21	17	14	15	28	28	36	13	13	5	41	2	2	1	1	1	3	1	1	1	0.13	0.10	0.20
2197547	2024-05-26 03:00:00	49	0	5.40	4.30	1.58	4.80	4.30	1.64	6	2	1	2	3	6	8	5	7	0	3	1	8	1	3	2	3	1	2	-1	0	1	-0.60	0.00	0.06
2155787	2024-02-08 04:10:00	49	3	1.37	4.45	6.00	1.36	4.90	7.00	9	7	15	8	10	20	17	17	35	22	22	4	39	2	2	1	1	1	3	-1	1	1	-0.01	0.45	1.00
2339144	2024-12-23 04:00:00	49	1	4.15	3.55	1.68	4.05	3.55	1.69	4	2	1	3	3	1	7	5	2	1	3	6	8	1	2	3	3	2	1	-1	0	1	-0.10	0.00	0.01
2147630	2024-01-22 04:05:00	49	1	2.29	3.20	2.83	2.24	3.25	2.91	4	1	2	3	3	5	7	4	7	0	3	0	7	1	3	1	2	1	2	-1	1	1	-0.05	0.05	0.08
2338541	2024-12-21 03:45:00	49	3	3.05	3.00	2.17	2.88	2.99	2.28	6	5	7	6	5	7	12	10	14	3	5	1	15	2	3	1	2	1	3	-1	-1	1	-0.17	-0.01	0.11
2345907	2025-01-15 03:45:00	49	1	3.25	3.30	1.97	3.10	3.50	2.03	7	3	9	5	5	8	12	8	17	8	12	3	20	2	3	1	2	1	3	-1	1	1	-0.15	0.20	0.06
2345910	2025-01-16 01:30:00	49	3	2.07	3.20	3.05	2.09	3.20	3.05	1	1	4	1	1	3	2	2	7	5	5	0	7	2	2	1	1	1	3	1	0	0	0.02	0.00	0.00
2345908	2025-01-15 04:10:00	49	1	2.07	3.40	3.10	2.07	3.30	3.20	4	10	7	8	10	8	12	20	15	11	3	8	23	3	1	2	1	3	2	0	-1	1	0.00	-0.10	0.10
2186396	2024-04-04 03:10:00	49	3	1.40	4.70	6.60	1.41	4.65	6.60	12	10	12	13	10	13	25	20	25	8	13	8	33	1	3	1	2	1	2	1	-1	0	0.01	-0.05	0.00
2134851	2023-12-19 02:00:00	50	3	1.89	3.35	3.45	1.97	3.30	3.45	5	2	6	6	2	5	11	4	11	3	10	3	14	1	3	1	2	1	2	1	-1	0	0.08	-0.05	0.00
2134852	2023-12-20 02:00:00	50	0	11.00	7.20	1.15	17.00	7.90	1.16	5	12	7	7	12	9	12	24	16	15	3	11	27	3	1	2	1	3	2	1	1	1	6.00	0.70	0.01
2135688	2023-12-22 22:30:00	50	0	3.15	3.55	2.00	3.45	3.80	2.02	8	3	7	7	5	10	15	8	17	6	13	4	21	2	3	1	2	1	3	1	1	1	0.30	0.25	0.02
2135689	2023-12-23 02:00:00	50	3	1.31	5.00	7.00	1.29	5.60	10.00	11	7	16	13	8	10	24	15	26	10	19	8	34	2	3	1	2	1	3	-1	1	1	-0.02	0.60	3.00
2131899	2023-12-13 02:00:00	50	3	1.07	8.50	15.00	1.08	8.20	13.00	10	16	14	9	11	10	19	27	24	9	1	4	28	3	1	2	1	3	2	1	-1	-1	0.01	-0.30	-2.00
2131900	2023-12-15 22:30:00	50	0	2.08	3.30	2.99	2.06	3.40	3.35	1	2	2	0	3	5	1	5	7	7	3	1	8	3	2	1	1	2	3	-1	1	1	-0.02	0.10	0.36
2325795	2024-12-05 03:45:00	51	1	2.80	3.40	2.13	3.05	3.40	2.33	3	7	2	8	4	4	11	11	6	3	3	8	14	1	1	3	2	2	1	1	0	1	0.25	0.00	0.20
2325794	2024-12-05 01:00:00	51	1	1.86	3.65	3.25	1.86	3.75	3.60	9	4	5	8	3	7	17	7	12	5	15	10	22	1	3	2	3	1	2	0	1	1	0.00	0.10	0.35
2325796	2024-12-04 03:45:00	51	3	1.60	4.35	4.45	1.64	4.35	4.75	3	3	4	3	4	6	6	7	10	4	3	0	10	3	2	1	1	2	3	1	0	1	0.04	0.00	0.30
2325802	2024-12-05 01:00:00	51	3	1.90	3.50	3.25	1.91	3.85	3.40	4	1	2	2	4	4	6	5	6	4	5	4	10	1	3	1	2	1	2	1	1	1	0.01	0.35	0.15
2325801	2024-12-04 01:00:00	51	3	5.30	3.65	1.52	5.80	4.10	1.58	5	2	3	4	5	5	9	7	8	1	3	2	10	1	3	2	3	1	2	1	1	1	0.50	0.45	0.06
2197546	2024-05-26 02:00:00	51	0	8.70	6.80	1.17	17.00	8.30	1.15	2	3	5	5	7	3	7	10	8	5	2	4	12	3	1	2	1	3	2	1	1	-1	8.30	1.50	-0.02
2325806	2024-12-04 01:00:00	51	0	6.60	5.60	1.26	9.50	6.30	1.27	5	3	3	9	6	4	14	9	7	1	6	8	15	1	2	3	3	2	1	1	1	1	2.90	0.70	0.01
2294125	2024-10-30 03:45:00	51	3	1.19	6.10	8.30	1.22	6.30	9.60	3	6	10	5	7	9	8	13	19	12	7	1	20	3	2	1	1	2	3	1	1	1	0.03	0.20	1.30
2325805	2024-12-05 03:45:00	51	3	2.26	3.35	2.64	2.36	3.70	2.81	8	4	16	8	8	12	16	12	28	12	16	0	28	2	3	1	2	1	3	1	1	1	0.10	0.35	0.17
2294124	2024-10-30 01:00:00	51	3	1.31	4.70	6.90	1.42	4.45	6.30	4	13	17	14	6	9	18	19	26	8	7	0	26	3	2	1	1	2	3	1	-1	-1	0.11	-0.25	-0.60
2325804	2024-12-04 03:45:00	51	0	1.74	3.90	4.00	1.65	4.20	4.90	12	12	13	9	17	19	21	29	32	15	7	4	36	3	2	1	1	2	3	-1	1	1	-0.09	0.30	0.90
2123379	2023-12-07 03:45:00	51	3	2.08	3.55	2.78	2.13	3.85	3.10	3	2	7	6	3	5	9	5	12	8	12	5	17	2	3	1	2	1	3	1	1	1	0.05	0.30	0.32
2294128	2024-10-31 01:00:00	51	3	1.78	3.75	3.45	1.81	3.90	3.65	3	1	2	2	3	4	5	4	6	1	2	0	6	2	3	1	2	1	3	1	1	1	0.03	0.15	0.20
2123381	2023-12-06 03:45:00	51	1	2.08	3.50	2.84	2.13	3.80	3.15	4	1	5	4	4	6	8	5	11	5	8	2	13	2	3	1	2	1	3	1	1	1	0.05	0.30	0.31
2123382	2023-12-07 01:00:00	51	3	1.10	8.60	11.00	1.10	8.90	13.00	4	8	6	5	8	5	9	16	11	9	2	7	18	3	1	2	1	3	2	0	1	1	0.00	0.30	2.00
2294133	2024-10-31 03:45:00	51	0	7.50	5.80	1.23	8.70	6.50	1.23	17	8	9	16	9	12	33	17	21	0	16	12	33	1	3	2	3	1	2	1	1	0	1.20	0.70	0.00
2133879	2024-02-01 03:45:00	51	0	2.03	3.50	2.91	2.16	3.70	3.15	1	2	9	9	2	5	10	4	14	6	12	2	16	2	3	1	2	1	3	1	1	1	0.13	0.20	0.24
2123384	2023-12-07 03:45:00	51	1	2.37	3.55	2.41	2.55	3.85	2.52	5	1	6	9	4	7	14	5	13	3	12	4	17	1	3	2	3	1	2	1	1	1	0.18	0.30	0.11
2133880	2024-02-07 03:45:00	51	3	1.64	4.25	4.90	1.67	4.20	4.65	2	5	9	3	5	7	5	10	16	13	8	2	18	3	2	1	1	2	3	1	-1	-1	0.03	-0.05	-0.25
2123386	2023-12-06 01:00:00	51	3	2.21	3.35	2.70	2.16	3.75	3.15	9	1	8	6	5	11	15	6	19	6	15	2	21	2	3	1	2	1	3	-1	1	1	-0.05	0.40	0.45
2176442	2024-04-04 02:45:00	51	3	1.16	6.60	9.00	1.17	7.50	16.00	6	7	2	4	10	5	10	17	7	7	0	10	17	2	1	3	2	3	1	1	1	1	0.01	0.90	7.00
2011011	2023-06-04 02:00:00	51	3	1.70	4.05	4.65	1.72	4.05	4.50	1	1	3	2	2	2	3	3	5	2	2	0	5	2	2	1	1	1	3	1	0	-1	0.02	0.00	-0.15
2109841	2023-11-01 03:45:00	51	3	1.56	4.25	4.90	1.57	4.20	4.90	0	5	4	1	4	5	1	9	9	14	6	6	15	3	1	1	1	2	2	1	-1	0	0.01	-0.05	0.00
2109842	2023-11-02 01:00:00	51	3	1.57	4.15	4.10	1.56	4.45	4.65	2	6	7	2	9	8	4	15	15	12	1	1	16	3	1	1	1	2	2	-1	1	1	-0.01	0.30	0.55
2109844	2023-11-02 01:00:00	51	0	1.54	3.80	4.80	1.52	4.20	5.40	2	3	4	2	4	4	4	7	8	4	1	0	8	3	2	1	1	2	3	-1	1	1	-0.02	0.40	0.60
2109845	2023-11-02 03:45:00	51	3	2.52	3.35	2.34	2.68	3.55	2.35	10	2	9	11	3	10	21	5	19	0	16	2	21	1	3	2	3	1	2	1	1	1	0.16	0.20	0.01
2109853	2023-11-01 01:00:00	51	3	1.74	3.65	3.70	1.71	3.90	4.15	3	3	4	2	5	6	5	8	10	6	3	1	11	3	2	1	1	2	3	-1	1	1	-0.03	0.25	0.45
2109855	2023-11-01 01:00:00	51	3	3.15	3.60	1.90	4.10	3.90	1.72	7	3	9	9	7	5	16	10	14	3	9	5	19	1	3	2	3	1	2	1	1	-1	0.95	0.30	-0.18
2125921	2024-01-04 04:00:00	52	3	1.38	4.30	6.20	1.44	4.40	7.90	12	10	16	11	12	17	23	22	33	14	15	4	37	2	3	1	2	1	3	1	1	1	0.06	0.10	1.70
2294117	2024-09-25 03:00:00	52	0	1.76	3.45	4.15	1.71	3.60	4.65	9	5	11	8	8	11	17	13	22	5	9	0	22	2	3	1	2	1	3	-1	1	1	-0.05	0.15	0.50
2108849	2023-11-01 04:00:00	52	3	1.73	3.70	4.35	1.68	3.75	4.60	8	2	4	2	4	10	10	6	14	4	8	0	14	2	3	1	2	1	3	-1	1	1	-0.05	0.05	0.25
2108851	2023-11-02 04:00:00	52	1	1.80	3.45	3.90	1.96	3.35	3.65	16	7	19	17	5	16	33	12	35	7	28	5	40	2	3	1	2	1	3	1	-1	-1	0.16	-0.10	-0.25
2108853	2023-11-03 04:00:00	52	1	1.67	3.60	4.95	1.70	3.60	4.65	3	6	11	5	7	9	8	13	20	16	11	4	24	3	2	1	1	2	3	1	0	-1	0.03	0.00	-0.30
2205684	2024-05-16 03:00:00	52	0	2.53	2.87	2.66	2.53	3.15	2.95	8	3	9	5	4	12	13	7	21	9	15	1	22	2	3	1	2	1	3	0	1	1	0.00	0.28	0.29
2306367	2024-12-19 01:30:00	52	3	1.22	6.10	11.00	1.23	6.20	13.00	8	7	4	8	8	6	16	15	10	8	9	14	24	1	2	3	3	2	1	1	1	1	0.01	0.10	2.00
2144320	2024-01-12 04:00:00	52	3	1.36	4.35	7.20	1.38	4.80	8.80	10	8	12	13	8	16	23	16	28	11	18	6	34	2	3	1	2	1	3	1	1	1	0.02	0.45	1.60
2306371	2024-12-19 04:00:00	52	3	1.32	5.10	8.20	1.26	5.60	12.00	10	3	3	6	8	9	16	11	12	4	9	8	20	1	3	2	3	1	2	-1	1	1	-0.06	0.50	3.80
2306370	2024-12-20 04:00:00	52	3	1.34	4.90	7.40	1.31	5.40	9.90	15	8	20	13	11	27	28	19	47	20	29	1	48	2	3	1	2	1	3	-1	1	1	-0.03	0.50	2.50
2306375	2024-12-06 04:00:00	52	3	2.31	3.20	3.30	2.42	3.15	3.10	0	2	3	2	2	2	2	4	5	6	4	3	8	3	2	1	1	2	3	1	-1	-1	0.11	-0.05	-0.20
2306374	2024-12-18 04:00:00	52	3	1.43	4.40	6.40	1.37	4.75	9.10	15	14	18	13	18	26	28	32	44	17	13	1	45	3	2	1	1	2	3	-1	1	1	-0.06	0.35	2.70
2306373	2024-12-05 04:00:00	52	1	1.39	4.15	6.30	1.46	4.40	7.20	4	2	5	6	3	7	10	5	12	2	7	0	12	2	3	1	2	1	3	1	1	1	0.07	0.25	0.90
2306372	2024-12-04 01:30:00	52	3	1.69	3.35	4.35	1.73	3.65	5.00	8	3	7	5	6	10	13	9	17	4	8	0	17	2	3	1	2	1	3	1	1	1	0.04	0.30	0.65
2155086	2024-04-24 03:00:00	52	3	2.79	3.10	2.51	2.92	3.15	2.56	12	0	11	14	1	9	26	1	20	0	25	6	26	1	3	2	3	1	2	1	1	1	0.13	0.05	0.05
2155087	2024-04-25 03:00:00	52	3	1.80	3.70	3.90	1.91	3.60	4.05	8	7	11	11	5	10	19	12	21	8	15	6	27	2	3	1	2	1	3	1	-1	1	0.11	-0.10	0.15
2142928	2024-01-10 04:00:00	52	1	2.12	3.10	3.25	2.21	3.10	3.60	3	3	8	5	2	10	8	5	18	10	13	0	18	2	3	1	2	1	3	1	0	1	0.09	0.00	0.35
2155088	2024-04-04 03:00:00	52	3	2.54	3.25	2.51	2.61	3.45	2.66	9	3	3	7	3	7	16	6	10	2	12	8	18	1	3	2	3	1	2	1	1	1	0.07	0.20	0.15
2142929	2024-01-11 01:00:00	52	3	2.77	2.93	2.52	2.93	3.05	2.61	11	4	5	8	3	8	19	7	13	1	13	7	20	1	3	2	3	1	2	1	1	1	0.16	0.12	0.09
2155089	2024-04-03 03:00:00	52	3	1.79	3.30	4.15	1.81	3.40	4.90	2	2	4	1	2	7	3	4	11	10	9	2	13	3	2	1	1	2	3	1	1	1	0.02	0.10	0.75
2142930	2024-01-11 04:00:00	52	0	2.14	3.30	3.05	2.23	3.45	3.20	0	2	3	3	2	4	3	4	7	6	5	2	9	3	2	1	1	2	3	1	1	1	0.09	0.15	0.15
2125914	2024-01-03 04:00:00	52	3	1.47	4.05	5.10	1.61	4.15	5.40	9	9	14	15	10	9	24	19	23	1	6	2	25	1	3	2	3	1	2	1	1	1	0.14	0.10	0.30
2125915	2024-01-04 01:00:00	52	3	1.49	4.05	5.10	1.45	4.90	6.40	7	10	9	6	12	11	13	22	20	12	3	5	25	3	1	2	1	3	2	-1	1	1	-0.04	0.85	1.30
2125916	2024-01-05 04:00:00	52	3	1.18	6.10	9.50	1.20	6.70	15.00	3	4	4	4	6	4	7	10	8	7	4	6	14	3	1	2	1	3	2	1	1	1	0.02	0.60	5.50
2125917	2023-12-06 04:00:00	52	3	1.80	3.30	4.10	1.72	3.55	5.40	6	6	10	3	9	17	9	15	27	21	15	3	30	3	2	1	1	2	3	-1	1	1	-0.08	0.25	1.30
2125919	2023-12-21 04:00:00	52	1	1.46	3.95	5.30	1.53	4.05	6.80	2	10	9	6	7	10	8	17	19	18	9	7	26	3	2	1	1	2	3	1	1	1	0.07	0.10	1.50
2333537	2025-01-04 03:00:00	53	0	2.38	3.10	2.66	2.44	3.15	3.10	1	3	3	1	2	4	2	5	7	7	4	2	9	3	2	1	1	2	3	1	1	1	0.06	0.05	0.44
2333536	2025-01-03 03:00:00	53	3	2.17	3.25	2.83	2.03	3.50	3.65	11	5	6	8	8	12	19	13	18	5	11	6	24	1	3	2	3	1	2	-1	1	1	-0.14	0.25	0.82
2139053	2024-01-19 03:00:00	53	3	2.49	3.25	2.69	2.47	3.35	2.90	2	0	4	2	2	3	4	2	7	5	7	2	9	2	3	1	2	1	3	-1	1	1	-0.02	0.10	0.21
2151197	2024-01-23 03:00:00	53	0	4.50	3.80	1.68	5.10	3.95	1.67	1	0	2	3	3	1	4	3	3	0	1	1	4	1	2	2	3	1	1	1	1	-1	0.60	0.15	-0.01
2139054	2024-01-20 03:00:00	53	3	1.68	3.65	4.70	1.66	3.75	5.50	3	3	5	0	4	10	3	7	15	14	10	2	17	3	2	1	1	2	3	-1	1	1	-0.02	0.10	0.80
2346364	2025-01-07 03:00:00	53	0	1.83	3.40	3.85	1.85	3.55	4.40	6	3	6	6	2	7	12	5	13	2	9	1	14	2	3	1	2	1	3	1	1	1	0.02	0.15	0.55
2348512	2025-01-13 03:00:00	54	0	2.38	3.70	2.32	2.49	3.85	2.57	9	2	13	9	5	11	18	7	24	8	19	2	26	2	3	1	2	1	3	1	1	1	0.11	0.15	0.25
2083848	2024-01-11 03:00:00	54	1	2.07	3.35	2.97	2.07	3.55	3.50	7	3	8	8	5	10	15	8	18	7	14	4	22	2	3	1	2	1	3	0	1	1	0.00	0.20	0.53
2133895	2024-01-12 03:00:00	54	3	1.37	4.40	6.20	1.45	4.70	7.00	6	9	15	13	8	13	19	17	28	11	13	2	30	2	3	1	2	1	3	1	1	1	0.08	0.30	0.80
2148039	2024-01-15 03:00:00	54	3	2.31	3.55	2.73	2.28	3.70	2.93	2	4	11	0	5	9	2	9	20	18	11	0	20	3	2	1	1	2	3	-1	1	1	-0.03	0.15	0.20
2312811	2025-01-10 03:00:00	54	3	1.32	4.70	7.70	1.34	5.20	9.10	9	4	10	8	10	19	17	14	29	12	15	0	29	2	3	1	2	1	3	1	1	1	0.02	0.50	1.40
2312812	2025-01-09 03:00:00	54	0	3.70	3.65	1.80	3.70	3.65	1.87	10	8	7	6	6	10	16	14	17	8	10	7	24	2	3	1	2	1	3	0	0	1	0.00	0.00	0.07
2019071	2023-05-31 05:00:00	55	0	2.73	2.98	2.51	2.76	3.05	2.45	17	9	16	17	9	18	34	18	34	1	17	1	35	1	3	1	2	1	2	1	1	-1	0.03	0.07	-0.06
2019116	2023-06-01 05:00:00	55	0	2.05	3.20	3.15	2.06	3.30	3.20	1	3	7	3	3	5	4	6	12	10	8	2	14	3	2	1	1	2	3	1	1	1	0.01	0.10	0.05
2021482	2023-06-09 05:00:00	55	3	1.60	3.70	4.45	1.52	3.85	4.90	6	5	7	3	6	9	9	11	16	11	9	4	20	3	2	1	1	2	3	-1	1	1	-0.08	0.15	0.45
2022283	2023-06-12 05:00:00	55	3	2.68	3.10	2.36	2.94	3.00	2.33	4	6	1	9	3	1	13	9	2	0	4	11	13	1	2	3	3	2	1	1	-1	-1	0.26	-0.10	-0.03
2019112	2023-05-31 01:30:00	55	3	1.26	4.95	8.00	1.28	5.10	9.20	19	8	15	9	16	21	28	24	36	10	14	2	38	2	3	1	2	1	3	1	1	1	0.02	0.15	1.20
2019113	2023-06-01 01:30:00	55	3	1.12	7.60	9.80	1.12	7.60	13.00	8	16	12	11	9	13	19	25	25	14	8	8	33	3	1	1	1	2	2	0	0	1	0.00	0.00	3.20
2020201	2023-06-04 01:30:00	55	1	9.60	6.20	1.18	8.20	5.80	1.21	17	15	12	17	15	13	34	30	25	0	4	9	34	1	2	3	3	2	1	-1	-1	1	-1.40	-0.40	0.03
2020185	2023-06-04 05:00:00	55	0	2.37	3.30	2.53	2.35	3.25	2.58	8	1	10	11	0	9	19	1	19	0	18	0	19	1	3	1	2	1	2	-1	-1	1	-0.02	-0.05	0.05
2021481	2023-06-09 01:30:00	55	3	1.88	3.20	3.60	1.80	3.30	3.80	11	6	7	6	7	12	17	13	19	4	8	2	21	2	3	1	2	1	3	-1	1	1	-0.08	0.10	0.20
2022281	2023-06-12 01:30:00	55	3	2.56	3.40	2.31	2.67	3.50	2.28	6	2	1	6	5	1	12	7	2	0	5	10	12	1	2	3	3	2	1	1	1	-1	0.11	0.10	-0.03
2020372	2023-06-05 05:00:00	55	0	2.45	3.20	2.50	2.26	3.25	2.69	16	1	12	10	2	17	26	3	29	4	27	1	30	2	3	1	2	1	3	-1	1	1	-0.19	0.05	0.19
2020369	2023-06-05 01:30:00	55	1	3.10	3.20	2.07	3.15	3.25	2.02	11	6	7	7	8	11	18	14	18	3	7	3	21	1	3	1	2	1	2	1	1	-1	0.05	0.05	-0.05
2193444	2024-09-06 22:00:00	56	1	6.10	4.35	1.37	8.20	4.75	1.39	5	4	9	10	8	6	15	12	15	5	8	5	20	1	3	1	2	1	2	1	1	1	2.10	0.40	0.02
2193446	2024-09-07 02:45:00	56	0	1.65	3.80	4.80	1.59	3.95	6.00	4	3	2	1	6	6	5	9	8	9	5	6	14	3	1	2	1	3	2	-1	1	1	-0.06	0.15	1.20
2193449	2024-09-07 02:45:00	56	3	2.07	3.40	3.65	2.14	3.35	3.50	5	3	9	8	3	7	13	6	16	3	10	0	16	2	3	1	2	1	3	1	-1	-1	0.07	-0.05	-0.15
2193448	2024-09-07 02:45:00	56	1	3.05	3.20	2.09	3.85	3.40	2.01	7	3	9	10	3	8	17	6	17	4	15	4	21	1	3	1	2	1	2	1	1	-1	0.80	0.20	-0.08
2193450	2024-09-07 02:45:00	56	1	2.34	3.15	2.66	2.84	3.30	2.53	18	4	34	33	6	17	51	10	51	4	45	4	55	1	3	1	2	1	2	1	1	-1	0.50	0.15	-0.13
2193437	2024-09-06 02:45:00	56	3	1.51	4.15	6.80	1.54	4.15	6.30	1	5	5	4	6	4	5	11	9	8	2	4	13	3	1	2	1	3	2	1	0	-1	0.03	0.00	-0.50
2193436	2024-09-06 02:45:00	56	3	2.31	3.25	3.25	2.38	3.20	3.15	0	2	2	1	2	2	1	4	4	3	0	0	4	3	1	1	1	2	2	1	-1	-1	0.07	-0.05	-0.10
2193439	2024-09-06 02:45:00	56	1	6.50	3.95	1.49	7.00	4.20	1.50	13	4	4	10	8	4	23	12	8	2	13	17	25	1	2	3	3	2	1	1	1	1	0.50	0.25	0.01
2193438	2024-09-06 02:45:00	56	0	2.38	3.10	3.25	2.51	3.10	3.00	0	3	5	2	4	3	2	7	8	11	6	5	13	3	2	1	1	2	3	1	0	-1	0.13	0.00	-0.25
2193518	2024-09-08 00:00:00	56	3	2.76	3.30	2.21	3.00	3.40	2.35	5	3	0	2	2	4	7	5	4	1	3	4	8	1	2	3	3	2	1	1	1	1	0.24	0.10	0.14
2193521	2024-09-08 00:00:00	56	0	5.60	4.00	1.46	7.20	4.20	1.49	4	1	2	4	4	3	8	5	5	0	3	3	8	1	2	2	3	1	1	1	1	1	1.60	0.20	0.03
2193525	2024-09-08 02:45:00	56	3	1.17	6.90	12.00	1.18	7.20	16.00	2	4	2	3	6	3	5	10	5	8	3	8	13	2	1	2	1	3	1	1	1	1	0.01	0.30	4.00
2193524	2024-09-08 02:45:00	56	3	1.32	5.10	8.20	1.25	6.10	12.00	11	7	10	7	13	13	18	20	23	16	14	11	34	3	2	1	1	2	3	-1	1	1	-0.07	1.00	3.80
2193526	2024-09-08 02:45:00	56	3	1.76	3.25	4.15	1.62	3.85	5.80	8	12	12	2	18	15	10	30	27	32	12	15	42	3	1	2	1	3	2	-1	1	1	-0.14	0.60	1.65
2193529	2024-09-09 00:00:00	56	3	1.78	3.50	4.25	1.78	3.60	4.75	3	1	3	2	2	4	5	3	7	3	5	1	8	2	3	1	2	1	3	0	1	1	0.00	0.10	0.50
2193569	2024-10-14 00:00:00	56	0	7.90	5.00	1.30	10.00	5.60	1.30	6	5	9	10	8	7	16	13	16	5	8	5	21	1	3	1	2	1	2	1	1	0	2.10	0.60	0.00
2193571	2024-10-12 02:45:00	56	1	5.20	4.00	1.65	4.85	3.85	1.71	5	4	2	6	5	2	11	9	4	2	4	9	13	1	2	3	3	2	1	-1	-1	1	-0.35	-0.15	0.06
2193570	2024-10-13 02:45:00	56	0	5.80	3.95	1.44	5.60	3.85	1.63	7	4	6	6	8	9	13	12	15	4	5	2	17	2	3	1	2	1	3	-1	-1	1	-0.20	-0.10	0.19
2193572	2024-10-16 02:45:00	56	3	1.80	3.20	4.00	1.93	3.20	4.60	6	5	7	9	5	7	15	10	14	1	6	2	16	1	3	2	3	1	2	1	0	1	0.13	0.00	0.60
2193577	2024-10-12 02:45:00	56	0	8.10	5.30	1.27	11.00	5.90	1.27	4	4	9	10	11	5	14	15	14	6	5	6	20	2	1	2	1	3	1	1	1	0	2.90	0.60	0.00
2193576	2024-11-15 03:45:00	56	0	2.68	3.05	2.38	3.00	3.25	2.42	13	4	7	15	5	6	28	9	13	1	20	16	29	1	3	2	3	1	2	1	1	1	0.32	0.20	0.04
2193578	2024-10-13 21:00:00	56	0	4.35	3.45	1.72	5.40	3.65	1.70	2	1	3	7	2	1	9	3	4	0	6	5	9	1	3	2	3	1	2	1	1	-1	1.05	0.20	-0.02
2193581	2024-10-13 02:45:00	56	0	4.50	3.75	1.64	5.40	4.05	1.62	3	1	2	3	5	2	6	6	4	1	1	3	7	1	1	3	2	2	1	1	1	-1	0.90	0.30	-0.02
2193580	2024-10-12 02:45:00	56	3	1.68	3.80	5.20	1.62	3.75	6.00	3	2	2	1	3	8	4	5	10	7	6	1	11	3	2	1	1	2	3	-1	-1	1	-0.06	-0.05	0.80
2193582	2024-10-15 00:00:00	56	0	4.10	3.30	1.75	5.70	3.75	1.65	4	4	6	9	9	3	13	13	9	3	3	7	16	1	1	3	2	2	1	1	1	-1	1.60	0.45	-0.10
2193584	2024-11-15 03:45:00	56	0	4.15	3.25	1.88	3.90	3.35	2.01	20	9	19	17	11	24	37	20	43	16	33	10	53	2	3	1	2	1	3	-1	1	1	-0.25	0.10	0.13
2193587	2024-10-15 00:00:00	56	0	1.97	3.25	3.55	1.98	3.35	4.05	8	1	4	5	3	9	13	4	13	2	11	2	15	1	3	1	2	1	2	1	1	1	0.01	0.10	0.50
2193586	2024-10-16 02:45:00	56	1	5.00	4.00	1.54	5.80	4.25	1.56	7	3	7	11	6	7	18	9	14	1	10	5	19	1	3	2	3	1	2	1	1	1	0.80	0.25	0.02
2193589	2024-10-11 02:45:00	56	3	1.62	3.95	5.60	1.64	3.95	5.30	2	3	3	2	3	4	4	6	7	5	3	2	9	3	2	1	1	2	3	1	0	-1	0.02	0.00	-0.30
2193588	2024-10-14 02:45:00	56	3	2.05	3.45	3.10	2.05	3.50	3.60	10	5	8	12	4	11	22	9	19	6	19	9	28	1	3	2	3	1	2	0	1	1	0.00	0.05	0.50
2193591	2024-10-16 02:45:00	56	3	1.34	4.45	7.40	1.40	4.70	7.90	10	6	12	10	9	16	20	15	28	8	13	0	28	2	3	1	2	1	3	1	1	1	0.06	0.25	0.50
2193590	2024-10-13 02:45:00	56	3	2.42	3.05	2.78	2.85	3.15	2.63	8	1	12	15	2	9	23	3	21	0	20	2	23	1	3	2	3	1	2	1	1	-1	0.43	0.10	-0.15
2193593	2024-10-16 02:45:00	56	1	2.92	3.25	2.23	3.05	3.30	2.38	8	3	3	5	5	5	13	8	8	1	6	6	14	1	2	2	3	1	1	1	1	1	0.13	0.05	0.15
2193592	2024-10-15 02:45:00	56	0	2.71	3.20	2.38	3.00	3.35	2.38	5	2	3	6	2	1	11	4	4	1	8	8	12	1	2	2	3	1	1	1	1	0	0.29	0.15	0.00
2193595	2024-10-11 02:45:00	56	1	1.96	3.40	3.35	2.01	3.40	3.85	2	3	7	5	4	4	7	7	11	7	7	3	14	2	2	1	1	1	3	1	0	1	0.05	0.00	0.50
2193594	2024-10-15 02:45:00	56	3	1.59	3.55	5.30	1.56	3.85	6.80	5	2	3	2	6	7	7	8	10	6	5	3	13	3	2	1	1	2	3	-1	1	1	-0.03	0.30	1.50
2193596	2024-09-11 02:45:00	56	0	2.28	3.20	2.70	2.42	3.15	3.15	0	3	3	1	1	5	1	4	8	8	5	1	9	3	2	1	1	2	3	1	-1	1	0.14	-0.05	0.45
2193599	2024-09-10 02:45:00	56	3	1.33	4.30	7.50	1.37	4.65	9.50	8	4	14	10	7	12	18	11	26	11	18	3	29	2	3	1	2	1	3	1	1	1	0.04	0.35	2.00
2193539	2024-10-15 02:45:00	56	3	1.77	3.70	3.75	1.84	4.05	3.85	5	5	13	11	6	7	16	11	20	4	9	0	20	2	3	1	2	1	3	1	1	1	0.07	0.35	0.10
2193540	2024-10-15 02:45:00	56	0	7.90	5.30	1.24	14.00	6.40	1.21	6	4	10	10	11	6	16	15	16	5	6	5	21	1	3	1	2	1	2	1	1	-1	6.10	1.10	-0.03
2193543	2024-10-12 02:45:00	56	1	2.75	3.20	2.37	3.00	3.20	2.47	4	0	6	8	1	5	12	1	11	0	11	1	12	1	3	2	3	1	2	1	0	1	0.25	0.00	0.10
2193542	2024-09-11 02:45:00	56	3	1.13	7.60	9.70	1.12	8.70	22.00	8	11	10	5	19	16	13	30	26	24	7	11	37	3	1	2	1	3	2	-1	1	1	-0.01	1.10	12.30
1960885	2023-06-15 02:45:00	56	1	1.98	3.35	3.60	1.99	3.30	4.10	17	5	9	14	4	12	31	9	21	4	26	14	35	1	3	2	3	1	2	1	-1	1	0.01	-0.05	0.50
2193545	2024-10-15 02:45:00	56	0	3.75	3.50	1.82	4.20	3.60	1.87	5	1	4	6	2	3	11	3	7	1	9	5	12	1	3	2	3	1	2	1	1	1	0.45	0.10	0.05
2193544	2024-10-14 00:00:00	56	0	2.35	3.10	2.70	2.38	3.30	3.05	3	2	6	6	3	4	9	5	10	4	8	3	13	2	3	1	2	1	3	1	1	1	0.03	0.20	0.35
1960886	2023-06-16 02:45:00	56	3	2.26	3.20	3.40	2.25	3.20	3.40	3	0	1	1	0	2	4	0	3	0	4	1	4	1	3	2	3	1	2	-1	0	0	-0.01	0.00	0.00
2193546	2024-10-12 02:45:00	56	1	2.28	3.15	2.75	2.55	3.20	2.65	6	6	11	18	4	10	24	10	21	1	15	4	25	1	3	2	3	1	2	1	1	-1	0.27	0.05	-0.10
2193549	2024-09-10 02:45:00	56	3	1.54	3.95	4.55	1.54	4.25	6.10	9	4	5	6	7	12	15	11	17	5	9	3	20	2	3	1	2	1	3	0	1	1	0.00	0.30	1.55
2193551	2024-09-09 02:45:00	56	3	1.17	6.30	14.00	1.24	6.00	13.00	5	6	4	8	5	3	13	11	7	3	5	9	16	1	2	3	3	2	1	1	-1	-1	0.07	-0.30	-1.00
2193550	2024-10-16 02:45:00	56	3	1.29	4.85	7.60	1.36	4.95	8.80	6	8	10	10	7	6	16	15	16	1	2	1	17	1	3	1	2	1	2	1	1	1	0.07	0.10	1.20
2193553	2024-11-15 03:45:00	56	0	2.56	3.15	2.42	2.63	3.30	2.73	7	4	15	12	5	14	19	9	29	12	22	2	31	2	3	1	2	1	3	1	1	1	0.07	0.15	0.31
2193552	2024-09-09 02:45:00	56	3	1.78	3.55	4.25	1.68	3.85	5.10	11	7	14	6	11	17	17	18	31	15	14	1	32	3	2	1	1	2	3	-1	1	1	-0.10	0.30	0.85
2193555	2024-10-15 02:45:00	56	0	3.15	3.25	2.11	3.40	3.35	2.20	4	2	1	4	2	5	8	4	6	4	8	6	12	1	3	2	3	1	2	1	1	1	0.25	0.10	0.09
2024106	2023-06-18 21:00:00	56	0	2.28	3.45	2.69	2.28	3.45	2.69	0	0	1	1	0	0	1	0	1	0	1	0	1	1	3	1	2	1	2	0	0	0	0.00	0.00	0.00
2193557	2024-09-10 02:45:00	56	3	2.28	3.45	2.57	2.36	3.55	2.92	2	2	7	2	3	4	4	5	11	9	8	2	13	3	2	1	1	2	3	1	1	1	0.08	0.10	0.35
2024107	2023-06-19 02:45:00	56	1	3.30	3.20	2.07	3.70	3.40	2.07	2	1	1	3	3	2	5	4	3	4	5	6	9	1	2	3	3	2	1	1	1	0	0.40	0.20	0.00
2193558	2024-09-10 02:45:00	56	3	1.82	3.60	3.95	1.86	3.70	4.10	16	9	18	15	9	18	31	18	36	12	25	7	43	2	3	1	2	1	3	1	1	1	0.04	0.10	0.15
2193562	2024-09-11 02:45:00	56	0	2.70	2.97	2.43	2.83	3.00	2.74	15	6	11	15	5	20	30	11	31	6	25	5	36	2	3	1	2	1	3	1	1	1	0.13	0.03	0.31
2193565	2024-09-11 02:45:00	56	1	1.73	3.55	4.50	1.64	3.85	5.50	9	3	4	4	6	9	13	9	13	2	6	2	15	1	3	1	2	1	2	-1	1	1	-0.09	0.30	1.00
2193564	2024-10-11 02:45:00	56	0	1.28	4.85	8.70	1.31	5.10	11.00	6	6	6	9	7	6	15	13	12	4	6	7	19	1	2	3	3	2	1	1	1	1	0.03	0.25	2.30
2193566	2024-10-13 00:00:00	56	1	1.69	3.35	4.40	1.69	3.50	5.80	4	3	3	2	5	5	6	8	8	3	1	1	9	3	1	1	1	2	2	0	1	1	0.00	0.15	1.40
2193633	2024-11-17 03:45:00	56	1	2.85	3.05	2.26	3.25	3.25	2.29	5	3	2	5	2	2	10	5	4	1	6	7	11	1	2	3	3	2	1	1	1	1	0.40	0.20	0.03
2193635	2024-11-17 03:45:00	56	3	1.67	3.70	4.05	1.70	3.85	4.90	12	13	10	9	11	20	21	24	30	11	8	2	32	3	2	1	1	2	3	1	1	1	0.03	0.15	0.85
2193634	2024-11-20 03:45:00	56	3	6.40	4.40	1.50	6.60	4.35	1.49	5	4	2	8	4	2	13	8	4	0	5	9	13	1	2	3	3	2	1	1	-1	-1	0.20	-0.05	-0.01
2193636	2024-11-17 22:00:00	56	0	2.94	3.05	2.21	3.60	3.30	2.12	2	1	2	4	2	0	6	3	2	0	3	4	6	1	2	3	3	2	1	1	1	-1	0.66	0.25	-0.09
2193639	2024-11-20 03:45:00	56	1	6.20	4.45	1.51	6.90	4.60	1.45	6	4	5	8	5	4	14	9	9	2	7	7	16	1	2	2	3	1	1	1	1	-1	0.70	0.15	-0.06
2193638	2024-11-20 03:45:00	56	3	1.63	3.70	6.00	1.69	3.75	5.20	1	5	10	3	7	6	4	12	16	17	9	5	21	3	2	1	1	2	3	1	1	-1	0.06	0.05	-0.80
2193641	2024-11-16 03:45:00	56	1	1.86	3.50	4.40	1.80	3.60	4.65	10	2	7	6	5	10	16	7	17	3	12	2	19	2	3	1	2	1	3	-1	1	1	-0.06	0.10	0.25
2193642	2024-11-17 01:00:00	56	0	2.38	3.05	2.69	2.36	3.30	3.10	2	2	2	1	2	5	3	4	7	4	3	0	7	3	2	1	1	2	3	-1	1	1	-0.02	0.25	0.41
2193645	2024-11-18 01:00:00	56	0	3.40	2.97	2.04	4.05	3.25	2.03	14	7	17	16	10	16	30	17	33	7	20	4	37	2	3	1	2	1	3	1	1	-1	0.65	0.28	-0.01
2193647	2024-11-17 03:45:00	56	3	1.09	9.10	11.00	1.11	9.40	22.00	4	13	11	6	8	9	10	21	20	17	6	7	27	3	1	2	1	3	2	1	1	1	0.02	0.30	11.00
2193646	2024-11-19 03:45:00	56	0	2.17	3.35	2.77	2.33	3.40	3.05	1	5	10	5	4	9	6	9	19	14	11	1	20	3	2	1	1	2	3	1	1	1	0.16	0.05	0.28
2193649	2024-11-18 03:45:00	56	0	2.57	3.20	2.39	2.75	3.05	2.79	16	8	10	12	4	18	28	12	28	6	22	6	34	1	3	1	2	1	2	1	-1	1	0.18	-0.15	0.40
2193648	2024-11-16 03:45:00	56	0	2.68	2.80	2.57	2.97	2.91	2.70	13	13	19	21	12	17	34	25	36	7	16	5	41	2	3	1	2	1	3	1	1	1	0.29	0.11	0.13
2193650	2024-11-19 03:45:00	56	1	3.25	3.15	2.01	4.20	3.15	2.02	9	8	13	17	5	12	26	13	25	7	20	8	33	1	3	2	3	1	2	1	0	1	0.95	0.00	0.01
2193653	2024-11-16 03:45:00	56	0	3.55	3.20	1.90	4.00	3.30	2.01	15	4	15	12	4	19	27	8	34	9	28	2	36	2	3	1	2	1	3	1	1	1	0.45	0.10	0.11
2193652	2024-11-18 01:00:00	56	1	1.39	4.25	6.20	1.43	4.60	7.60	7	3	6	7	7	11	14	10	17	6	10	3	20	2	3	1	2	1	3	1	1	1	0.04	0.35	1.40
2193655	2024-11-18 01:00:00	56	3	1.08	9.00	12.00	1.10	10.00	24.00	3	4	4	3	9	5	6	13	9	9	2	6	15	3	1	2	1	3	2	1	1	1	0.02	1.00	12.00
2193654	2024-11-17 22:00:00	56	3	1.53	3.55	5.60	1.52	4.05	6.90	2	2	2	2	3	3	4	5	5	2	1	1	6	3	1	1	1	2	2	-1	1	1	-0.01	0.50	1.30
2193659	2024-11-16 22:00:00	56	1	1.62	3.50	4.50	1.67	3.75	5.30	4	3	3	4	4	5	8	7	8	0	1	0	8	1	3	1	2	1	2	1	1	1	0.05	0.25	0.80
2193658	2024-11-16 03:45:00	56	3	1.21	5.80	8.50	1.26	5.90	12.00	6	6	5	7	6	7	13	12	12	6	7	7	19	1	2	2	3	1	1	1	1	1	0.05	0.10	3.50
2193661	2024-11-19 03:45:00	56	3	1.24	5.30	8.20	1.32	5.30	9.60	7	11	9	11	10	12	18	21	21	12	9	9	30	3	1	1	1	2	2	1	0	1	0.08	0.00	1.40
2193660	2024-11-16 03:45:00	56	3	3.45	3.40	2.14	3.40	3.40	2.17	1	0	1	2	1	1	3	1	2	0	2	1	3	1	3	2	3	1	2	-1	0	1	-0.05	0.00	0.03
2193662	2024-11-20 03:45:00	56	3	1.17	5.80	11.00	1.17	7.60	17.00	14	12	13	13	18	15	27	30	28	16	13	15	43	3	1	2	1	3	2	0	1	1	0.00	1.80	6.00
2193601	2024-09-10 02:45:00	56	0	2.81	3.15	2.23	3.25	3.15	2.36	8	5	3	8	5	3	16	10	6	1	7	11	17	1	2	3	3	2	1	1	0	1	0.44	0.00	0.13
2193604	2024-10-13 00:00:00	56	3	1.54	3.90	5.20	1.57	4.00	6.10	4	4	7	6	6	6	10	10	13	4	4	1	14	2	2	1	1	1	3	1	1	1	0.03	0.10	0.90
2193609	2024-09-11 02:45:00	56	1	2.51	3.60	2.48	2.56	3.70	2.57	13	2	13	12	3	15	25	5	28	5	25	2	30	2	3	1	2	1	3	1	1	1	0.05	0.10	0.09
2193611	2024-10-14 02:45:00	56	3	1.77	3.20	4.50	1.84	3.30	4.90	11	5	12	8	6	11	19	11	23	7	15	3	26	2	3	1	2	1	3	1	1	1	0.07	0.10	0.40
2193613	2024-10-12 02:45:00	56	3	1.28	5.20	8.00	1.32	5.30	9.30	4	7	8	8	6	7	12	13	15	8	7	5	20	3	2	1	1	2	3	1	1	1	0.04	0.10	1.30
2193614	2024-10-13 02:45:00	56	3	1.37	4.50	6.80	1.45	4.40	7.40	7	9	10	9	7	7	16	16	17	4	4	3	20	2	2	1	1	1	3	1	-1	1	0.08	-0.10	0.60
2193617	2024-09-11 02:45:00	56	3	1.91	3.40	3.30	2.01	3.40	3.85	5	4	4	4	4	6	9	8	10	6	7	5	15	2	3	1	2	1	3	1	0	1	0.10	0.00	0.55
2193616	2024-10-16 02:45:00	56	1	2.33	3.05	2.91	2.26	3.10	3.50	2	1	4	2	2	7	4	3	11	8	9	1	12	2	3	1	2	1	3	-1	1	1	-0.07	0.05	0.59
2193618	2024-09-09 02:45:00	56	0	4.10	3.50	1.82	4.70	3.60	1.78	13	5	13	18	7	7	31	12	20	5	24	16	36	1	3	2	3	1	2	1	1	-1	0.60	0.10	-0.04
2193620	2024-11-20 03:45:00	56	3	1.81	3.45	3.60	1.93	3.45	4.15	13	3	7	7	3	17	20	6	24	7	21	3	27	2	3	1	2	1	3	1	0	1	0.12	0.00	0.55
2193623	2024-11-17 01:00:00	56	1	1.80	3.40	3.70	1.85	3.60	4.35	6	6	6	7	4	6	13	10	12	4	7	5	17	1	3	2	3	1	2	1	1	1	0.05	0.20	0.65
2193622	2024-11-17 03:45:00	56	3	1.33	4.75	6.40	1.39	5.10	7.80	3	2	10	7	2	8	10	4	18	10	16	2	20	2	3	1	2	1	3	1	1	1	0.06	0.35	1.40
2193624	2024-11-19 03:45:00	56	1	2.47	3.35	2.40	2.67	3.30	2.69	17	6	5	17	6	8	34	12	13	0	22	21	34	1	3	2	3	1	2	1	-1	1	0.20	-0.05	0.29
2193627	2024-11-19 03:45:00	56	3	1.45	4.20	5.20	1.41	4.85	7.60	7	8	7	6	11	14	13	19	21	12	6	4	25	3	2	1	1	2	3	-1	1	1	-0.04	0.65	2.40
2193626	2024-11-19 03:45:00	56	1	2.44	3.15	2.54	2.56	3.25	2.86	2	0	7	5	1	6	7	1	13	6	12	0	13	2	3	1	2	1	3	1	1	1	0.12	0.10	0.32
2193629	2024-11-18 01:00:00	56	3	1.20	5.80	8.80	1.22	6.30	14.00	6	5	7	5	8	9	11	13	16	10	8	5	21	3	2	1	1	2	3	1	1	1	0.02	0.50	5.20
2193628	2024-11-15 03:45:00	56	3	1.67	3.45	5.20	1.80	3.45	4.85	5	9	11	8	8	11	13	17	22	13	9	4	26	3	2	1	1	2	3	1	0	-1	0.13	0.00	-0.35
2193631	2024-11-20 03:45:00	56	3	1.21	5.20	9.60	1.22	6.10	15.00	15	17	11	15	20	15	30	37	26	14	7	18	44	2	1	3	2	3	1	1	1	1	0.01	0.90	5.40
2128993	2024-04-19 23:30:00	63	0	5.80	3.60	1.49	5.80	3.70	1.48	3	1	2	2	4	1	5	5	3	2	2	4	7	1	1	3	2	2	1	0	1	-1	0.00	0.10	-0.01
2128995	2024-04-22 21:00:00	63	0	2.47	3.15	2.52	2.65	3.10	2.39	7	1	9	9	0	9	16	1	18	3	18	1	19	2	3	1	2	1	3	1	-1	-1	0.18	-0.05	-0.13
2128996	2024-04-19 23:30:00	63	0	7.60	4.25	1.33	7.10	4.10	1.36	6	6	3	6	5	6	12	11	9	1	2	4	13	1	2	3	3	2	1	-1	-1	1	-0.50	-0.15	0.03
2128997	2024-04-17 21:00:00	63	3	1.21	5.20	10.00	1.17	5.60	12.00	6	2	2	2	5	4	8	7	6	3	4	5	11	1	2	3	3	2	1	-1	1	1	-0.04	0.40	2.00
2128999	2024-04-17 23:30:00	63	3	2.43	2.93	2.73	2.49	2.83	2.74	34	17	32	28	14	33	62	31	65	8	39	5	70	2	3	1	2	1	3	1	-1	1	0.06	-0.10	0.01
2206323	2024-05-02 23:30:00	63	1	2.03	3.25	3.10	2.08	3.35	2.94	14	10	28	16	14	20	30	24	48	23	29	5	53	2	3	1	2	1	3	1	1	-1	0.05	0.10	-0.16
2206322	2024-05-03 23:30:00	63	3	2.33	2.87	2.92	2.26	2.98	2.92	11	16	20	4	21	19	15	37	39	28	6	4	43	3	2	1	1	2	3	-1	1	0	-0.07	0.11	0.00
2204923	2024-04-25 22:00:00	63	1	4.70	3.50	1.61	4.30	3.35	1.70	21	20	13	17	13	18	38	33	31	2	7	9	40	1	2	3	3	2	1	-1	-1	1	-0.40	-0.15	0.09
2204924	2024-04-26 01:30:00	63	1	1.48	4.10	4.85	1.53	4.00	4.65	48	42	50	50	41	54	98	83	104	14	29	8	112	2	3	1	2	1	3	1	-1	-1	0.05	-0.10	-0.20
2204941	2024-04-26 22:00:00	63	3	2.48	3.00	2.61	2.50	3.10	2.52	38	12	40	40	14	42	78	26	82	6	58	2	84	2	3	1	2	1	3	1	1	-1	0.02	0.10	-0.09
2204940	2024-04-27 01:30:00	63	3	1.64	3.50	4.40	1.55	3.65	5.00	15	20	21	17	19	23	32	39	44	12	5	0	44	3	2	1	1	2	3	-1	1	1	-0.09	0.15	0.60
2128976	2024-04-15 21:00:00	63	1	1.80	3.30	3.85	1.61	3.35	4.95	5	1	2	2	2	7	7	3	9	2	6	0	9	2	3	1	2	1	3	-1	1	1	-0.19	0.05	1.10
2128977	2024-04-19 21:00:00	63	0	12.00	5.00	1.20	9.60	4.65	1.26	20	13	8	13	9	13	33	22	21	0	11	12	33	1	2	3	3	2	1	-1	-1	1	-2.40	-0.35	0.06
2128978	2024-04-18 21:00:00	63	3	7.70	4.65	1.29	6.20	4.30	1.37	2	2	0	0	0	3	2	2	3	2	2	1	4	2	2	1	1	1	3	-1	-1	1	-1.50	-0.35	0.08
2128979	2024-04-16 23:30:00	63	0	1.61	3.50	4.50	1.50	3.70	5.50	20	10	15	12	11	22	32	21	37	5	16	0	37	2	3	1	2	1	3	-1	1	1	-0.11	0.20	1.00
2128980	2024-04-16 21:00:00	63	3	1.18	6.10	9.50	1.19	6.00	9.20	10	11	13	10	11	14	20	22	27	8	6	1	28	3	2	1	1	2	3	1	-1	-1	0.01	-0.10	-0.30
2128981	2024-04-22 21:00:00	63	0	2.01	3.15	3.20	2.05	3.15	3.20	3	2	3	4	2	3	7	4	6	2	5	3	9	1	3	2	3	1	2	1	0	0	0.04	0.00	0.00
2206230	2024-04-29 22:00:00	63	0	3.70	3.35	1.82	4.25	3.50	1.67	25	13	23	29	13	21	54	26	44	3	31	13	57	1	3	2	3	1	2	1	1	-1	0.55	0.15	-0.15
2128985	2024-04-20 23:30:00	63	0	12.00	5.70	1.15	13.00	5.70	1.15	6	5	8	7	10	6	13	15	14	4	2	3	17	3	1	2	1	3	2	1	0	0	1.00	0.00	0.00
2206232	2024-04-30 01:30:00	63	3	1.67	3.35	4.55	1.64	3.40	4.65	29	14	25	21	19	32	50	33	57	10	27	3	60	2	3	1	2	1	3	-1	1	1	-0.03	0.05	0.10
2128986	2024-04-20 21:00:00	63	0	3.35	2.98	2.06	3.65	3.10	1.90	22	11	17	16	10	21	38	21	38	4	21	4	42	1	3	1	2	1	2	1	1	-1	0.30	0.12	-0.16
2128987	2024-04-21 23:30:00	63	1	3.70	3.50	1.77	4.80	3.70	1.57	31	22	18	19	12	32	50	34	50	1	17	1	51	1	3	1	2	1	2	1	1	-1	1.10	0.20	-0.20
2128988	2024-04-15 23:30:00	63	3	1.40	4.10	6.40	1.37	4.15	6.50	18	17	21	21	19	18	39	36	39	0	3	0	39	1	3	1	2	1	2	-1	1	1	-0.03	0.05	0.10
2128990	2024-04-17 02:00:00	63	3	1.24	5.20	7.80	1.26	5.00	7.80	9	10	14	10	9	14	19	19	28	9	9	0	28	2	2	1	1	1	3	1	-1	0	0.02	-0.20	0.00
2128991	2024-04-16 23:30:00	63	3	1.32	4.40	7.30	1.31	4.35	8.20	19	18	22	21	17	20	40	35	42	4	9	2	44	2	3	1	2	1	3	-1	-1	1	-0.01	-0.05	0.90
2173201	2024-03-01 04:45:00	65	3	1.99	3.45	3.05	2.00	3.65	3.25	5	4	12	9	5	9	14	9	21	10	15	3	24	2	3	1	2	1	3	1	1	1	0.01	0.20	0.20
2329794	2024-11-24 04:45:00	65	3	1.11	8.10	12.00	1.10	8.20	14.00	1	3	2	0	3	2	1	6	4	5	0	2	6	3	1	2	1	3	2	-1	1	1	-0.01	0.10	2.00
2329696	2024-11-23 23:00:00	65	0	1.66	3.35	4.50	1.92	3.20	3.50	2	5	9	7	2	3	9	7	12	4	6	1	13	2	3	1	2	1	3	1	-1	-1	0.26	-0.15	-1.00
2329798	2024-11-25 01:00:00	65	3	5.40	3.85	1.49	7.00	4.10	1.41	1	1	5	5	5	1	6	6	6	1	1	1	7	1	1	1	1	1	1	1	1	-1	1.60	0.25	-0.08
2337531	2024-12-19 04:45:00	65	1	1.24	5.30	8.00	1.31	4.65	8.40	10	15	18	12	11	18	22	26	36	16	12	2	38	3	2	1	1	2	3	1	-1	1	0.07	-0.65	0.40
2178218	2024-04-03 03:45:00	65	1	2.35	3.25	2.58	2.41	3.35	2.74	12	2	7	9	4	16	21	6	23	2	17	0	23	2	3	1	2	1	3	1	1	1	0.06	0.10	0.16
2329800	2024-11-25 00:00:00	65	0	2.39	2.83	2.88	2.44	2.85	2.94	0	0	0	2	1	2	2	1	2	0	1	0	2	1	3	1	2	1	2	1	1	1	0.05	0.02	0.06
2130988	2024-01-11 04:45:00	65	3	1.55	3.85	4.60	1.52	3.95	4.75	3	8	14	2	11	14	5	19	28	23	9	0	28	3	2	1	1	2	3	-1	1	1	-0.03	0.10	0.15
2202781	2024-05-27 00:15:00	65	1	2.86	3.20	2.17	2.87	3.20	2.18	0	0	1	2	0	1	2	0	2	0	2	0	2	1	3	1	2	1	2	1	0	1	0.01	0.00	0.01
2130991	2024-01-10 04:45:00	65	0	4.75	4.00	1.51	4.90	4.10	1.49	26	18	17	19	17	20	45	35	37	0	10	8	45	1	3	2	3	1	2	1	1	-1	0.15	0.10	-0.02
2154816	2024-01-30 01:00:00	66	3	1.88	3.05	3.85	1.98	2.98	3.60	8	9	9	12	4	7	20	13	16	3	10	7	23	1	3	2	3	1	2	1	-1	-1	0.10	-0.07	-0.25
2115523	2024-01-21 04:00:00	66	1	2.64	2.92	2.51	2.72	2.85	2.49	7	8	11	14	4	8	21	12	19	2	11	4	23	1	3	2	3	1	2	1	-1	-1	0.08	-0.07	-0.02
2115524	2024-01-21 22:00:00	66	1	1.53	3.65	5.20	1.53	3.60	5.30	0	1	1	0	1	1	0	2	2	2	0	0	2	3	1	1	1	2	2	0	-1	1	0.00	-0.05	0.10
2115526	2024-01-22 04:00:00	66	3	1.99	3.15	3.35	2.05	3.10	3.25	6	3	8	10	1	6	16	4	14	4	16	6	20	1	3	2	3	1	2	1	-1	-1	0.06	-0.05	-0.10
2115527	2024-01-23 01:00:00	66	0	1.31	4.30	8.00	1.35	4.30	6.50	0	3	7	5	3	0	5	6	7	2	1	0	7	3	2	1	1	2	3	1	0	-1	0.04	0.00	-1.50
2115503	2024-01-14 04:00:00	66	3	1.18	5.60	11.00	1.19	5.30	12.00	2	6	3	4	2	4	6	8	7	6	4	5	12	3	1	2	1	3	2	1	-1	1	0.01	-0.30	1.00
2115504	2024-01-14 22:00:00	66	1	1.40	3.80	6.90	1.40	3.70	7.20	1	2	2	1	1	5	2	3	7	6	5	1	8	3	2	1	1	2	3	0	-1	1	0.00	-0.10	0.30
2115507	2024-01-15 22:00:00	66	3	1.30	4.35	8.10	1.30	4.40	8.00	2	1	4	3	2	3	5	3	7	3	5	1	8	2	3	1	2	1	3	0	1	-1	0.00	0.05	-0.10
2161588	2024-02-04 04:00:00	66	1	2.59	2.91	2.56	2.63	2.87	2.56	7	6	9	9	6	9	16	12	18	4	8	2	20	2	3	1	2	1	3	1	-1	0	0.04	-0.04	0.00
2115510	2024-01-16 04:00:00	66	1	1.44	3.60	6.70	1.51	3.45	6.00	1	2	5	3	0	3	4	2	8	5	7	1	9	2	3	1	2	1	3	1	-1	-1	0.07	-0.15	-0.70
2115512	2024-01-17 04:00:00	66	3	1.95	3.10	3.55	1.99	3.05	3.45	11	6	17	15	6	14	26	12	31	8	22	3	34	2	3	1	2	1	3	1	-1	-1	0.04	-0.05	-0.10
2115513	2024-01-18 01:00:00	66	3	1.29	4.55	8.10	1.28	4.55	8.60	6	7	9	5	8	15	11	15	24	14	10	1	25	3	2	1	1	2	3	-1	0	1	-0.01	0.00	0.50
2115514	2024-01-18 04:00:00	66	1	2.71	2.97	2.41	2.48	2.93	2.67	17	11	12	16	7	18	33	18	30	3	18	6	36	1	3	2	3	1	2	-1	-1	1	-0.23	-0.04	0.26
2161274	2024-02-03 01:00:00	66	3	1.61	3.20	5.30	1.63	3.25	5.10	0	4	7	1	5	5	1	9	12	15	7	4	16	3	2	1	1	2	3	1	1	-1	0.02	0.05	-0.20
2115516	2024-01-19 01:00:00	66	0	2.06	2.97	3.35	2.04	3.00	3.35	8	3	3	5	5	4	13	8	7	1	6	7	14	1	2	3	3	2	1	-1	1	0	-0.02	0.03	0.00
2154814	2024-01-28 04:00:00	66	3	2.04	2.94	3.45	2.02	2.97	3.45	5	5	5	4	8	4	9	13	9	4	0	4	13	2	1	2	1	3	1	-1	1	0	-0.02	0.03	0.00
2013592	2024-02-06 23:00:00	67	3	5.40	3.70	1.51	5.70	3.75	1.48	6	8	2	5	7	2	11	15	4	6	2	13	17	2	1	3	2	3	1	1	1	-1	0.30	0.05	-0.03
2013593	2024-02-07 23:00:00	67	3	3.95	3.35	1.75	4.05	3.25	1.77	7	6	5	9	3	7	16	9	12	1	8	5	17	1	3	2	3	1	2	1	-1	1	0.10	-0.10	0.02
2013591	2024-02-03 19:30:00	67	3	3.55	3.25	1.89	3.55	3.25	1.89	14	7	19	19	7	15	33	14	34	7	26	6	40	2	3	1	2	1	3	0	0	0	0.00	0.00	0.00
2013588	2024-02-02 23:30:00	67	1	3.05	2.88	2.26	2.94	2.96	2.26	4	4	0	3	6	0	7	10	0	3	0	10	10	2	1	3	2	3	1	-1	1	0	-0.11	0.08	0.00
2013589	2024-02-03 23:30:00	67	1	2.44	2.85	2.78	2.35	2.86	2.90	2	5	4	0	5	7	2	10	11	9	1	0	11	3	2	1	1	2	3	-1	1	1	-0.09	0.01	0.12
2013586	2024-02-01 00:00:00	67	1	1.28	4.75	8.40	1.27	4.70	8.80	7	11	13	10	6	10	17	17	23	7	7	1	24	2	2	1	1	1	3	-1	-1	1	-0.01	-0.05	0.40
2013587	2024-02-02 19:30:00	67	0	3.45	2.91	2.06	3.45	2.93	2.04	1	4	1	2	5	0	3	9	1	6	0	8	9	2	1	3	2	3	1	0	1	-1	0.00	0.02	-0.02
2013584	2024-01-31 00:00:00	67	1	3.90	3.50	1.73	3.90	3.45	1.74	11	7	9	10	6	14	21	13	23	10	18	8	31	2	3	1	2	1	3	0	-1	1	0.00	-0.05	0.01
2013585	2024-01-31 19:30:00	67	0	9.40	5.80	1.19	7.70	5.30	1.24	19	14	7	13	7	13	32	21	20	1	12	13	33	1	2	3	3	2	1	-1	-1	1	-1.70	-0.50	0.05
2013582	2024-01-30 00:00:00	67	3	1.42	3.85	6.30	1.44	3.80	6.00	0	3	5	1	2	5	1	5	10	11	7	2	12	3	2	1	1	2	3	1	-1	-1	0.02	-0.05	-0.30
2013583	2024-01-30 19:30:00	67	3	1.56	3.65	4.95	1.60	3.55	4.75	6	6	9	8	4	12	14	10	21	7	11	0	21	2	3	1	2	1	3	1	-1	-1	0.04	-0.10	-0.20
2013580	2024-01-29 00:00:00	67	1	3.45	3.05	1.98	3.65	3.10	1.90	15	9	9	10	8	13	25	17	22	5	13	8	30	1	3	2	3	1	2	1	1	-1	0.20	0.05	-0.08
2013581	2024-01-29 19:30:00	67	0	2.09	3.10	3.15	2.01	3.15	3.30	5	1	1	1	2	5	6	3	6	1	4	1	7	1	3	1	2	1	2	-1	1	1	-0.08	0.05	0.15
2013579	2024-01-28 19:30:00	67	3	1.16	5.80	12.00	1.16	6.00	11.00	6	7	4	7	6	3	13	13	7	6	6	12	19	1	1	3	2	2	1	0	1	-1	0.00	0.20	-1.00
2013736	2024-01-15 22:30:00	67	0	5.80	4.65	1.36	6.40	4.90	1.31	2	2	6	7	7	1	9	9	7	1	1	3	10	1	1	3	2	2	1	1	1	-1	0.60	0.25	-0.05
2013737	2024-01-19 22:30:00	67	0	1.89	3.40	3.40	1.84	3.50	3.45	46	18	31	30	19	43	76	37	74	4	43	6	80	1	3	2	3	1	2	-1	1	1	-0.05	0.10	0.05
2013734	2024-01-23 23:00:00	67	0	4.60	3.85	1.56	4.60	3.80	1.56	1	2	0	2	1	0	3	3	0	3	3	6	6	1	1	3	2	2	1	0	-1	0	0.00	-0.05	0.00
2013735	2024-01-23 23:00:00	67	3	1.63	3.45	4.65	1.65	3.40	4.55	0	1	1	1	0	1	1	1	2	1	1	0	2	2	2	1	1	1	3	1	-1	-1	0.02	-0.05	-0.10
2013732	2024-01-19 01:30:00	67	1	4.20	3.45	1.69	4.40	3.45	1.66	3	1	3	4	3	1	7	4	4	1	4	4	8	1	2	2	3	1	1	1	0	-1	0.20	0.00	-0.03
2013731	2024-01-14 22:30:00	67	3	1.21	5.40	9.80	1.18	5.70	11.00	4	3	2	2	5	4	6	8	6	4	2	4	10	2	1	2	1	3	1	-1	1	1	-0.03	0.30	1.20
2013535	2024-01-20 22:30:00	67	3	1.64	3.75	4.10	1.64	3.75	4.10	3	2	2	3	1	3	6	3	5	0	3	1	6	1	3	2	3	1	2	0	0	0	0.00	0.00	0.00
2013532	2024-01-25 19:30:00	67	1	1.08	8.10	15.00	1.11	7.10	13.00	1	10	8	5	5	4	6	15	12	12	3	6	18	3	1	2	1	3	2	1	-1	-1	0.03	-1.00	-2.00
2013533	2024-01-25 19:30:00	67	0	2.13	2.99	3.15	2.42	2.85	2.81	0	8	6	4	4	3	4	12	9	10	2	5	14	3	1	2	1	3	2	1	-1	-1	0.29	-0.14	-0.34
2013530	2024-01-16 01:30:00	67	0	3.90	3.55	1.72	3.90	3.50	1.73	5	3	2	5	1	3	10	4	5	0	6	5	10	1	3	2	3	1	2	0	-1	1	0.00	-0.05	0.01
2013531	2024-01-20 19:30:00	67	1	7.70	4.95	1.26	7.40	4.70	1.29	14	9	8	12	7	8	26	16	16	3	13	13	29	1	2	2	3	1	1	-1	-1	1	-0.30	-0.25	0.03
2013528	2024-01-25 23:00:00	67	1	6.10	3.80	1.45	5.20	3.85	1.50	6	1	1	5	3	1	11	4	2	0	7	9	11	1	2	3	3	2	1	-1	1	1	-0.90	0.05	0.05
2013529	2024-01-25 23:00:00	67	1	1.60	3.40	4.95	1.62	3.30	5.00	0	4	3	1	1	4	1	5	7	6	2	0	7	3	2	1	1	2	3	1	-1	1	0.02	-0.10	0.05
2013526	2024-01-22 01:30:00	67	0	9.70	5.70	1.19	10.00	5.60	1.19	13	7	5	13	8	4	26	15	9	0	11	17	26	1	2	3	3	2	1	1	-1	0	0.30	-0.10	0.00
2013527	2024-01-21 22:30:00	67	1	1.94	3.25	3.35	1.93	3.30	3.35	10	3	7	7	4	8	17	7	15	6	16	8	23	1	3	2	3	1	2	-1	1	0	-0.01	0.05	0.00
2013524	2024-01-16 22:30:00	67	3	2.36	3.15	2.65	2.31	3.15	2.71	4	3	6	2	5	6	6	8	12	7	5	1	13	3	2	1	1	2	3	-1	0	1	-0.05	0.00	0.06
2013525	2024-01-17 01:30:00	67	3	1.59	3.45	5.00	1.72	3.25	4.30	3	9	8	6	6	7	9	15	15	11	5	5	20	3	1	1	1	2	2	1	-1	-1	0.13	-0.20	-0.70
2013520	2024-01-23 19:30:00	67	3	1.28	4.95	7.50	1.27	4.90	7.70	3	4	6	3	3	6	6	7	12	7	6	1	13	3	2	1	1	2	3	-1	-1	1	-0.01	-0.05	0.20
2013521	2024-01-19 19:30:00	67	3	8.40	5.60	1.22	8.30	5.50	1.22	24	20	13	18	14	18	42	34	31	1	9	12	43	1	2	3	3	2	1	-1	-1	0	-0.10	-0.10	0.00
2013518	2024-01-23 19:30:00	67	1	2.29	2.91	2.94	2.26	2.88	3.05	1	10	4	1	5	9	2	15	13	13	0	2	15	3	1	2	1	3	2	-1	-1	1	-0.03	-0.03	0.11
2013519	2024-01-15 01:30:00	67	3	1.13	6.50	12.00	1.12	6.60	12.00	5	8	6	4	10	6	9	18	12	11	2	8	20	3	1	2	1	3	2	-1	1	0	-0.01	0.10	0.00
2013516	2024-01-18 19:30:00	67	0	7.50	4.15	1.33	7.30	4.00	1.36	15	9	8	10	6	11	25	15	19	3	13	9	28	1	3	2	3	1	2	-1	-1	1	-0.20	-0.15	0.03
2013517	2024-01-18 22:30:00	67	0	14.00	7.00	1.11	12.00	6.50	1.13	8	9	4	7	6	6	15	15	10	3	3	8	18	1	1	3	2	2	1	-1	-1	1	-2.00	-0.50	0.02
2013515	2024-01-14 01:30:00	67	1	1.64	3.25	4.95	1.59	3.30	5.30	3	1	5	1	3	7	4	4	12	9	9	1	13	2	2	1	1	1	3	-1	1	1	-0.05	0.05	0.35
2013508	2024-01-22 23:00:00	67	3	2.06	2.99	3.35	2.02	2.96	3.50	3	6	3	1	6	6	4	12	9	9	1	4	13	3	1	2	1	3	2	-1	-1	1	-0.04	-0.03	0.15
2013509	2024-01-17 22:30:00	67	3	1.33	4.15	7.70	1.29	4.45	8.30	6	2	6	3	7	7	9	9	13	4	4	0	13	2	2	1	1	1	3	-1	1	1	-0.04	0.30	0.60
2013507	2024-01-13 00:00:00	67	3	1.26	4.80	8.70	1.25	4.90	8.80	10	8	11	7	12	12	17	20	23	9	6	3	26	3	2	1	1	2	3	-1	1	1	-0.01	0.10	0.10
2017790	2024-01-22 23:00:00	67	3	2.13	3.15	3.00	2.02	3.10	3.30	4	3	4	1	4	6	5	7	10	6	4	1	11	3	2	1	1	2	3	-1	-1	1	-0.11	-0.05	0.30
2017788	2024-01-13 22:30:00	67	1	2.07	2.82	3.55	2.02	2.83	3.70	5	3	2	2	4	5	7	7	7	2	2	2	9	1	1	1	1	1	1	-1	1	1	-0.05	0.01	0.15
2017789	2024-01-17 19:30:00	67	1	2.93	2.82	2.36	3.20	2.78	2.23	11	18	6	15	13	6	26	31	12	6	1	20	32	2	1	3	2	3	1	1	-1	-1	0.27	-0.04	-0.13
2328019	2024-12-20 04:00:00	68	3	1.11	7.90	11.00	1.22	6.00	8.60	18	26	26	24	22	20	42	48	46	19	13	15	61	3	1	2	1	3	2	1	-1	-1	0.11	-1.90	-2.40
2173200	2024-03-01 03:00:00	68	3	1.10	8.80	18.00	1.15	8.30	15.00	4	12	11	8	9	9	12	21	20	15	6	7	27	3	1	2	1	3	2	1	-1	-1	0.05	-0.50	-3.00
2347585	2025-01-16 03:00:00	68	0	3.80	3.70	1.70	4.10	3.65	1.71	9	6	7	8	5	7	17	11	14	0	6	3	17	1	3	2	3	1	2	1	-1	1	0.30	-0.05	0.01
2347184	2025-01-15 01:45:00	68	3	2.48	3.30	2.41	2.29	3.20	2.69	16	4	6	9	2	18	25	6	24	2	21	3	27	1	3	2	3	1	2	-1	-1	1	-0.19	-0.10	0.28
2347584	2025-01-16 01:45:00	68	3	2.64	3.45	2.22	2.64	3.30	2.38	4	2	4	6	2	5	10	4	9	0	6	1	10	1	3	2	3	1	2	0	-1	1	0.00	-0.15	0.16
2328007	2024-12-18 03:00:00	68	3	2.21	3.45	2.66	2.44	3.55	2.44	4	1	8	7	3	3	11	4	11	1	8	1	12	1	3	1	2	1	2	1	1	-1	0.23	0.10	-0.22
2328006	2024-12-18 03:00:00	68	0	3.65	3.60	1.76	3.55	3.65	1.84	4	3	6	6	5	5	10	8	11	4	6	3	14	2	3	1	2	1	3	-1	1	1	-0.10	0.05	0.08
2181080	2024-04-22 00:00:00	68	3	1.24	5.70	8.60	1.21	6.00	9.70	3	1	2	0	4	6	3	5	8	5	3	0	8	3	2	1	1	2	3	-1	1	1	-0.03	0.30	1.10
2328009	2024-12-18 04:00:00	68	0	11.00	8.10	1.10	13.00	7.10	1.13	6	10	7	6	6	8	12	16	15	10	6	7	22	3	1	2	1	3	2	1	-1	1	2.00	-1.00	0.03
2328015	2024-12-19 04:00:00	68	3	1.53	3.80	5.60	1.39	4.20	7.40	11	2	3	2	9	14	13	11	17	4	6	0	17	2	3	1	2	1	3	-1	1	1	-0.14	0.40	1.80
2328013	2024-12-19 03:00:00	68	1	3.15	3.35	1.98	2.45	3.25	2.60	17	4	12	15	3	19	32	7	31	1	26	2	33	1	3	2	3	1	2	-1	-1	1	-0.70	-0.10	0.62
2328012	2024-12-19 03:00:00	68	1	2.70	3.45	2.16	2.68	3.50	2.28	3	0	3	3	1	3	6	1	6	0	5	0	6	1	3	1	2	1	2	-1	1	1	-0.02	0.05	0.12
2207969	2024-06-02 09:15:00	69	3	1.59	3.90	4.65	1.65	3.85	4.25	1	4	7	5	2	3	6	6	10	4	4	0	10	2	2	1	1	1	3	1	-1	-1	0.06	-0.05	-0.40
2200487	2024-05-02 10:15:00	69	0	1.58	4.10	5.20	1.62	4.05	4.65	3	2	4	2	3	3	5	5	7	2	2	0	7	2	2	1	1	1	3	1	-1	-1	0.04	-0.05	-0.55
2200486	2024-05-01 09:15:00	69	3	2.54	3.45	2.40	2.63	3.55	2.40	11	5	5	13	5	3	24	10	8	0	14	16	24	1	2	3	3	2	1	1	1	0	0.09	0.10	0.00
2191359	2024-05-01 20:00:00	70	1	1.58	3.75	4.60	1.61	3.90	4.90	0	0	0	1	1	2	1	1	2	1	1	0	2	2	2	1	1	1	3	1	1	1	0.03	0.15	0.30
2328021	2024-12-07 23:00:00	71	1	3.35	3.10	2.01	3.45	3.20	2.09	1	2	2	3	2	2	4	4	4	1	1	1	5	1	1	1	1	1	1	1	1	1	0.10	0.10	0.08
2240282	2024-10-06 23:15:00	71	0	3.65	3.65	1.74	4.15	3.95	1.71	0	0	2	2	1	0	2	1	2	1	2	1	3	1	3	1	2	1	2	1	1	-1	0.50	0.30	-0.03
2319886	2024-10-31 03:30:00	71	1	2.04	3.30	3.05	2.11	3.20	3.45	1	3	3	4	0	5	5	3	8	5	7	2	10	2	3	1	2	1	3	1	-1	1	0.07	-0.10	0.40
2335111	2024-12-19 01:00:00	72	3	1.20	6.20	12.00	1.19	6.40	12.00	3	4	2	4	4	1	7	8	3	4	3	8	11	2	1	3	2	3	1	-1	1	0	-0.01	0.20	0.00
2335110	2024-12-15 01:00:00	72	1	2.35	3.15	2.79	2.35	3.15	2.79	0	0	0	0	0	0	0	0	0	1	1	1	1	1	1	1	1	1	1	0	0	0	0.00	0.00	0.00
2335109	2024-12-12 01:00:00	72	0	1.44	4.00	6.40	1.46	4.10	6.70	3	5	5	5	6	7	8	11	12	5	2	1	13	3	2	1	1	2	3	1	1	1	0.02	0.10	0.30
2254626	2024-08-07 03:00:00	73	3	4.90	3.75	1.54	5.60	3.50	1.63	13	13	7	14	9	14	27	22	21	2	7	8	29	1	2	3	3	2	1	1	-1	1	0.70	-0.25	0.09
2254627	2024-08-07 00:00:00	73	1	1.84	3.30	3.65	1.93	3.10	4.15	30	13	28	28	10	31	58	23	59	12	47	11	70	2	3	1	2	1	3	1	-1	1	0.09	-0.20	0.50
2254624	2024-08-04 01:00:00	73	1	2.69	3.60	2.12	3.30	3.50	1.96	11	8	12	16	5	13	27	13	25	4	18	6	31	1	3	2	3	1	2	1	-1	-1	0.61	-0.10	-0.16
2254625	2024-08-04 03:00:00	73	0	1.68	3.65	4.00	1.72	3.60	4.15	2	13	13	3	9	15	5	22	28	28	11	5	33	3	2	1	1	2	3	1	-1	1	0.04	-0.05	0.15
2254628	2024-08-09 21:00:00	73	0	2.02	3.45	2.99	1.95	3.55	3.10	12	8	15	16	9	11	28	17	26	5	16	7	33	1	3	2	3	1	2	-1	1	1	-0.07	0.10	0.11
2254629	2024-08-10 23:00:00	73	0	3.35	3.15	1.98	3.80	3.10	2.02	21	6	21	19	6	29	40	12	50	13	41	3	53	2	3	1	2	1	3	1	-1	1	0.45	-0.05	0.04
2210281	2024-07-25 23:00:00	73	3	1.21	5.50	9.60	1.21	5.50	9.10	9	10	14	7	11	15	16	21	29	16	11	3	32	3	2	1	1	2	3	0	0	-1	0.00	0.00	-0.50
2210283	2024-07-26 03:00:00	73	3	1.28	5.00	6.90	1.27	5.00	7.50	5	8	12	7	6	11	12	14	23	11	9	0	23	3	2	1	1	2	3	-1	0	1	-0.01	0.00	0.60
2210282	2024-07-28 23:00:00	73	0	5.60	4.10	1.44	5.20	4.20	1.44	6	2	3	3	4	3	9	6	6	0	3	3	9	1	2	2	3	1	1	-1	1	0	-0.40	0.10	0.00
2210285	2024-08-01 03:00:00	73	0	3.30	3.45	1.90	3.45	3.60	1.87	17	8	17	15	9	19	32	17	36	4	19	0	36	2	3	1	2	1	3	1	1	-1	0.15	0.15	-0.03
2210284	2024-07-29 03:00:00	73	0	1.55	3.80	4.80	1.47	4.35	5.50	5	6	13	4	15	11	9	21	24	21	9	6	30	3	2	1	1	2	3	-1	1	1	-0.08	0.55	0.70
2210287	2024-07-26 01:00:00	73	3	1.62	3.80	4.25	1.85	3.55	3.35	2	7	10	9	1	2	11	8	12	3	6	2	14	2	3	1	2	1	3	1	-1	-1	0.23	-0.25	-0.90
2210286	2024-08-01 03:00:00	73	3	1.09	7.80	14.00	1.13	7.40	14.00	7	10	5	9	11	8	16	21	13	7	2	10	23	2	1	3	2	3	1	1	-1	0	0.04	-0.40	0.00
2210289	2024-07-29 03:00:00	73	3	2.13	3.25	2.91	2.03	3.40	3.20	6	4	12	6	7	8	12	11	20	8	9	0	20	2	3	1	2	1	3	-1	1	1	-0.10	0.15	0.29
2210291	2024-08-01 01:00:00	73	0	5.60	4.55	1.39	4.80	4.30	1.46	12	7	3	6	4	10	18	11	13	0	7	5	18	1	3	2	3	1	2	-1	-1	1	-0.80	-0.25	0.07
2210290	2024-07-29 01:00:00	73	3	1.16	6.70	9.20	1.17	7.10	8.30	1	4	7	2	5	6	3	9	13	10	4	0	13	3	2	1	1	2	3	1	1	-1	0.01	0.40	-0.90
2210293	2024-07-25 23:00:00	73	3	1.52	4.05	4.70	1.53	4.00	4.55	2	3	5	4	2	2	6	5	7	2	3	1	8	2	3	1	2	1	3	1	-1	-1	0.01	-0.05	-0.15
2210292	2024-08-01 01:00:00	73	0	11.00	9.40	1.09	12.00	9.70	1.08	2	4	3	5	5	2	7	9	5	2	0	4	9	2	1	3	2	3	1	1	1	-1	1.00	0.30	-0.01
2210295	2024-07-28 23:00:00	73	0	2.61	3.20	2.36	2.70	3.20	2.29	2	1	2	3	1	1	5	2	3	0	3	2	5	1	3	2	3	1	2	1	0	-1	0.09	0.00	-0.07
2210294	2024-07-26 01:00:00	73	0	4.80	4.00	1.50	5.10	3.80	1.51	4	6	2	6	3	2	10	9	4	1	2	7	11	1	2	3	3	2	1	1	-1	1	0.30	-0.20	0.01
2210297	2024-07-31 23:00:00	73	0	3.95	3.50	1.72	3.50	3.40	1.85	10	9	5	9	6	8	19	15	13	2	6	8	21	1	2	3	3	2	1	-1	-1	1	-0.45	-0.10	0.13
2210296	2024-07-29 01:00:00	73	3	1.11	7.80	12.00	1.06	8.30	19.00	4	6	2	2	4	5	6	10	7	6	2	5	12	3	1	2	1	3	2	-1	1	1	-0.05	0.50	7.00
2210298	2024-07-31 23:00:00	73	3	1.45	4.00	5.50	1.48	3.90	5.30	2	4	5	3	3	4	5	7	9	5	3	1	10	3	2	1	1	2	3	1	-1	-1	0.03	-0.10	-0.20
2254622	2024-08-03 21:00:00	73	1	1.62	3.75	4.40	1.58	3.80	4.45	5	3	10	3	4	10	8	7	20	12	13	0	20	2	3	1	2	1	3	-1	1	1	-0.04	0.05	0.05
2254623	2024-08-03 23:00:00	73	1	1.27	4.90	7.70	1.24	5.10	8.70	12	10	13	10	13	18	22	23	31	9	8	0	31	3	2	1	1	2	3	-1	1	1	-0.03	0.20	1.00
2210797	2024-07-25 03:00:00	74	1	2.40	3.05	2.68	2.44	3.10	2.87	4	1	6	5	2	8	9	3	14	5	11	0	14	2	3	1	2	1	3	1	1	1	0.04	0.05	0.19
2210799	2024-07-28 01:00:00	74	0	2.49	3.30	2.39	2.51	3.30	2.64	7	1	3	5	1	8	12	2	11	0	10	1	12	1	3	2	3	1	2	1	0	1	0.02	0.00	0.25
2210798	2024-07-31 03:00:00	74	0	3.40	3.45	1.86	3.80	3.75	1.92	13	5	11	14	7	12	27	12	23	2	17	6	29	1	3	2	3	1	2	1	1	1	0.40	0.30	0.06
2210241	2024-07-28 01:00:00	74	0	4.30	3.85	1.60	4.50	3.80	1.68	4	2	3	5	3	6	9	5	9	2	6	2	11	1	3	1	2	1	2	1	-1	1	0.20	-0.05	0.08
2210240	2024-07-25 03:00:00	74	3	1.46	4.30	4.80	1.48	4.20	6.00	9	7	10	6	7	13	15	14	23	11	12	3	26	2	3	1	2	1	3	1	-1	1	0.02	-0.10	1.20
2210243	2024-07-25 01:00:00	74	3	3.80	3.20	1.83	4.35	3.40	1.80	2	0	4	5	3	1	7	3	5	1	5	3	8	1	3	2	3	1	2	1	1	-1	0.55	0.20	-0.03
2210242	2024-07-24 21:00:00	74	0	1.81	3.20	3.95	1.81	3.45	3.85	16	4	16	14	4	15	30	8	31	7	29	6	37	2	3	1	2	1	3	0	1	-1	0.00	0.25	-0.10
2210245	2024-07-31 01:00:00	74	3	1.23	5.50	7.70	1.24	5.50	11.00	2	3	5	3	2	4	5	5	9	6	6	2	11	2	2	1	1	1	3	1	0	1	0.01	0.00	3.30
2210244	2024-07-27 21:00:00	74	3	1.31	4.75	7.00	1.32	4.80	7.30	17	15	20	17	15	21	34	30	41	18	22	11	52	2	3	1	2	1	3	1	1	1	0.01	0.05	0.30
2210247	2024-07-30 23:00:00	74	0	4.60	3.90	1.55	4.60	3.80	1.67	6	3	0	3	3	3	9	6	3	0	3	6	9	1	2	3	3	2	1	0	-1	1	0.00	-0.10	0.12
2210246	2024-07-27 23:00:00	74	3	3.35	3.25	1.94	3.65	3.25	1.92	6	3	4	6	2	5	12	5	9	1	8	4	13	1	3	2	3	1	2	1	0	-1	0.30	0.00	-0.02
2210249	2024-07-24 21:00:00	74	0	8.40	4.90	1.25	8.30	5.60	1.25	4	3	5	7	7	4	11	10	9	0	1	2	11	1	2	3	3	2	1	-1	1	0	-0.10	0.70	0.00
2210248	2024-07-30 23:00:00	74	3	1.43	4.25	5.50	1.47	4.20	6.20	0	2	3	2	1	2	2	3	5	5	4	2	7	3	2	1	1	2	3	1	-1	1	0.04	-0.05	0.70
2210251	2024-07-27 21:00:00	74	0	12.00	7.30	1.11	15.00	7.50	1.11	6	6	4	4	3	6	10	9	10	1	2	1	11	1	3	1	2	1	2	1	1	0	3.00	0.20	0.00
2210250	2024-07-24 23:00:00	74	1	1.19	6.00	8.80	1.23	5.80	9.40	6	7	12	9	6	14	15	13	26	14	16	3	29	2	3	1	2	1	3	1	-1	1	0.04	-0.20	0.60
2210253	2024-07-30 21:00:00	74	0	1.50	3.80	5.40	1.56	3.85	5.60	4	6	9	5	3	9	9	9	18	9	9	0	18	2	2	1	1	1	3	1	1	1	0.06	0.05	0.20
2210252	2024-07-27 23:00:00	74	0	2.28	3.15	2.73	2.25	3.20	2.91	1	2	6	0	3	4	1	5	10	9	5	0	10	3	2	1	1	2	3	-1	1	1	-0.03	0.05	0.18
2210255	2024-07-25 01:00:00	74	3	2.09	3.20	3.05	1.95	3.40	3.65	20	3	5	9	6	17	29	9	22	2	22	9	31	1	3	2	3	1	2	-1	1	1	-0.14	0.20	0.60
2210254	2024-07-30 21:00:00	74	1	4.25	4.00	1.58	4.55	4.00	1.64	4	2	1	3	4	1	7	6	2	0	1	5	7	1	2	3	3	2	1	1	0	1	0.30	0.00	0.06
2210257	2024-07-31 03:00:00	74	3	2.47	3.30	2.42	2.47	3.55	2.75	1	2	4	3	3	3	4	5	7	3	2	0	7	3	2	1	1	2	3	0	1	1	0.00	0.25	0.33
2210256	2024-07-28 03:00:00	74	3	1.86	3.40	3.45	1.83	3.65	3.85	14	5	9	9	9	11	23	14	20	3	12	6	26	1	3	2	3	1	2	-1	1	1	-0.03	0.25	0.40
2254614	2024-08-02 21:00:00	74	3	2.12	3.15	3.00	2.21	3.35	2.86	16	5	18	14	6	20	30	11	38	11	30	3	41	2	3	1	2	1	3	1	1	-1	0.09	0.20	-0.14
2254615	2024-08-02 23:00:00	74	0	6.33	3.96	1.40	6.40	4.00	1.40	0	0	0	1	1	0	1	1	0	1	1	2	2	1	1	3	2	2	1	1	1	0	0.07	0.04	0.00
2254618	2024-08-06 00:00:00	74	0	3.15	3.10	2.07	3.10	3.30	2.21	7	2	2	6	4	4	13	6	6	2	9	9	15	1	2	2	3	1	1	-1	1	1	-0.05	0.20	0.14
2254619	2024-08-06 03:00:00	74	1	1.29	4.55	8.30	1.34	4.60	8.50	12	15	20	14	13	22	26	28	42	20	18	4	46	3	2	1	1	2	3	1	1	1	0.05	0.05	0.20
2211355	2024-07-24 23:00:00	74	0	1.74	3.40	3.95	1.68	3.55	4.45	3	0	2	0	2	4	3	2	6	4	5	1	7	2	3	1	2	1	3	-1	1	1	-0.06	0.15	0.50
2254616	2024-08-03 01:00:00	74	1	2.43	3.15	2.56	3.30	3.25	2.28	14	2	17	22	3	12	36	5	29	3	34	10	39	1	3	2	3	1	2	1	1	-1	0.87	0.10	-0.28
2254617	2024-08-03 03:00:00	74	3	2.05	3.30	3.25	2.20	3.35	3.40	14	8	13	15	7	12	29	15	25	7	21	11	36	1	3	2	3	1	2	1	1	1	0.15	0.05	0.15
2211357	2024-07-31 01:00:00	74	3	1.46	4.10	5.40	1.50	4.10	5.90	2	3	4	2	4	4	4	7	8	7	4	3	11	3	2	1	1	2	3	1	0	1	0.04	0.00	0.50
2211356	2024-07-28 03:00:00	74	3	1.20	5.50	9.40	1.26	5.50	9.90	6	7	14	10	6	10	16	13	24	10	13	2	26	2	3	1	2	1	3	1	0	1	0.06	0.00	0.50
2254620	2024-08-08 23:00:00	74	0	3.75	3.60	1.74	3.75	3.65	1.79	17	11	8	11	8	16	28	19	24	6	15	10	34	1	3	2	3	1	2	0	1	1	0.00	0.05	0.05
2254621	2024-08-10 00:00:00	74	1	2.40	2.89	2.80	2.49	3.00	3.15	3	7	9	3	9	9	6	16	18	13	3	1	19	3	2	1	1	2	3	1	1	1	0.09	0.11	0.35
2133152	2024-06-25 06:00:00	75	3	1.69	3.50	4.95	1.71	3.55	5.50	4	3	5	3	3	8	7	6	13	8	9	2	15	2	3	1	2	1	3	1	1	1	0.02	0.05	0.55
2133153	2024-06-26 06:00:00	75	0	3.20	3.10	2.40	3.30	3.10	2.36	4	2	3	7	3	2	11	5	5	0	6	6	11	1	2	2	3	1	1	1	0	-1	0.10	0.00	-0.04
2133154	2024-06-25 09:00:00	75	1	1.13	8.70	19.00	1.12	9.70	20.00	11	18	18	10	17	17	21	35	35	34	20	20	55	3	1	1	1	2	2	-1	1	1	-0.01	1.00	1.00
2133155	2024-06-30 08:00:00	75	3	1.50	4.05	7.50	1.49	3.95	7.80	3	4	6	3	2	7	6	6	13	12	12	5	18	2	2	1	1	1	3	-1	-1	1	-0.01	-0.10	0.30
2133156	2024-06-30 08:00:00	75	1	3.15	3.35	2.31	2.84	3.40	2.47	7	0	6	5	2	7	12	2	13	4	14	3	16	2	3	1	2	1	3	-1	1	1	-0.31	0.05	0.16
2133157	2024-06-28 09:00:00	75	3	1.14	8.40	20.00	1.20	6.60	16.00	9	30	22	14	18	17	23	48	39	45	20	29	68	3	1	2	1	3	2	1	-1	-1	0.06	-1.80	-4.00
2133158	2024-06-28 06:00:00	75	0	1.35	4.85	9.80	1.40	4.60	8.60	6	10	21	12	6	13	18	16	34	20	22	4	38	2	3	1	2	1	3	1	-1	-1	0.05	-0.25	-1.20
2133159	2024-06-23 09:00:00	75	3	1.62	3.75	6.10	1.49	4.30	6.80	12	5	13	5	14	15	17	19	28	16	14	5	33	3	2	1	1	2	3	-1	1	1	-0.13	0.55	0.70
2133160	2024-06-29 09:00:00	75	0	9.70	5.10	1.33	10.00	5.00	1.33	33	20	18	34	21	20	67	41	38	13	39	42	80	1	2	3	3	2	1	1	-1	0	0.30	-0.10	0.00
2133161	2024-06-29 06:00:00	75	3	1.31	4.80	9.20	1.29	5.20	11.00	27	27	28	26	31	28	53	58	56	35	30	32	88	3	1	2	1	3	2	-1	1	1	-0.02	0.40	1.80
2133162	2024-06-23 06:00:00	75	0	2.01	3.15	4.25	2.05	3.05	4.25	9	2	7	9	1	8	18	3	15	6	21	9	24	1	3	2	3	1	2	1	-1	0	0.04	-0.10	0.00
2133163	2024-07-02 09:00:00	75	0	5.60	3.85	1.63	5.40	3.75	1.67	6	7	3	5	5	4	11	12	7	6	5	10	17	2	1	3	2	3	1	-1	-1	1	-0.20	-0.10	0.04
2133164	2024-07-02 09:00:00	75	0	2.47	3.25	2.95	2.56	3.25	2.86	2	3	10	4	3	9	6	6	19	13	13	0	19	2	2	1	1	1	3	1	0	-1	0.09	0.00	-0.09
2133165	2024-06-27 09:00:00	75	3	3.40	3.20	2.25	3.45	3.10	2.28	3	6	1	4	4	1	7	10	2	9	6	14	16	2	1	3	2	3	1	1	-1	1	0.05	-0.10	0.03
2133166	2024-06-27 06:00:00	75	3	1.51	4.00	7.30	1.50	4.05	7.30	5	5	8	5	7	7	10	12	15	10	8	5	20	3	2	1	1	2	3	-1	1	0	-0.01	0.05	0.00
2133167	2024-07-03 09:00:00	75	1	1.91	3.55	4.10	1.93	3.40	4.25	12	9	11	17	6	12	29	15	23	11	25	17	40	1	3	2	3	1	2	1	-1	1	0.02	-0.15	0.15
2133168	2024-07-03 09:00:00	75	3	3.90	3.20	2.09	4.00	3.35	2.00	17	4	18	17	7	18	34	11	36	7	30	5	41	2	3	1	2	1	3	1	1	-1	0.10	0.15	-0.09
2133169	2024-07-01 08:00:00	75	1	2.85	3.10	2.65	2.96	2.84	2.78	20	10	8	17	5	10	37	15	18	1	23	20	38	1	3	2	3	1	2	1	-1	1	0.11	-0.26	0.13
2133170	2024-07-01 08:00:00	75	0	4.05	3.30	2.00	4.40	3.30	1.92	7	3	11	14	3	4	21	6	15	2	17	8	23	1	3	2	3	1	2	1	0	-1	0.35	0.00	-0.08
2212733	2024-07-05 09:00:00	75	1	1.44	4.00	9.40	1.44	3.90	9.80	5	9	18	5	6	18	10	15	36	26	21	0	36	3	2	1	1	2	3	0	-1	1	0.00	-0.10	0.40
2212735	2024-07-07 09:00:00	75	1	2.85	3.10	2.66	3.00	2.90	2.69	5	7	2	11	2	2	16	9	4	0	7	12	16	1	2	3	3	2	1	1	-1	1	0.15	-0.20	0.03
2212734	2024-07-06 09:00:00	75	1	2.51	3.10	3.00	2.72	3.10	2.76	11	4	22	12	5	18	23	9	40	23	37	6	46	2	3	1	2	1	3	1	0	-1	0.21	0.00	-0.24
2212737	2024-07-10 08:00:00	75	3	1.35	4.75	9.60	1.32	4.95	10.00	6	7	7	5	10	7	11	17	14	13	7	10	24	3	1	2	1	3	2	-1	1	1	-0.03	0.20	0.40
2212736	2024-07-07 06:00:00	75	3	1.27	5.10	11.00	1.34	5.00	10.00	7	6	6	10	7	5	17	13	11	9	13	15	26	1	2	3	3	2	1	1	-1	-1	0.07	-0.10	-1.00
2212739	2024-07-14 08:00:00	75	1	6.00	4.35	1.53	6.30	4.40	1.51	5	2	5	6	4	4	11	6	9	6	11	8	17	1	3	2	3	1	2	1	1	-1	0.30	0.05	-0.02
2212738	2024-07-11 08:00:00	75	0	2.75	2.79	3.05	2.69	2.72	3.20	4	12	4	1	7	7	5	19	11	19	5	13	24	3	1	2	1	3	2	-1	-1	1	-0.06	-0.07	0.15
2212740	2024-07-15 08:00:00	75	1	2.19	2.87	4.10	2.12	2.89	4.30	11	4	8	8	7	11	19	11	19	7	15	7	26	1	3	1	2	1	2	-1	1	1	-0.07	0.02	0.20
2133147	2024-06-24 09:00:00	75	3	1.30	5.40	9.90	1.30	5.30	10.00	12	11	7	12	10	7	24	21	14	10	13	20	34	1	2	3	3	2	1	0	-1	1	0.00	-0.10	0.10
2133148	2024-06-21 08:00:00	75	3	1.29	5.40	10.00	1.30	5.30	9.90	9	4	8	6	5	13	15	9	21	9	15	3	24	2	3	1	2	1	3	1	-1	-1	0.01	-0.10	-0.10
2133149	2024-06-24 06:00:00	75	3	1.16	7.00	14.00	1.20	6.60	16.00	5	16	11	9	13	11	14	29	22	26	11	18	40	3	1	2	1	3	2	1	-1	1	0.04	-0.40	2.00
2133150	2024-06-22 08:00:00	75	1	3.80	3.00	2.20	3.90	2.96	2.20	7	13	2	9	9	3	16	22	5	10	4	21	26	2	1	3	2	3	1	1	-1	0	0.10	-0.04	0.00
2133151	2024-06-26 09:00:00	75	0	8.30	4.25	1.44	8.00	3.95	1.48	13	11	4	18	8	3	31	19	7	0	12	24	31	1	2	3	3	2	1	-1	-1	1	-0.30	-0.30	0.04
2135200	2024-07-07 00:00:00	76	1	2.23	2.93	3.45	2.23	2.97	3.80	1	11	3	2	9	5	3	20	8	17	0	12	20	3	1	2	1	3	2	0	1	1	0.00	0.04	0.35
2135201	2024-07-07 03:00:00	76	3	1.59	3.95	5.00	1.58	4.15	5.70	5	5	8	6	6	8	11	11	16	7	7	2	18	2	2	1	1	1	3	-1	1	1	-0.01	0.20	0.70
2135202	2024-07-10 03:00:00	76	3	2.69	2.75	2.90	2.75	2.85	2.98	7	11	12	7	11	13	14	22	25	22	14	11	36	3	2	1	1	2	3	1	1	1	0.06	0.10	0.08
2135203	2024-07-11 03:00:00	76	0	2.89	2.76	2.69	3.20	2.75	2.66	12	11	7	14	11	4	26	22	11	6	10	21	32	1	2	3	3	2	1	1	-1	-1	0.31	-0.01	-0.03
2135204	2024-07-15 03:00:00	76	3	2.44	2.78	3.20	2.44	2.82	3.50	11	9	8	9	13	12	20	22	20	14	12	14	34	2	1	2	1	3	1	0	1	1	0.00	0.04	0.30
2135190	2024-06-30 00:00:00	76	3	3.10	2.91	2.42	3.30	2.98	2.42	4	7	3	6	3	2	10	10	5	5	5	10	15	1	1	3	2	2	1	1	1	0	0.20	0.07	0.00
2135191	2024-06-30 03:00:00	76	3	1.63	3.75	5.00	1.64	3.90	5.40	2	2	5	2	6	3	4	8	8	10	6	6	14	3	1	1	1	2	2	1	1	1	0.01	0.15	0.40
2135192	2024-07-01 00:00:00	76	1	1.37	4.15	9.10	1.45	4.10	8.90	6	18	26	13	13	18	19	31	44	29	17	4	48	3	2	1	1	2	3	1	-1	-1	0.08	-0.05	-0.20
2135193	2024-07-01 03:00:00	76	3	1.19	6.40	12.00	1.20	6.60	15.00	7	7	4	8	7	5	15	14	9	7	8	13	22	1	2	3	3	2	1	1	1	1	0.01	0.20	3.00
2135194	2024-07-02 00:00:00	76	3	1.98	3.20	3.80	1.98	3.35	4.10	15	5	12	14	5	14	29	10	26	11	30	14	40	1	3	2	3	1	2	0	1	1	0.00	0.15	0.30
2135195	2024-07-02 03:00:00	76	1	1.31	4.75	9.70	1.35	4.85	9.60	8	10	19	10	12	15	18	22	34	20	16	4	38	3	2	1	1	2	3	1	1	-1	0.04	0.10	-0.10
2135196	2024-07-03 00:00:00	76	0	7.10	4.35	1.41	7.90	4.55	1.43	8	5	6	13	6	6	21	11	12	4	14	13	25	1	3	2	3	1	2	1	1	1	0.80	0.20	0.02
2135197	2024-07-03 03:00:00	76	0	2.01	3.35	3.50	1.98	3.30	4.10	15	5	10	12	4	14	27	9	24	8	26	11	35	1	3	2	3	1	2	-1	-1	1	-0.03	-0.05	0.60
2135198	2024-07-06 00:00:00	76	1	2.71	3.15	2.56	2.89	3.20	2.56	10	3	10	16	3	6	26	6	16	0	20	10	26	1	3	2	3	1	2	1	1	0	0.18	0.05	0.00
2135199	2024-07-06 03:00:00	76	1	3.20	3.10	2.42	3.30	2.98	2.44	2	10	1	6	5	2	8	15	3	9	2	14	17	2	1	3	2	3	1	1	-1	1	0.10	-0.12	0.02
2132321	2024-06-16 21:00:00	76	0	6.10	4.10	1.56	6.70	4.30	1.50	16	12	21	21	15	15	37	27	36	1	11	2	38	1	3	2	3	1	2	1	1	-1	0.60	0.20	-0.06
2132322	2024-06-17 21:00:00	76	3	4.05	3.35	1.98	4.35	3.35	1.92	9	4	14	14	4	9	23	8	23	6	21	6	29	1	3	1	2	1	2	1	0	-1	0.30	0.00	-0.06
2132323	2024-06-19 00:00:00	76	3	1.73	3.65	5.10	1.69	3.85	5.10	6	2	8	1	7	9	7	9	17	16	14	6	23	3	2	1	1	2	3	-1	1	0	-0.04	0.20	0.00
2132324	2024-06-22 00:00:00	76	0	3.00	3.35	2.21	3.40	3.40	2.16	3	1	4	5	2	1	8	3	5	3	8	6	11	1	3	2	3	1	2	1	1	-1	0.40	0.05	-0.05
2132325	2024-06-21 21:00:00	76	0	3.35	3.25	2.12	3.50	3.30	2.16	10	4	6	7	5	12	17	9	18	12	20	11	29	2	3	1	2	1	3	1	1	1	0.15	0.05	0.04
2132326	2024-06-22 21:00:00	76	1	4.15	3.60	1.78	4.55	3.75	1.78	6	2	2	8	4	1	14	6	3	2	10	13	16	1	2	3	3	2	1	1	1	0	0.40	0.15	0.00
2132327	2024-06-26 00:00:00	76	1	1.28	5.30	9.50	1.27	5.80	11.00	11	5	6	9	8	9	20	13	15	15	22	20	35	1	3	2	3	1	2	-1	1	1	-0.01	0.50	1.50
2132328	2024-06-27 03:00:00	76	3	8.00	5.00	1.38	7.50	4.80	1.41	14	7	4	11	4	8	25	11	12	3	17	16	28	1	3	2	3	1	2	-1	-1	1	-0.50	-0.20	0.03
2132329	2024-06-27 00:00:00	76	1	4.85	3.80	1.64	5.60	3.95	1.62	2	2	4	6	4	1	8	6	5	3	5	6	11	1	2	3	3	2	1	1	1	-1	0.75	0.15	-0.02
2132290	2024-06-15 03:00:00	76	3	1.28	5.70	11.00	1.28	5.80	11.00	6	7	7	6	9	7	12	16	14	16	12	14	28	3	1	2	1	3	2	0	1	0	0.00	0.10	0.00
2132291	2024-06-15 21:00:00	76	0	3.50	3.20	2.21	3.60	3.20	2.17	4	1	4	7	1	0	11	2	4	3	12	10	14	1	3	2	3	1	2	1	0	-1	0.10	0.00	-0.04
2132292	2024-06-16 00:00:00	76	3	1.93	3.50	4.10	1.92	3.50	4.10	11	3	8	9	4	8	20	7	16	4	17	8	24	1	3	2	3	1	2	-1	0	0	-0.01	0.00	0.00
2132293	2024-06-16 03:00:00	76	3	1.38	4.85	8.30	1.35	4.85	9.50	13	10	14	10	13	20	23	23	34	11	11	0	34	2	2	1	1	1	3	-1	0	1	-0.03	0.00	1.20
2132294	2024-06-17 00:00:00	76	1	5.30	3.50	1.74	5.50	3.65	1.69	5	3	6	7	5	2	12	8	8	5	9	9	17	1	2	2	3	1	1	1	1	-1	0.20	0.15	-0.05
2132295	2024-06-17 03:00:00	76	0	6.70	4.40	1.48	7.10	4.50	1.46	11	10	9	16	13	6	27	23	15	8	12	20	35	1	2	3	3	2	1	1	1	-1	0.40	0.10	-0.02
2132296	2024-06-18 00:00:00	76	0	1.50	4.30	6.60	1.45	4.45	7.50	11	8	8	7	11	17	18	19	25	9	8	2	27	3	2	1	1	2	3	-1	1	1	-0.05	0.15	0.90
2132299	2024-06-18 03:00:00	76	0	6.10	4.35	1.52	5.60	4.15	1.59	17	10	12	16	6	15	33	16	27	3	20	9	36	1	3	2	3	1	2	-1	-1	1	-0.50	-0.20	0.07
2132300	2024-06-19 03:00:00	76	3	1.47	4.50	6.80	1.47	4.50	7.00	15	12	17	15	13	21	30	25	38	13	18	5	43	2	3	1	2	1	3	0	0	1	0.00	0.00	0.20
2132301	2024-06-19 21:00:00	76	1	1.45	4.15	6.90	1.43	4.45	8.00	4	2	5	2	5	9	6	7	14	8	7	0	14	3	2	1	1	2	3	-1	1	1	-0.02	0.30	1.10
2132302	2024-06-20 00:00:00	76	3	1.26	5.80	8.80	1.28	6.00	9.70	6	8	22	9	8	16	15	16	38	24	23	1	39	3	2	1	1	2	3	1	1	1	0.02	0.20	0.90
2132303	2024-06-20 03:00:00	76	1	4.10	3.40	1.84	4.40	3.45	1.88	10	3	9	11	3	12	21	6	21	7	22	7	28	1	3	1	2	1	2	1	1	1	0.30	0.05	0.04
2132304	2024-06-20 21:00:00	76	1	4.35	3.40	1.80	4.75	3.70	1.76	11	4	11	12	7	8	23	11	19	2	14	6	25	1	3	2	3	1	2	1	1	-1	0.40	0.30	-0.04
2132305	2024-06-21 00:00:00	76	1	4.85	3.50	1.70	5.80	3.65	1.66	6	2	6	7	4	5	13	6	11	1	8	3	14	1	3	2	3	1	2	1	1	-1	0.95	0.15	-0.04
2132306	2024-06-21 03:00:00	76	3	2.17	3.15	3.30	2.25	3.20	3.40	4	3	6	7	2	4	11	5	10	4	10	5	15	1	3	2	3	1	2	1	1	1	0.08	0.05	0.10
2132307	2024-06-22 03:00:00	76	1	2.97	3.30	2.26	3.35	3.30	2.23	4	2	3	6	2	4	10	4	7	2	8	5	12	1	3	2	3	1	2	1	0	-1	0.38	0.00	-0.03
2132308	2024-06-23 00:00:00	76	0	4.80	4.10	1.59	5.50	4.10	1.60	15	12	16	18	12	15	33	24	31	5	14	7	38	1	3	2	3	1	2	1	0	1	0.70	0.00	0.01
2132309	2024-06-23 03:00:00	76	3	1.49	4.25	5.80	1.46	4.50	7.10	7	5	8	5	8	12	12	13	20	11	10	3	23	3	2	1	1	2	3	-1	1	1	-0.03	0.25	1.30
2132310	2024-06-24 03:00:00	76	0	2.60	3.35	2.51	2.58	3.75	2.53	11	1	2	10	4	2	21	5	4	0	16	17	21	1	2	3	3	2	1	-1	1	1	-0.02	0.40	0.02
2132311	2024-06-24 03:00:00	76	1	1.71	3.80	4.30	1.67	3.95	5.10	7	4	5	2	6	12	9	10	17	16	15	8	25	3	2	1	1	2	3	-1	1	1	-0.04	0.15	0.80
2132312	2024-06-25 03:00:00	76	0	7.00	4.45	1.40	7.30	4.50	1.45	5	5	4	10	6	5	15	11	9	4	8	10	19	1	2	3	3	2	1	1	1	1	0.30	0.05	0.05
2132313	2024-06-26 00:00:00	76	0	2.23	3.05	3.30	2.12	3.10	3.95	8	3	1	2	2	10	10	5	11	7	12	6	17	2	3	1	2	1	3	-1	1	1	-0.11	0.05	0.65
2132314	2024-06-25 03:00:00	76	1	2.80	3.25	2.40	3.10	3.20	2.42	13	4	8	18	2	8	31	6	16	3	28	18	34	1	3	2	3	1	2	1	-1	1	0.30	-0.05	0.02
2132315	2024-06-26 03:00:00	76	1	2.26	3.40	2.92	2.29	3.30	3.20	3	11	21	3	9	25	6	20	46	49	35	9	55	3	2	1	1	2	3	1	-1	1	0.03	-0.10	0.28
2132316	2024-06-26 03:00:00	76	1	1.30	4.85	10.00	1.36	4.70	9.40	4	11	14	6	8	13	10	19	27	23	14	6	33	3	2	1	1	2	3	1	-1	-1	0.06	-0.15	-0.60
2132317	2024-06-27 00:00:00	76	1	3.22	1.95	3.90	3.00	1.93	4.40	8	14	9	2	8	21	10	22	30	20	8	0	30	3	2	1	1	2	3	-1	-1	1	-0.22	-0.02	0.50
2132318	2024-06-27 03:00:00	76	0	2.58	3.10	2.69	2.71	3.25	2.69	3	4	5	4	3	13	7	7	18	13	13	2	20	2	2	1	1	1	3	1	1	0	0.13	0.15	0.00
